Index Nabijacky;Index Udalosti;Cas Zaciatku;Cas Konca;CasTrvania;Miesto;Rychlost nabijania
0;0;243;338;95;25;2.0
0;1;338;339;1;25;2.0
0;2;339;349;10;25;2.0
0;3;349;350;1;25;2.0
0;4;350;354;4;25;2.0
0;5;354;361;7;25;2.0
0;6;361;369;8;25;2.0
0;7;369;380;11;25;2.0
0;8;380;384;4;25;2.0
0;9;384;389;5;25;2.0
0;10;389;391;2;25;2.0
0;11;391;394;3;25;2.0
0;12;394;400;6;25;2.0
0;13;400;404;4;25;2.0
0;14;404;409;5;25;2.0
0;15;409;414;5;25;2.0
0;16;414;420;6;25;2.0
0;17;420;421;1;25;2.0
0;18;421;424;3;25;2.0
0;19;424;429;5;25;2.0
0;20;429;434;5;25;2.0
0;21;434;440;6;25;2.0
0;22;440;444;4;25;2.0
0;23;444;449;5;25;2.0
0;24;449;451;2;25;2.0
0;25;451;454;3;25;2.0
0;26;454;460;6;25;2.0
0;27;460;464;4;25;2.0
0;28;464;469;5;25;2.0
0;29;469;474;5;25;2.0
0;30;474;480;6;25;2.0
0;31;480;481;1;25;2.0
0;32;481;484;3;25;2.0
0;33;484;489;5;25;2.0
0;34;489;494;5;25;2.0
0;35;494;500;6;25;2.0
0;36;500;504;4;25;2.0
0;37;504;509;5;25;2.0
0;38;509;511;2;25;2.0
0;39;511;514;3;25;2.0
0;40;514;520;6;25;2.0
0;41;520;524;4;25;2.0
0;42;524;529;5;25;2.0
0;43;529;534;5;25;2.0
0;44;534;540;6;25;2.0
0;45;540;544;4;25;2.0
0;46;544;549;5;25;2.0
0;47;549;560;11;25;2.0
0;48;560;564;4;25;2.0
0;49;564;569;5;25;2.0
0;50;569;571;2;25;2.0
0;51;571;580;9;25;2.0
0;52;580;584;4;25;2.0
0;53;584;589;5;25;2.0
0;54;589;594;5;25;2.0
0;55;594;600;6;25;2.0
0;56;600;604;4;25;2.0
0;57;604;609;5;25;2.0
0;58;609;620;11;25;2.0
0;59;620;624;4;25;2.0
0;60;624;629;5;25;2.0
0;61;629;631;2;25;2.0
0;62;631;640;9;25;2.0
0;63;640;644;4;25;2.0
0;64;644;649;5;25;2.0
0;65;649;654;5;25;2.0
0;66;654;660;6;25;2.0
0;67;660;664;4;25;2.0
0;68;664;669;5;25;2.0
0;69;669;680;11;25;2.0
0;70;680;684;4;25;2.0
0;71;684;689;5;25;2.0
0;72;689;691;2;25;2.0
0;73;691;700;9;25;2.0
0;74;700;704;4;25;2.0
0;75;704;709;5;25;2.0
0;76;709;714;5;25;2.0
0;77;714;720;6;25;2.0
0;78;720;724;4;25;2.0
0;79;724;729;5;25;2.0
0;80;729;740;11;25;2.0
0;81;740;744;4;25;2.0
0;82;744;749;5;25;2.0
0;83;749;751;2;25;2.0
0;84;751;760;9;25;2.0
0;85;760;764;4;25;2.0
0;86;764;769;5;25;2.0
0;87;769;774;5;25;2.0
0;88;774;780;6;25;2.0
0;89;780;784;4;25;2.0
0;90;784;789;5;25;2.0
0;91;789;800;11;25;2.0
0;92;800;804;4;25;2.0
0;93;804;809;5;25;2.0
0;94;809;811;2;25;2.0
0;95;811;814;3;25;2.0
0;96;814;820;6;25;2.0
0;97;820;824;4;25;2.0
0;98;824;829;5;25;2.0
0;99;829;834;5;25;2.0
0;100;834;840;6;25;2.0
0;101;840;844;4;25;2.0
0;102;844;849;5;25;2.0
0;103;849;854;5;25;2.0
0;104;854;860;6;25;2.0
0;105;860;864;4;25;2.0
0;106;864;869;5;25;2.0
0;107;869;871;2;25;2.0
0;108;871;874;3;25;2.0
0;109;874;880;6;25;2.0
0;110;880;884;4;25;2.0
0;111;884;886;2;25;2.0
0;112;886;889;3;25;2.0
0;113;889;894;5;25;2.0
0;114;894;900;6;25;2.0
0;115;900;904;4;25;2.0
0;116;904;909;5;25;2.0
0;117;909;911;2;25;2.0
0;118;911;914;3;25;2.0
0;119;914;920;6;25;2.0
0;120;920;924;4;25;2.0
0;121;924;929;5;25;2.0
0;122;929;931;2;25;2.0
0;123;931;934;3;25;2.0
0;124;934;940;6;25;2.0
0;125;940;944;4;25;2.0
0;126;944;946;2;25;2.0
0;127;946;949;3;25;2.0
0;128;949;954;5;25;2.0
0;129;954;960;6;25;2.0
0;130;960;964;4;25;2.0
0;131;964;969;5;25;2.0
0;132;969;971;2;25;2.0
0;133;971;974;3;25;2.0
0;134;974;980;6;25;2.0
0;135;980;984;4;25;2.0
0;136;984;989;5;25;2.0
0;137;989;994;5;25;2.0
0;138;994;1000;6;25;2.0
0;139;1000;1004;4;25;2.0
0;140;1004;1006;2;25;2.0
0;141;1006;1009;3;25;2.0
0;142;1009;1019;10;25;2.0
0;143;1019;1020;1;25;2.0
0;144;1020;1029;9;25;2.0
0;145;1029;1034;5;25;2.0
0;146;1034;1040;6;25;2.0
0;147;1040;1046;6;25;2.0
0;148;1046;1049;3;25;2.0
0;149;1049;1060;11;25;2.0
0;150;1060;1064;4;25;2.0
0;151;1064;1066;2;25;2.0
0;152;1066;1069;3;25;2.0
0;153;1069;1073;4;25;2.0
0;154;1073;1079;6;25;2.0
0;155;1079;1080;1;25;2.0
0;156;1080;1089;9;25;2.0
0;157;1089;1094;5;25;2.0
0;158;1094;1108;14;25;2.0
0;159;1108;1109;1;25;2.0
0;160;1109;1111;2;25;2.0
0;161;1111;1121;10;25;2.0
0;162;1121;1130;9;25;2.0
0;163;1130;1133;3;25;2.0
0;164;1133;1141;8;25;2.0
0;165;1141;1146;5;25;2.0
0;166;1146;1153;7;25;2.0
0;167;1153;1161;8;25;2.0
0;168;1161;1169;8;25;2.0
0;169;1169;1171;2;25;2.0
0;170;1171;1178;7;25;2.0
0;171;1178;1181;3;25;2.0
0;172;1181;1190;9;25;2.0
0;173;1190;1198;8;25;2.0
0;174;1198;1201;3;25;2.0
0;175;1201;1203;2;25;2.0
0;176;1203;1226;23;25;2.0
0;177;1226;1229;3;25;2.0
0;178;1229;1233;4;25;2.0
0;179;1233;1238;5;25;2.0
0;180;1238;1251;13;25;2.0
0;181;1251;1270;19;25;2.0
0;182;1270;1273;3;25;2.0
0;183;1273;1276;3;25;2.0
0;184;1276;1301;25;25;2.0
0;185;1301;1304;3;25;2.0
0;186;1304;1308;4;25;2.0
0;187;1308;1313;5;25;2.0
0;188;1313;1331;18;25;2.0
0;189;1331;1348;17;25;2.0
0;190;1348;1351;3;25;2.0
0;191;1351;1366;15;25;2.0
0;192;1366;1381;15;25;2.0
0;193;1381;1396;15;25;2.0
0;194;1396;1411;15;25;2.0
0;195;1411;1426;15;25;2.0
0;196;1426;1441;15;25;2.0
0;197;1441;1456;15;25;2.0
0;198;1456;1471;15;25;2.0
0;199;1471;1486;15;25;2.0
0;200;1486;1501;15;25;2.0
0;201;1501;1516;15;25;2.0
0;202;1516;1531;15;25;2.0
0;203;1531;1546;15;25;2.0
0;204;1546;1561;15;25;2.0
0;205;1561;1576;15;25;2.0
0;206;1576;1591;15;25;2.0
0;207;1591;1606;15;25;2.0
0;208;1606;1621;15;25;2.0
0;209;1621;1636;15;25;2.0
0;210;1636;1651;15;25;2.0
0;211;1651;1666;15;25;2.0
0;212;1666;1680;14;25;2.0
1;0;242;338;96;42;2.0
1;1;338;349;11;42;2.0
1;2;349;353;4;42;2.0
1;3;353;361;8;42;2.0
1;4;361;368;7;42;2.0
1;5;368;369;1;42;2.0
1;6;369;379;10;42;2.0
1;7;379;383;4;42;2.0
1;8;383;389;6;42;2.0
1;9;389;391;2;42;2.0
1;10;391;393;2;42;2.0
1;11;393;399;6;42;2.0
1;12;399;403;4;42;2.0
1;13;403;409;6;42;2.0
1;14;409;413;4;42;2.0
1;15;413;419;6;42;2.0
1;16;419;421;2;42;2.0
1;17;421;423;2;42;2.0
1;18;423;429;6;42;2.0
1;19;429;433;4;42;2.0
1;20;433;439;6;42;2.0
1;21;439;443;4;42;2.0
1;22;443;449;6;42;2.0
1;23;449;451;2;42;2.0
1;24;451;453;2;42;2.0
1;25;453;459;6;42;2.0
1;26;459;463;4;42;2.0
1;27;463;469;6;42;2.0
1;28;469;473;4;42;2.0
1;29;473;479;6;42;2.0
1;30;479;481;2;42;2.0
1;31;481;483;2;42;2.0
1;32;483;489;6;42;2.0
1;33;489;493;4;42;2.0
1;34;493;499;6;42;2.0
1;35;499;503;4;42;2.0
1;36;503;509;6;42;2.0
1;37;509;511;2;42;2.0
1;38;511;513;2;42;2.0
1;39;513;519;6;42;2.0
1;40;519;523;4;42;2.0
1;41;523;529;6;42;2.0
1;42;529;533;4;42;2.0
1;43;533;539;6;42;2.0
1;44;539;543;4;42;2.0
1;45;543;549;6;42;2.0
1;46;549;559;10;42;2.0
1;47;559;563;4;42;2.0
1;48;563;569;6;42;2.0
1;49;569;571;2;42;2.0
1;50;571;579;8;42;2.0
1;51;579;583;4;42;2.0
1;52;583;589;6;42;2.0
1;53;589;593;4;42;2.0
1;54;593;599;6;42;2.0
1;55;599;603;4;42;2.0
1;56;603;609;6;42;2.0
1;57;609;619;10;42;2.0
1;58;619;623;4;42;2.0
1;59;623;629;6;42;2.0
1;60;629;631;2;42;2.0
1;61;631;639;8;42;2.0
1;62;639;643;4;42;2.0
1;63;643;649;6;42;2.0
1;64;649;653;4;42;2.0
1;65;653;659;6;42;2.0
1;66;659;663;4;42;2.0
1;67;663;669;6;42;2.0
1;68;669;679;10;42;2.0
1;69;679;683;4;42;2.0
1;70;683;689;6;42;2.0
1;71;689;691;2;42;2.0
1;72;691;699;8;42;2.0
1;73;699;703;4;42;2.0
1;74;703;709;6;42;2.0
1;75;709;713;4;42;2.0
1;76;713;719;6;42;2.0
1;77;719;723;4;42;2.0
1;78;723;729;6;42;2.0
1;79;729;739;10;42;2.0
1;80;739;743;4;42;2.0
1;81;743;749;6;42;2.0
1;82;749;751;2;42;2.0
1;83;751;759;8;42;2.0
1;84;759;763;4;42;2.0
1;85;763;769;6;42;2.0
1;86;769;773;4;42;2.0
1;87;773;779;6;42;2.0
1;88;779;783;4;42;2.0
1;89;783;789;6;42;2.0
1;90;789;799;10;42;2.0
1;91;799;803;4;42;2.0
1;92;803;809;6;42;2.0
1;93;809;811;2;42;2.0
1;94;811;813;2;42;2.0
1;95;813;819;6;42;2.0
1;96;819;823;4;42;2.0
1;97;823;829;6;42;2.0
1;98;829;833;4;42;2.0
1;99;833;839;6;42;2.0
1;100;839;843;4;42;2.0
1;101;843;848;5;42;2.0
1;102;848;849;1;42;2.0
1;103;849;854;5;42;2.0
1;104;854;859;5;42;2.0
1;105;859;863;4;42;2.0
1;106;863;869;6;42;2.0
1;107;869;871;2;42;2.0
1;108;871;873;2;42;2.0
1;109;873;879;6;42;2.0
1;110;879;883;4;42;2.0
1;111;883;886;3;42;2.0
1;112;886;889;3;42;2.0
1;113;889;893;4;42;2.0
1;114;893;899;6;42;2.0
1;115;899;903;4;42;2.0
1;116;903;908;5;42;2.0
1;117;908;909;1;42;2.0
1;118;909;911;2;42;2.0
1;119;911;913;2;42;2.0
1;120;913;919;6;42;2.0
1;121;919;923;4;42;2.0
1;122;923;929;6;42;2.0
1;123;929;931;2;42;2.0
1;124;931;933;2;42;2.0
1;125;933;939;6;42;2.0
1;126;939;943;4;42;2.0
1;127;943;946;3;42;2.0
1;128;946;949;3;42;2.0
1;129;949;953;4;42;2.0
1;130;953;959;6;42;2.0
1;131;959;963;4;42;2.0
1;132;963;968;5;42;2.0
1;133;968;969;1;42;2.0
1;134;969;971;2;42;2.0
1;135;971;973;2;42;2.0
1;136;973;979;6;42;2.0
1;137;979;983;4;42;2.0
1;138;983;989;6;42;2.0
1;139;989;993;4;42;2.0
1;140;993;994;1;42;2.0
1;141;994;999;5;42;2.0
1;142;999;1003;4;42;2.0
1;143;1003;1006;3;42;2.0
1;144;1006;1008;2;42;2.0
1;145;1008;1009;1;42;2.0
1;146;1009;1018;9;42;2.0
1;147;1018;1019;1;42;2.0
1;148;1019;1028;9;42;2.0
1;149;1028;1029;1;42;2.0
1;150;1029;1033;4;42;2.0
1;151;1033;1039;6;42;2.0
1;152;1039;1046;7;42;2.0
1;153;1046;1048;2;42;2.0
1;154;1048;1049;1;42;2.0
1;155;1049;1059;10;42;2.0
1;156;1059;1063;4;42;2.0
1;157;1063;1066;3;42;2.0
1;158;1066;1069;3;42;2.0
1;159;1069;1072;3;42;2.0
1;160;1072;1078;6;42;2.0
1;161;1078;1079;1;42;2.0
1;162;1079;1089;10;42;2.0
1;163;1089;1093;4;42;2.0
1;164;1093;1107;14;42;2.0
1;165;1107;1108;1;42;2.0
1;166;1108;1111;3;42;2.0
1;167;1111;1120;9;42;2.0
1;168;1120;1129;9;42;2.0
1;169;1129;1132;3;42;2.0
1;170;1132;1140;8;42;2.0
1;171;1140;1146;6;42;2.0
1;172;1146;1152;6;42;2.0
1;173;1152;1160;8;42;2.0
1;174;1160;1169;9;42;2.0
1;175;1169;1171;2;42;2.0
1;176;1171;1177;6;42;2.0
1;177;1177;1180;3;42;2.0
1;178;1180;1189;9;42;2.0
1;179;1189;1198;9;42;2.0
1;180;1198;1200;2;42;2.0
1;181;1200;1202;2;42;2.0
1;182;1202;1225;23;42;2.0
1;183;1225;1229;4;42;2.0
1;184;1229;1233;4;42;2.0
1;185;1233;1237;4;42;2.0
1;186;1237;1250;13;42;2.0
1;187;1250;1269;19;42;2.0
1;188;1269;1272;3;42;2.0
1;189;1272;1273;1;42;2.0
1;190;1273;1275;2;42;2.0
1;191;1275;1300;25;42;2.0
1;192;1300;1304;4;42;2.0
1;193;1304;1307;3;42;2.0
1;194;1307;1313;6;42;2.0
1;195;1313;1330;17;42;2.0
1;196;1330;1348;18;42;2.0
1;197;1348;1350;2;42;2.0
1;198;1350;1365;15;42;2.0
1;199;1365;1380;15;42;2.0
1;200;1380;1395;15;42;2.0
1;201;1395;1410;15;42;2.0
1;202;1410;1425;15;42;2.0
1;203;1425;1440;15;42;2.0
1;204;1440;1455;15;42;2.0
1;205;1455;1470;15;42;2.0
1;206;1470;1485;15;42;2.0
1;207;1485;1500;15;42;2.0
1;208;1500;1515;15;42;2.0
1;209;1515;1530;15;42;2.0
1;210;1530;1545;15;42;2.0
1;211;1545;1560;15;42;2.0
1;212;1560;1575;15;42;2.0
1;213;1575;1590;15;42;2.0
1;214;1590;1605;15;42;2.0
1;215;1605;1620;15;42;2.0
1;216;1620;1635;15;42;2.0
1;217;1635;1650;15;42;2.0
1;218;1650;1665;15;42;2.0
1;219;1665;1680;15;42;2.0
2;0;246;333;87;49;2.0
2;1;333;340;7;49;2.0
2;2;340;351;11;49;2.0
2;3;351;352;1;49;2.0
2;4;352;355;3;49;2.0
2;5;355;356;1;49;2.0
2;6;356;357;1;49;2.0
2;7;357;370;13;49;2.0
2;8;370;372;2;49;2.0
2;9;372;381;9;49;2.0
2;10;381;385;4;49;2.0
2;11;385;386;1;49;2.0
2;12;386;387;1;49;2.0
2;13;387;392;5;49;2.0
2;14;392;395;3;49;2.0
2;15;395;401;6;49;2.0
2;16;401;405;4;49;2.0
2;17;405;412;7;49;2.0
2;18;412;415;3;49;2.0
2;19;415;416;1;49;2.0
2;20;416;417;1;49;2.0
2;21;417;421;4;49;2.0
2;22;421;425;4;49;2.0
2;23;425;432;7;49;2.0
2;24;432;435;3;49;2.0
2;25;435;441;6;49;2.0
2;26;441;445;4;49;2.0
2;27;445;446;1;49;2.0
2;28;446;447;1;49;2.0
2;29;447;452;5;49;2.0
2;30;452;455;3;49;2.0
2;31;455;461;6;49;2.0
2;32;461;465;4;49;2.0
2;33;465;472;7;49;2.0
2;34;472;475;3;49;2.0
2;35;475;476;1;49;2.0
2;36;476;477;1;49;2.0
2;37;477;481;4;49;2.0
2;38;481;485;4;49;2.0
2;39;485;492;7;49;2.0
2;40;492;495;3;49;2.0
2;41;495;501;6;49;2.0
2;42;501;505;4;49;2.0
2;43;505;506;1;49;2.0
2;44;506;512;6;49;2.0
2;45;512;515;3;49;2.0
2;46;515;521;6;49;2.0
2;47;521;525;4;49;2.0
2;48;525;532;7;49;2.0
2;49;532;537;5;49;2.0
2;50;537;541;4;49;2.0
2;51;541;545;4;49;2.0
2;52;545;552;7;49;2.0
2;53;552;561;9;49;2.0
2;54;561;565;4;49;2.0
2;55;565;566;1;49;2.0
2;56;566;572;6;49;2.0
2;57;572;581;9;49;2.0
2;58;581;585;4;49;2.0
2;59;585;592;7;49;2.0
2;60;592;597;5;49;2.0
2;61;597;601;4;49;2.0
2;62;601;605;4;49;2.0
2;63;605;612;7;49;2.0
2;64;612;621;9;49;2.0
2;65;621;625;4;49;2.0
2;66;625;626;1;49;2.0
2;67;626;632;6;49;2.0
2;68;632;641;9;49;2.0
2;69;641;645;4;49;2.0
2;70;645;652;7;49;2.0
2;71;652;657;5;49;2.0
2;72;657;661;4;49;2.0
2;73;661;665;4;49;2.0
2;74;665;672;7;49;2.0
2;75;672;681;9;49;2.0
2;76;681;685;4;49;2.0
2;77;685;686;1;49;2.0
2;78;686;692;6;49;2.0
2;79;692;701;9;49;2.0
2;80;701;705;4;49;2.0
2;81;705;712;7;49;2.0
2;82;712;717;5;49;2.0
2;83;717;721;4;49;2.0
2;84;721;725;4;49;2.0
2;85;725;732;7;49;2.0
2;86;732;741;9;49;2.0
2;87;741;745;4;49;2.0
2;88;745;746;1;49;2.0
2;89;746;752;6;49;2.0
2;90;752;761;9;49;2.0
2;91;761;765;4;49;2.0
2;92;765;772;7;49;2.0
2;93;772;777;5;49;2.0
2;94;777;781;4;49;2.0
2;95;781;785;4;49;2.0
2;96;785;792;7;49;2.0
2;97;792;801;9;49;2.0
2;98;801;805;4;49;2.0
2;99;805;806;1;49;2.0
2;100;806;812;6;49;2.0
2;101;812;817;5;49;2.0
2;102;817;821;4;49;2.0
2;103;821;825;4;49;2.0
2;104;825;832;7;49;2.0
2;105;832;837;5;49;2.0
2;106;837;841;4;49;2.0
2;107;841;845;4;49;2.0
2;108;845;849;4;49;2.0
2;109;849;852;3;49;2.0
2;110;852;861;9;49;2.0
2;111;861;865;4;49;2.0
2;112;865;866;1;49;2.0
2;113;866;872;6;49;2.0
2;114;872;875;3;49;2.0
2;115;875;877;2;49;2.0
2;116;877;881;4;49;2.0
2;117;881;885;4;49;2.0
2;118;885;892;7;49;2.0
2;119;892;895;3;49;2.0
2;120;895;897;2;49;2.0
2;121;897;901;4;49;2.0
2;122;901;905;4;49;2.0
2;123;905;906;1;49;2.0
2;124;906;912;6;49;2.0
2;125;912;915;3;49;2.0
2;126;915;921;6;49;2.0
2;127;921;925;4;49;2.0
2;128;925;926;1;49;2.0
2;129;926;932;6;49;2.0
2;130;932;935;3;49;2.0
2;131;935;937;2;49;2.0
2;132;937;941;4;49;2.0
2;133;941;945;4;49;2.0
2;134;945;952;7;49;2.0
2;135;952;955;3;49;2.0
2;136;955;957;2;49;2.0
2;137;957;961;4;49;2.0
2;138;961;965;4;49;2.0
2;139;965;966;1;49;2.0
2;140;966;972;6;49;2.0
2;141;972;975;3;49;2.0
2;142;975;981;6;49;2.0
2;143;981;985;4;49;2.0
2;144;985;989;4;49;2.0
2;145;989;992;3;49;2.0
2;146;992;995;3;49;2.0
2;147;995;1001;6;49;2.0
2;148;1001;1005;4;49;2.0
2;149;1005;1012;7;49;2.0
2;150;1012;1020;8;49;2.0
2;151;1020;1021;1;49;2.0
2;152;1021;1032;11;49;2.0
2;153;1032;1035;3;49;2.0
2;154;1035;1041;6;49;2.0
2;155;1041;1050;9;49;2.0
2;156;1050;1052;2;49;2.0
2;157;1052;1061;9;49;2.0
2;158;1061;1065;4;49;2.0
2;159;1065;1072;7;49;2.0
2;160;1072;1076;4;49;2.0
2;161;1076;1080;4;49;2.0
2;162;1080;1081;1;49;2.0
2;163;1081;1092;11;49;2.0
2;164;1092;1095;3;49;2.0
2;165;1095;1106;11;49;2.0
2;166;1106;1109;3;49;2.0
2;167;1109;1110;1;49;2.0
2;168;1110;1114;4;49;2.0
2;169;1114;1122;8;49;2.0
2;170;1122;1133;11;49;2.0
2;171;1133;1134;1;49;2.0
2;172;1134;1142;8;49;2.0
2;173;1142;1149;7;49;2.0
2;174;1149;1154;5;49;2.0
2;175;1154;1162;8;49;2.0
2;176;1162;1164;2;49;2.0
2;177;1164;1174;10;49;2.0
2;178;1174;1179;5;49;2.0
2;179;1179;1182;3;49;2.0
2;180;1182;1193;11;49;2.0
2;181;1193;1201;8;49;2.0
2;182;1201;1202;1;49;2.0
2;183;1202;1204;2;49;2.0
2;184;1204;1224;20;49;2.0
2;185;1224;1227;3;49;2.0
2;186;1227;1236;9;49;2.0
2;187;1236;1239;3;49;2.0
2;188;1239;1252;13;49;2.0
2;189;1252;1273;21;49;2.0
2;190;1273;1274;1;49;2.0
2;191;1274;1276;2;49;2.0
2;192;1276;1277;1;49;2.0
2;193;1277;1299;22;49;2.0
2;194;1299;1302;3;49;2.0
2;195;1302;1309;7;49;2.0
2;196;1309;1316;7;49;2.0
2;197;1316;1332;16;49;2.0
2;198;1332;1351;19;49;2.0
2;199;1351;1352;1;49;2.0
2;200;1352;1367;15;49;2.0
2;201;1367;1382;15;49;2.0
2;202;1382;1397;15;49;2.0
2;203;1397;1412;15;49;2.0
2;204;1412;1427;15;49;2.0
2;205;1427;1442;15;49;2.0
2;206;1442;1457;15;49;2.0
2;207;1457;1472;15;49;2.0
2;208;1472;1487;15;49;2.0
2;209;1487;1502;15;49;2.0
2;210;1502;1517;15;49;2.0
2;211;1517;1532;15;49;2.0
2;212;1532;1547;15;49;2.0
2;213;1547;1562;15;49;2.0
2;214;1562;1577;15;49;2.0
2;215;1577;1592;15;49;2.0
2;216;1592;1607;15;49;2.0
2;217;1607;1622;15;49;2.0
2;218;1622;1637;15;49;2.0
2;219;1637;1652;15;49;2.0
2;220;1652;1667;15;49;2.0
2;221;1667;1680;13;49;2.0
3;0;244;334;90;77;2.0
3;1;334;339;5;77;2.0
3;2;339;345;6;77;2.0
3;3;345;348;3;77;2.0
3;4;348;349;1;77;2.0
3;5;349;354;5;77;2.0
3;6;354;362;8;77;2.0
3;7;362;364;2;77;2.0
3;8;364;368;4;77;2.0
3;9;368;375;7;77;2.0
3;10;375;379;4;77;2.0
3;11;379;384;5;77;2.0
3;12;384;388;4;77;2.0
3;13;388;389;1;77;2.0
3;14;389;392;3;77;2.0
3;15;392;395;3;77;2.0
3;16;395;399;4;77;2.0
3;17;399;408;9;77;2.0
3;18;408;409;1;77;2.0
3;19;409;414;5;77;2.0
3;20;414;415;1;77;2.0
3;21;415;419;4;77;2.0
3;22;419;422;3;77;2.0
3;23;422;428;6;77;2.0
3;24;428;429;1;77;2.0
3;25;429;435;6;77;2.0
3;26;435;439;4;77;2.0
3;27;439;444;5;77;2.0
3;28;444;448;4;77;2.0
3;29;448;449;1;77;2.0
3;30;449;452;3;77;2.0
3;31;452;455;3;77;2.0
3;32;455;459;4;77;2.0
3;33;459;468;9;77;2.0
3;34;468;469;1;77;2.0
3;35;469;474;5;77;2.0
3;36;474;475;1;77;2.0
3;37;475;479;4;77;2.0
3;38;479;482;3;77;2.0
3;39;482;488;6;77;2.0
3;40;488;489;1;77;2.0
3;41;489;495;6;77;2.0
3;42;495;499;4;77;2.0
3;43;499;508;9;77;2.0
3;44;508;509;1;77;2.0
3;45;509;512;3;77;2.0
3;46;512;515;3;77;2.0
3;47;515;519;4;77;2.0
3;48;519;528;9;77;2.0
3;49;528;534;6;77;2.0
3;50;534;535;1;77;2.0
3;51;535;539;4;77;2.0
3;52;539;548;9;77;2.0
3;53;548;555;7;77;2.0
3;54;555;559;4;77;2.0
3;55;559;568;9;77;2.0
3;56;568;572;4;77;2.0
3;57;572;575;3;77;2.0
3;58;575;579;4;77;2.0
3;59;579;588;9;77;2.0
3;60;588;594;6;77;2.0
3;61;594;595;1;77;2.0
3;62;595;599;4;77;2.0
3;63;599;608;9;77;2.0
3;64;608;615;7;77;2.0
3;65;615;619;4;77;2.0
3;66;619;628;9;77;2.0
3;67;628;632;4;77;2.0
3;68;632;635;3;77;2.0
3;69;635;639;4;77;2.0
3;70;639;648;9;77;2.0
3;71;648;654;6;77;2.0
3;72;654;655;1;77;2.0
3;73;655;659;4;77;2.0
3;74;659;668;9;77;2.0
3;75;668;675;7;77;2.0
3;76;675;679;4;77;2.0
3;77;679;688;9;77;2.0
3;78;688;692;4;77;2.0
3;79;692;695;3;77;2.0
3;80;695;699;4;77;2.0
3;81;699;708;9;77;2.0
3;82;708;714;6;77;2.0
3;83;714;715;1;77;2.0
3;84;715;719;4;77;2.0
3;85;719;728;9;77;2.0
3;86;728;735;7;77;2.0
3;87;735;739;4;77;2.0
3;88;739;748;9;77;2.0
3;89;748;752;4;77;2.0
3;90;752;755;3;77;2.0
3;91;755;759;4;77;2.0
3;92;759;768;9;77;2.0
3;93;768;774;6;77;2.0
3;94;774;775;1;77;2.0
3;95;775;779;4;77;2.0
3;96;779;788;9;77;2.0
3;97;788;795;7;77;2.0
3;98;795;799;4;77;2.0
3;99;799;808;9;77;2.0
3;100;808;812;4;77;2.0
3;101;812;814;2;77;2.0
3;102;814;815;1;77;2.0
3;103;815;819;4;77;2.0
3;104;819;828;9;77;2.0
3;105;828;834;6;77;2.0
3;106;834;835;1;77;2.0
3;107;835;839;4;77;2.0
3;108;839;848;9;77;2.0
3;109;848;849;1;77;2.0
3;110;849;855;6;77;2.0
3;111;855;859;4;77;2.0
3;112;859;868;9;77;2.0
3;113;868;869;1;77;2.0
3;114;869;872;3;77;2.0
3;115;872;874;2;77;2.0
3;116;874;875;1;77;2.0
3;117;875;879;4;77;2.0
3;118;879;887;8;77;2.0
3;119;887;888;1;77;2.0
3;120;888;889;1;77;2.0
3;121;889;894;5;77;2.0
3;122;894;895;1;77;2.0
3;123;895;899;4;77;2.0
3;124;899;908;9;77;2.0
3;125;908;909;1;77;2.0
3;126;909;912;3;77;2.0
3;127;912;915;3;77;2.0
3;128;915;919;4;77;2.0
3;129;919;928;9;77;2.0
3;130;928;929;1;77;2.0
3;131;929;932;3;77;2.0
3;132;932;934;2;77;2.0
3;133;934;935;1;77;2.0
3;134;935;939;4;77;2.0
3;135;939;947;8;77;2.0
3;136;947;948;1;77;2.0
3;137;948;949;1;77;2.0
3;138;949;954;5;77;2.0
3;139;954;955;1;77;2.0
3;140;955;959;4;77;2.0
3;141;959;968;9;77;2.0
3;142;968;969;1;77;2.0
3;143;969;972;3;77;2.0
3;144;972;975;3;77;2.0
3;145;975;979;4;77;2.0
3;146;979;988;9;77;2.0
3;147;988;989;1;77;2.0
3;148;989;995;6;77;2.0
3;149;995;999;4;77;2.0
3;150;999;1007;8;77;2.0
3;151;1007;1008;1;77;2.0
3;152;1008;1009;1;77;2.0
3;153;1009;1014;5;77;2.0
3;154;1014;1015;1;77;2.0
3;155;1015;1028;13;77;2.0
3;156;1028;1029;1;77;2.0
3;157;1029;1035;6;77;2.0
3;158;1035;1044;9;77;2.0
3;159;1044;1047;3;77;2.0
3;160;1047;1048;1;77;2.0
3;161;1048;1055;7;77;2.0
3;162;1055;1059;4;77;2.0
3;163;1059;1067;8;77;2.0
3;164;1067;1068;1;77;2.0
3;165;1068;1073;5;77;2.0
3;166;1073;1074;1;77;2.0
3;167;1074;1075;1;77;2.0
3;168;1075;1088;13;77;2.0
3;169;1088;1089;1;77;2.0
3;170;1089;1103;14;77;2.0
3;171;1103;1104;1;77;2.0
3;172;1104;1110;6;77;2.0
3;173;1110;1112;2;77;2.0
3;174;1112;1116;4;77;2.0
3;175;1116;1128;12;77;2.0
3;176;1128;1130;2;77;2.0
3;177;1130;1136;6;77;2.0
3;178;1136;1145;9;77;2.0
3;179;1145;1148;3;77;2.0
3;180;1148;1156;8;77;2.0
3;181;1156;1170;14;77;2.0
3;182;1170;1173;3;77;2.0
3;183;1173;1176;3;77;2.0
3;184;1176;1190;14;77;2.0
3;185;1190;1196;6;77;2.0
3;186;1196;1197;1;77;2.0
3;187;1197;1198;1;77;2.0
3;188;1198;1221;23;77;2.0
3;189;1221;1230;9;77;2.0
3;190;1230;1232;2;77;2.0
3;191;1232;1233;1;77;2.0
3;192;1233;1246;13;77;2.0
3;193;1246;1268;22;77;2.0
3;194;1268;1270;2;77;2.0
3;195;1270;1271;1;77;2.0
3;196;1271;1272;1;77;2.0
3;197;1272;1296;24;77;2.0
3;198;1296;1303;7;77;2.0
3;199;1303;1305;2;77;2.0
3;200;1305;1312;7;77;2.0
3;201;1312;1326;14;77;2.0
3;202;1326;1346;20;77;2.0
3;203;1346;1347;1;77;2.0
3;204;1347;1361;14;77;2.0
3;205;1361;1376;15;77;2.0
3;206;1376;1391;15;77;2.0
3;207;1391;1406;15;77;2.0
3;208;1406;1421;15;77;2.0
3;209;1421;1436;15;77;2.0
3;210;1436;1451;15;77;2.0
3;211;1451;1466;15;77;2.0
3;212;1466;1481;15;77;2.0
3;213;1481;1496;15;77;2.0
3;214;1496;1511;15;77;2.0
3;215;1511;1526;15;77;2.0
3;216;1526;1541;15;77;2.0
3;217;1541;1556;15;77;2.0
3;218;1556;1571;15;77;2.0
3;219;1571;1586;15;77;2.0
3;220;1586;1601;15;77;2.0
3;221;1601;1616;15;77;2.0
3;222;1616;1631;15;77;2.0
3;223;1631;1646;15;77;2.0
3;224;1646;1661;15;77;2.0
3;225;1661;1680;19;77;2.0
4;0;243;338;95;93;2.0
4;1;338;340;2;93;2.0
4;2;340;346;6;93;2.0
4;3;346;349;3;93;2.0
4;4;349;352;3;93;2.0
4;5;352;353;1;93;2.0
4;6;353;363;10;93;2.0
4;7;363;366;3;93;2.0
4;8;366;368;2;93;2.0
4;9;368;379;11;93;2.0
4;10;379;382;3;93;2.0
4;11;382;383;1;93;2.0
4;12;383;386;3;93;2.0
4;13;386;393;7;93;2.0
4;14;393;399;6;93;2.0
4;15;399;403;4;93;2.0
4;16;403;406;3;93;2.0
4;17;406;412;6;93;2.0
4;18;412;413;1;93;2.0
4;19;413;419;6;93;2.0
4;20;419;423;4;93;2.0
4;21;423;426;3;93;2.0
4;22;426;433;7;93;2.0
4;23;433;439;6;93;2.0
4;24;439;442;3;93;2.0
4;25;442;443;1;93;2.0
4;26;443;446;3;93;2.0
4;27;446;453;7;93;2.0
4;28;453;459;6;93;2.0
4;29;459;463;4;93;2.0
4;30;463;466;3;93;2.0
4;31;466;472;6;93;2.0
4;32;472;473;1;93;2.0
4;33;473;479;6;93;2.0
4;34;479;483;4;93;2.0
4;35;483;486;3;93;2.0
4;36;486;493;7;93;2.0
4;37;493;499;6;93;2.0
4;38;499;503;4;93;2.0
4;39;503;506;3;93;2.0
4;40;506;513;7;93;2.0
4;41;513;519;6;93;2.0
4;42;519;523;4;93;2.0
4;43;523;526;3;93;2.0
4;44;526;532;6;93;2.0
4;45;532;539;7;93;2.0
4;46;539;543;4;93;2.0
4;47;543;546;3;93;2.0
4;48;546;559;13;93;2.0
4;49;559;563;4;93;2.0
4;50;563;566;3;93;2.0
4;51;566;573;7;93;2.0
4;52;573;579;6;93;2.0
4;53;579;583;4;93;2.0
4;54;583;586;3;93;2.0
4;55;586;592;6;93;2.0
4;56;592;599;7;93;2.0
4;57;599;603;4;93;2.0
4;58;603;606;3;93;2.0
4;59;606;619;13;93;2.0
4;60;619;623;4;93;2.0
4;61;623;626;3;93;2.0
4;62;626;633;7;93;2.0
4;63;633;639;6;93;2.0
4;64;639;643;4;93;2.0
4;65;643;646;3;93;2.0
4;66;646;652;6;93;2.0
4;67;652;659;7;93;2.0
4;68;659;663;4;93;2.0
4;69;663;666;3;93;2.0
4;70;666;679;13;93;2.0
4;71;679;683;4;93;2.0
4;72;683;686;3;93;2.0
4;73;686;693;7;93;2.0
4;74;693;699;6;93;2.0
4;75;699;703;4;93;2.0
4;76;703;706;3;93;2.0
4;77;706;712;6;93;2.0
4;78;712;719;7;93;2.0
4;79;719;723;4;93;2.0
4;80;723;726;3;93;2.0
4;81;726;739;13;93;2.0
4;82;739;743;4;93;2.0
4;83;743;746;3;93;2.0
4;84;746;753;7;93;2.0
4;85;753;759;6;93;2.0
4;86;759;763;4;93;2.0
4;87;763;766;3;93;2.0
4;88;766;772;6;93;2.0
4;89;772;779;7;93;2.0
4;90;779;783;4;93;2.0
4;91;783;786;3;93;2.0
4;92;786;799;13;93;2.0
4;93;799;803;4;93;2.0
4;94;803;806;3;93;2.0
4;95;806;812;6;93;2.0
4;96;812;813;1;93;2.0
4;97;813;819;6;93;2.0
4;98;819;823;4;93;2.0
4;99;823;826;3;93;2.0
4;100;826;832;6;93;2.0
4;101;832;839;7;93;2.0
4;102;839;843;4;93;2.0
4;103;843;846;3;93;2.0
4;104;846;847;1;93;2.0
4;105;847;856;9;93;2.0
4;106;856;859;3;93;2.0
4;107;859;863;4;93;2.0
4;108;863;866;3;93;2.0
4;109;866;872;6;93;2.0
4;110;872;873;1;93;2.0
4;111;873;879;6;93;2.0
4;112;879;883;4;93;2.0
4;113;883;886;3;93;2.0
4;114;886;888;2;93;2.0
4;115;888;892;4;93;2.0
4;116;892;893;1;93;2.0
4;117;893;899;6;93;2.0
4;118;899;903;4;93;2.0
4;119;903;906;3;93;2.0
4;120;906;907;1;93;2.0
4;121;907;913;6;93;2.0
4;122;913;919;6;93;2.0
4;123;919;923;4;93;2.0
4;124;923;926;3;93;2.0
4;125;926;932;6;93;2.0
4;126;932;933;1;93;2.0
4;127;933;939;6;93;2.0
4;128;939;943;4;93;2.0
4;129;943;946;3;93;2.0
4;130;946;948;2;93;2.0
4;131;948;952;4;93;2.0
4;132;952;953;1;93;2.0
4;133;953;959;6;93;2.0
4;134;959;963;4;93;2.0
4;135;963;966;3;93;2.0
4;136;966;967;1;93;2.0
4;137;967;973;6;93;2.0
4;138;973;979;6;93;2.0
4;139;979;983;4;93;2.0
4;140;983;986;3;93;2.0
4;141;986;993;7;93;2.0
4;142;993;996;3;93;2.0
4;143;996;999;3;93;2.0
4;144;999;1003;4;93;2.0
4;145;1003;1006;3;93;2.0
4;146;1006;1007;1;93;2.0
4;147;1007;1008;1;93;2.0
4;148;1008;1018;10;93;2.0
4;149;1018;1019;1;93;2.0
4;150;1019;1026;7;93;2.0
4;151;1026;1027;1;93;2.0
4;152;1027;1033;6;93;2.0
4;153;1033;1039;6;93;2.0
4;154;1039;1046;7;93;2.0
4;155;1046;1048;2;93;2.0
4;156;1048;1059;11;93;2.0
4;157;1059;1063;4;93;2.0
4;158;1063;1066;3;93;2.0
4;159;1066;1068;2;93;2.0
4;160;1068;1071;3;93;2.0
4;161;1071;1078;7;93;2.0
4;162;1078;1079;1;93;2.0
4;163;1079;1086;7;93;2.0
4;164;1086;1093;7;93;2.0
4;165;1093;1107;14;93;2.0
4;166;1107;1108;1;93;2.0
4;167;1108;1113;5;93;2.0
4;168;1113;1120;7;93;2.0
4;169;1120;1128;8;93;2.0
4;170;1128;1132;4;93;2.0
4;171;1132;1140;8;93;2.0
4;172;1140;1143;3;93;2.0
4;173;1143;1152;9;93;2.0
4;174;1152;1160;8;93;2.0
4;175;1160;1168;8;93;2.0
4;176;1168;1171;3;93;2.0
4;177;1171;1177;6;93;2.0
4;178;1177;1180;3;93;2.0
4;179;1180;1188;8;93;2.0
4;180;1188;1195;7;93;2.0
4;181;1195;1200;5;93;2.0
4;182;1200;1202;2;93;2.0
4;183;1202;1225;23;93;2.0
4;184;1225;1230;5;93;2.0
4;185;1230;1231;1;93;2.0
4;186;1231;1237;6;93;2.0
4;187;1237;1250;13;93;2.0
4;188;1250;1268;18;93;2.0
4;189;1268;1270;2;93;2.0
4;190;1270;1272;2;93;2.0
4;191;1272;1275;3;93;2.0
4;192;1275;1300;25;93;2.0
4;193;1300;1306;6;93;2.0
4;194;1306;1307;1;93;2.0
4;195;1307;1310;3;93;2.0
4;196;1310;1330;20;93;2.0
4;197;1330;1345;15;93;2.0
4;198;1345;1350;5;93;2.0
4;199;1350;1365;15;93;2.0
4;200;1365;1380;15;93;2.0
4;201;1380;1395;15;93;2.0
4;202;1395;1410;15;93;2.0
4;203;1410;1425;15;93;2.0
4;204;1425;1440;15;93;2.0
4;205;1440;1455;15;93;2.0
4;206;1455;1470;15;93;2.0
4;207;1470;1485;15;93;2.0
4;208;1485;1500;15;93;2.0
4;209;1500;1515;15;93;2.0
4;210;1515;1530;15;93;2.0
4;211;1530;1545;15;93;2.0
4;212;1545;1560;15;93;2.0
4;213;1560;1575;15;93;2.0
4;214;1575;1590;15;93;2.0
4;215;1590;1605;15;93;2.0
4;216;1605;1620;15;93;2.0
4;217;1620;1635;15;93;2.0
4;218;1635;1650;15;93;2.0
4;219;1650;1665;15;93;2.0
4;220;1665;1680;15;93;2.0
5;0;245;335;90;112;2.0
5;1;335;339;4;112;2.0
5;2;339;350;11;112;2.0
5;3;350;351;1;112;2.0
5;4;351;354;3;112;2.0
5;5;354;356;2;112;2.0
5;6;356;358;2;112;2.0
5;7;358;369;11;112;2.0
5;8;369;371;2;112;2.0
5;9;371;380;9;112;2.0
5;10;380;384;4;112;2.0
5;11;384;386;2;112;2.0
5;12;386;388;2;112;2.0
5;13;388;391;3;112;2.0
5;14;391;394;3;112;2.0
5;15;394;400;6;112;2.0
5;16;400;404;4;112;2.0
5;17;404;411;7;112;2.0
5;18;411;414;3;112;2.0
5;19;414;416;2;112;2.0
5;20;416;418;2;112;2.0
5;21;418;420;2;112;2.0
5;22;420;424;4;112;2.0
5;23;424;431;7;112;2.0
5;24;431;434;3;112;2.0
5;25;434;440;6;112;2.0
5;26;440;444;4;112;2.0
5;27;444;446;2;112;2.0
5;28;446;448;2;112;2.0
5;29;448;451;3;112;2.0
5;30;451;454;3;112;2.0
5;31;454;460;6;112;2.0
5;32;460;464;4;112;2.0
5;33;464;471;7;112;2.0
5;34;471;474;3;112;2.0
5;35;474;476;2;112;2.0
5;36;476;478;2;112;2.0
5;37;478;480;2;112;2.0
5;38;480;484;4;112;2.0
5;39;484;491;7;112;2.0
5;40;491;494;3;112;2.0
5;41;494;500;6;112;2.0
5;42;500;504;4;112;2.0
5;43;504;508;4;112;2.0
5;44;508;511;3;112;2.0
5;45;511;514;3;112;2.0
5;46;514;520;6;112;2.0
5;47;520;524;4;112;2.0
5;48;524;531;7;112;2.0
5;49;531;536;5;112;2.0
5;50;536;540;4;112;2.0
5;51;540;544;4;112;2.0
5;52;544;551;7;112;2.0
5;53;551;560;9;112;2.0
5;54;560;564;4;112;2.0
5;55;564;568;4;112;2.0
5;56;568;571;3;112;2.0
5;57;571;580;9;112;2.0
5;58;580;584;4;112;2.0
5;59;584;591;7;112;2.0
5;60;591;596;5;112;2.0
5;61;596;600;4;112;2.0
5;62;600;604;4;112;2.0
5;63;604;611;7;112;2.0
5;64;611;620;9;112;2.0
5;65;620;624;4;112;2.0
5;66;624;628;4;112;2.0
5;67;628;631;3;112;2.0
5;68;631;640;9;112;2.0
5;69;640;644;4;112;2.0
5;70;644;651;7;112;2.0
5;71;651;656;5;112;2.0
5;72;656;660;4;112;2.0
5;73;660;664;4;112;2.0
5;74;664;671;7;112;2.0
5;75;671;680;9;112;2.0
5;76;680;684;4;112;2.0
5;77;684;688;4;112;2.0
5;78;688;691;3;112;2.0
5;79;691;700;9;112;2.0
5;80;700;704;4;112;2.0
5;81;704;711;7;112;2.0
5;82;711;716;5;112;2.0
5;83;716;720;4;112;2.0
5;84;720;724;4;112;2.0
5;85;724;731;7;112;2.0
5;86;731;740;9;112;2.0
5;87;740;744;4;112;2.0
5;88;744;748;4;112;2.0
5;89;748;751;3;112;2.0
5;90;751;760;9;112;2.0
5;91;760;764;4;112;2.0
5;92;764;771;7;112;2.0
5;93;771;776;5;112;2.0
5;94;776;780;4;112;2.0
5;95;780;784;4;112;2.0
5;96;784;791;7;112;2.0
5;97;791;800;9;112;2.0
5;98;800;804;4;112;2.0
5;99;804;808;4;112;2.0
5;100;808;811;3;112;2.0
5;101;811;816;5;112;2.0
5;102;816;820;4;112;2.0
5;103;820;824;4;112;2.0
5;104;824;831;7;112;2.0
5;105;831;836;5;112;2.0
5;106;836;840;4;112;2.0
5;107;840;844;4;112;2.0
5;108;844;851;7;112;2.0
5;109;851;860;9;112;2.0
5;110;860;864;4;112;2.0
5;111;864;868;4;112;2.0
5;112;868;871;3;112;2.0
5;113;871;874;3;112;2.0
5;114;874;876;2;112;2.0
5;115;876;880;4;112;2.0
5;116;880;883;3;112;2.0
5;117;883;884;1;112;2.0
5;118;884;891;7;112;2.0
5;119;891;894;3;112;2.0
5;120;894;896;2;112;2.0
5;121;896;900;4;112;2.0
5;122;900;904;4;112;2.0
5;123;904;908;4;112;2.0
5;124;908;911;3;112;2.0
5;125;911;914;3;112;2.0
5;126;914;920;6;112;2.0
5;127;920;924;4;112;2.0
5;128;924;928;4;112;2.0
5;129;928;931;3;112;2.0
5;130;931;934;3;112;2.0
5;131;934;936;2;112;2.0
5;132;936;940;4;112;2.0
5;133;940;943;3;112;2.0
5;134;943;944;1;112;2.0
5;135;944;951;7;112;2.0
5;136;951;954;3;112;2.0
5;137;954;956;2;112;2.0
5;138;956;960;4;112;2.0
5;139;960;964;4;112;2.0
5;140;964;968;4;112;2.0
5;141;968;971;3;112;2.0
5;142;971;974;3;112;2.0
5;143;974;980;6;112;2.0
5;144;980;984;4;112;2.0
5;145;984;991;7;112;2.0
5;146;991;994;3;112;2.0
5;147;994;1000;6;112;2.0
5;148;1000;1003;3;112;2.0
5;149;1003;1004;1;112;2.0
5;150;1004;1011;7;112;2.0
5;151;1011;1019;8;112;2.0
5;152;1019;1020;1;112;2.0
5;153;1020;1031;11;112;2.0
5;154;1031;1034;3;112;2.0
5;155;1034;1040;6;112;2.0
5;156;1040;1043;3;112;2.0
5;157;1043;1049;6;112;2.0
5;158;1049;1051;2;112;2.0
5;159;1051;1060;9;112;2.0
5;160;1060;1063;3;112;2.0
5;161;1063;1064;1;112;2.0
5;162;1064;1071;7;112;2.0
5;163;1071;1075;4;112;2.0
5;164;1075;1079;4;112;2.0
5;165;1079;1080;1;112;2.0
5;166;1080;1091;11;112;2.0
5;167;1091;1094;3;112;2.0
5;168;1094;1108;14;112;2.0
5;169;1108;1109;1;112;2.0
5;170;1109;1113;4;112;2.0
5;171;1113;1121;8;112;2.0
5;172;1121;1132;11;112;2.0
5;173;1132;1133;1;112;2.0
5;174;1133;1141;8;112;2.0
5;175;1141;1148;7;112;2.0
5;176;1148;1153;5;112;2.0
5;177;1153;1161;8;112;2.0
5;178;1161;1166;5;112;2.0
5;179;1166;1173;7;112;2.0
5;180;1173;1178;5;112;2.0
5;181;1178;1181;3;112;2.0
5;182;1181;1192;11;112;2.0
5;183;1192;1200;8;112;2.0
5;184;1200;1201;1;112;2.0
5;185;1201;1203;2;112;2.0
5;186;1203;1226;23;112;2.0
5;187;1226;1235;9;112;2.0
5;188;1235;1238;3;112;2.0
5;189;1238;1251;13;112;2.0
5;190;1251;1272;21;112;2.0
5;191;1272;1273;1;112;2.0
5;192;1273;1275;2;112;2.0
5;193;1275;1276;1;112;2.0
5;194;1276;1301;25;112;2.0
5;195;1301;1308;7;112;2.0
5;196;1308;1315;7;112;2.0
5;197;1315;1331;16;112;2.0
5;198;1331;1350;19;112;2.0
5;199;1350;1351;1;112;2.0
5;200;1351;1366;15;112;2.0
5;201;1366;1381;15;112;2.0
5;202;1381;1396;15;112;2.0
5;203;1396;1411;15;112;2.0
5;204;1411;1426;15;112;2.0
5;205;1426;1441;15;112;2.0
5;206;1441;1456;15;112;2.0
5;207;1456;1471;15;112;2.0
5;208;1471;1486;15;112;2.0
5;209;1486;1501;15;112;2.0
5;210;1501;1516;15;112;2.0
5;211;1516;1531;15;112;2.0
5;212;1531;1546;15;112;2.0
5;213;1546;1561;15;112;2.0
5;214;1561;1576;15;112;2.0
5;215;1576;1591;15;112;2.0
5;216;1591;1606;15;112;2.0
5;217;1606;1621;15;112;2.0
5;218;1621;1636;15;112;2.0
5;219;1636;1651;15;112;2.0
5;220;1651;1666;15;112;2.0
5;221;1666;1680;14;112;2.0
6;0;245;335;90;112;2.0
6;1;335;339;4;112;2.0
6;2;339;350;11;112;2.0
6;3;350;351;1;112;2.0
6;4;351;354;3;112;2.0
6;5;354;356;2;112;2.0
6;6;356;358;2;112;2.0
6;7;358;369;11;112;2.0
6;8;369;371;2;112;2.0
6;9;371;380;9;112;2.0
6;10;380;384;4;112;2.0
6;11;384;386;2;112;2.0
6;12;386;388;2;112;2.0
6;13;388;391;3;112;2.0
6;14;391;394;3;112;2.0
6;15;394;400;6;112;2.0
6;16;400;404;4;112;2.0
6;17;404;411;7;112;2.0
6;18;411;414;3;112;2.0
6;19;414;416;2;112;2.0
6;20;416;418;2;112;2.0
6;21;418;420;2;112;2.0
6;22;420;424;4;112;2.0
6;23;424;431;7;112;2.0
6;24;431;434;3;112;2.0
6;25;434;440;6;112;2.0
6;26;440;444;4;112;2.0
6;27;444;446;2;112;2.0
6;28;446;448;2;112;2.0
6;29;448;451;3;112;2.0
6;30;451;454;3;112;2.0
6;31;454;460;6;112;2.0
6;32;460;464;4;112;2.0
6;33;464;471;7;112;2.0
6;34;471;474;3;112;2.0
6;35;474;476;2;112;2.0
6;36;476;478;2;112;2.0
6;37;478;480;2;112;2.0
6;38;480;484;4;112;2.0
6;39;484;491;7;112;2.0
6;40;491;494;3;112;2.0
6;41;494;500;6;112;2.0
6;42;500;504;4;112;2.0
6;43;504;508;4;112;2.0
6;44;508;511;3;112;2.0
6;45;511;514;3;112;2.0
6;46;514;520;6;112;2.0
6;47;520;524;4;112;2.0
6;48;524;531;7;112;2.0
6;49;531;536;5;112;2.0
6;50;536;540;4;112;2.0
6;51;540;544;4;112;2.0
6;52;544;551;7;112;2.0
6;53;551;560;9;112;2.0
6;54;560;564;4;112;2.0
6;55;564;568;4;112;2.0
6;56;568;571;3;112;2.0
6;57;571;580;9;112;2.0
6;58;580;584;4;112;2.0
6;59;584;591;7;112;2.0
6;60;591;596;5;112;2.0
6;61;596;600;4;112;2.0
6;62;600;604;4;112;2.0
6;63;604;611;7;112;2.0
6;64;611;620;9;112;2.0
6;65;620;624;4;112;2.0
6;66;624;628;4;112;2.0
6;67;628;631;3;112;2.0
6;68;631;640;9;112;2.0
6;69;640;644;4;112;2.0
6;70;644;651;7;112;2.0
6;71;651;656;5;112;2.0
6;72;656;660;4;112;2.0
6;73;660;664;4;112;2.0
6;74;664;671;7;112;2.0
6;75;671;680;9;112;2.0
6;76;680;684;4;112;2.0
6;77;684;688;4;112;2.0
6;78;688;691;3;112;2.0
6;79;691;700;9;112;2.0
6;80;700;704;4;112;2.0
6;81;704;711;7;112;2.0
6;82;711;716;5;112;2.0
6;83;716;720;4;112;2.0
6;84;720;724;4;112;2.0
6;85;724;731;7;112;2.0
6;86;731;740;9;112;2.0
6;87;740;744;4;112;2.0
6;88;744;748;4;112;2.0
6;89;748;751;3;112;2.0
6;90;751;760;9;112;2.0
6;91;760;764;4;112;2.0
6;92;764;771;7;112;2.0
6;93;771;776;5;112;2.0
6;94;776;780;4;112;2.0
6;95;780;784;4;112;2.0
6;96;784;791;7;112;2.0
6;97;791;800;9;112;2.0
6;98;800;804;4;112;2.0
6;99;804;808;4;112;2.0
6;100;808;811;3;112;2.0
6;101;811;816;5;112;2.0
6;102;816;820;4;112;2.0
6;103;820;824;4;112;2.0
6;104;824;831;7;112;2.0
6;105;831;836;5;112;2.0
6;106;836;840;4;112;2.0
6;107;840;844;4;112;2.0
6;108;844;851;7;112;2.0
6;109;851;860;9;112;2.0
6;110;860;864;4;112;2.0
6;111;864;868;4;112;2.0
6;112;868;871;3;112;2.0
6;113;871;874;3;112;2.0
6;114;874;876;2;112;2.0
6;115;876;880;4;112;2.0
6;116;880;883;3;112;2.0
6;117;883;884;1;112;2.0
6;118;884;891;7;112;2.0
6;119;891;894;3;112;2.0
6;120;894;896;2;112;2.0
6;121;896;900;4;112;2.0
6;122;900;904;4;112;2.0
6;123;904;908;4;112;2.0
6;124;908;911;3;112;2.0
6;125;911;914;3;112;2.0
6;126;914;920;6;112;2.0
6;127;920;924;4;112;2.0
6;128;924;928;4;112;2.0
6;129;928;931;3;112;2.0
6;130;931;934;3;112;2.0
6;131;934;936;2;112;2.0
6;132;936;940;4;112;2.0
6;133;940;943;3;112;2.0
6;134;943;944;1;112;2.0
6;135;944;951;7;112;2.0
6;136;951;954;3;112;2.0
6;137;954;956;2;112;2.0
6;138;956;960;4;112;2.0
6;139;960;964;4;112;2.0
6;140;964;968;4;112;2.0
6;141;968;971;3;112;2.0
6;142;971;974;3;112;2.0
6;143;974;980;6;112;2.0
6;144;980;984;4;112;2.0
6;145;984;991;7;112;2.0
6;146;991;994;3;112;2.0
6;147;994;1000;6;112;2.0
6;148;1000;1003;3;112;2.0
6;149;1003;1004;1;112;2.0
6;150;1004;1011;7;112;2.0
6;151;1011;1019;8;112;2.0
6;152;1019;1020;1;112;2.0
6;153;1020;1031;11;112;2.0
6;154;1031;1034;3;112;2.0
6;155;1034;1040;6;112;2.0
6;156;1040;1043;3;112;2.0
6;157;1043;1049;6;112;2.0
6;158;1049;1051;2;112;2.0
6;159;1051;1060;9;112;2.0
6;160;1060;1063;3;112;2.0
6;161;1063;1064;1;112;2.0
6;162;1064;1071;7;112;2.0
6;163;1071;1075;4;112;2.0
6;164;1075;1079;4;112;2.0
6;165;1079;1080;1;112;2.0
6;166;1080;1091;11;112;2.0
6;167;1091;1094;3;112;2.0
6;168;1094;1108;14;112;2.0
6;169;1108;1109;1;112;2.0
6;170;1109;1113;4;112;2.0
6;171;1113;1121;8;112;2.0
6;172;1121;1132;11;112;2.0
6;173;1132;1133;1;112;2.0
6;174;1133;1141;8;112;2.0
6;175;1141;1148;7;112;2.0
6;176;1148;1153;5;112;2.0
6;177;1153;1161;8;112;2.0
6;178;1161;1166;5;112;2.0
6;179;1166;1173;7;112;2.0
6;180;1173;1178;5;112;2.0
6;181;1178;1181;3;112;2.0
6;182;1181;1192;11;112;2.0
6;183;1192;1200;8;112;2.0
6;184;1200;1201;1;112;2.0
6;185;1201;1203;2;112;2.0
6;186;1203;1226;23;112;2.0
6;187;1226;1235;9;112;2.0
6;188;1235;1238;3;112;2.0
6;189;1238;1251;13;112;2.0
6;190;1251;1272;21;112;2.0
6;191;1272;1273;1;112;2.0
6;192;1273;1275;2;112;2.0
6;193;1275;1276;1;112;2.0
6;194;1276;1301;25;112;2.0
6;195;1301;1308;7;112;2.0
6;196;1308;1315;7;112;2.0
6;197;1315;1331;16;112;2.0
6;198;1331;1350;19;112;2.0
6;199;1350;1351;1;112;2.0
6;200;1351;1366;15;112;2.0
6;201;1366;1381;15;112;2.0
6;202;1381;1396;15;112;2.0
6;203;1396;1411;15;112;2.0
6;204;1411;1426;15;112;2.0
6;205;1426;1441;15;112;2.0
6;206;1441;1456;15;112;2.0
6;207;1456;1471;15;112;2.0
6;208;1471;1486;15;112;2.0
6;209;1486;1501;15;112;2.0
6;210;1501;1516;15;112;2.0
6;211;1516;1531;15;112;2.0
6;212;1531;1546;15;112;2.0
6;213;1546;1561;15;112;2.0
6;214;1561;1576;15;112;2.0
6;215;1576;1591;15;112;2.0
6;216;1591;1606;15;112;2.0
6;217;1606;1621;15;112;2.0
6;218;1621;1636;15;112;2.0
6;219;1636;1651;15;112;2.0
6;220;1651;1666;15;112;2.0
6;221;1666;1680;14;112;2.0
7;0;240;338;98;28;0.83
7;1;338;339;1;28;0.83
7;2;339;348;9;28;0.83
7;3;348;349;1;28;0.83
7;4;349;352;3;28;0.83
7;5;352;353;1;28;0.83
7;6;353;362;9;28;0.83
7;7;362;368;6;28;0.83
7;8;368;379;11;28;0.83
7;9;379;382;3;28;0.83
7;10;382;383;1;28;0.83
7;11;383;388;5;28;0.83
7;12;388;392;4;28;0.83
7;13;392;393;1;28;0.83
7;14;393;399;6;28;0.83
7;15;399;403;4;28;0.83
7;16;403;408;5;28;0.83
7;17;408;412;4;28;0.83
7;18;412;413;1;28;0.83
7;19;413;419;6;28;0.83
7;20;419;422;3;28;0.83
7;21;422;423;1;28;0.83
7;22;423;428;5;28;0.83
7;23;428;433;5;28;0.83
7;24;433;439;6;28;0.83
7;25;439;442;3;28;0.83
7;26;442;443;1;28;0.83
7;27;443;448;5;28;0.83
7;28;448;452;4;28;0.83
7;29;452;453;1;28;0.83
7;30;453;459;6;28;0.83
7;31;459;463;4;28;0.83
7;32;463;468;5;28;0.83
7;33;468;472;4;28;0.83
7;34;472;473;1;28;0.83
7;35;473;479;6;28;0.83
7;36;479;482;3;28;0.83
7;37;482;483;1;28;0.83
7;38;483;488;5;28;0.83
7;39;488;493;5;28;0.83
7;40;493;499;6;28;0.83
7;41;499;503;4;28;0.83
7;42;503;508;5;28;0.83
7;43;508;512;4;28;0.83
7;44;512;513;1;28;0.83
7;45;513;519;6;28;0.83
7;46;519;523;4;28;0.83
7;47;523;528;5;28;0.83
7;48;528;532;4;28;0.83
7;49;532;539;7;28;0.83
7;50;539;543;4;28;0.83
7;51;543;548;5;28;0.83
7;52;548;559;11;28;0.83
7;53;559;563;4;28;0.83
7;54;563;568;5;28;0.83
7;55;568;572;4;28;0.83
7;56;572;579;7;28;0.83
7;57;579;583;4;28;0.83
7;58;583;588;5;28;0.83
7;59;588;592;4;28;0.83
7;60;592;599;7;28;0.83
7;61;599;603;4;28;0.83
7;62;603;608;5;28;0.83
7;63;608;619;11;28;0.83
7;64;619;623;4;28;0.83
7;65;623;628;5;28;0.83
7;66;628;632;4;28;0.83
7;67;632;639;7;28;0.83
7;68;639;643;4;28;0.83
7;69;643;648;5;28;0.83
7;70;648;652;4;28;0.83
7;71;652;659;7;28;0.83
7;72;659;663;4;28;0.83
7;73;663;668;5;28;0.83
7;74;668;679;11;28;0.83
7;75;679;683;4;28;0.83
7;76;683;688;5;28;0.83
7;77;688;692;4;28;0.83
7;78;692;699;7;28;0.83
7;79;699;703;4;28;0.83
7;80;703;708;5;28;0.83
7;81;708;712;4;28;0.83
7;82;712;719;7;28;0.83
7;83;719;723;4;28;0.83
7;84;723;728;5;28;0.83
7;85;728;739;11;28;0.83
7;86;739;743;4;28;0.83
7;87;743;748;5;28;0.83
7;88;748;752;4;28;0.83
7;89;752;759;7;28;0.83
7;90;759;763;4;28;0.83
7;91;763;768;5;28;0.83
7;92;768;772;4;28;0.83
7;93;772;779;7;28;0.83
7;94;779;783;4;28;0.83
7;95;783;788;5;28;0.83
7;96;788;799;11;28;0.83
7;97;799;803;4;28;0.83
7;98;803;808;5;28;0.83
7;99;808;812;4;28;0.83
7;100;812;819;7;28;0.83
7;101;819;823;4;28;0.83
7;102;823;828;5;28;0.83
7;103;828;832;4;28;0.83
7;104;832;839;7;28;0.83
7;105;839;843;4;28;0.83
7;106;843;847;4;28;0.83
7;107;847;848;1;28;0.83
7;108;848;855;7;28;0.83
7;109;855;859;4;28;0.83
7;110;859;863;4;28;0.83
7;111;863;868;5;28;0.83
7;112;868;872;4;28;0.83
7;113;872;873;1;28;0.83
7;114;873;879;6;28;0.83
7;115;879;883;4;28;0.83
7;116;883;887;4;28;0.83
7;117;887;888;1;28;0.83
7;118;888;892;4;28;0.83
7;119;892;893;1;28;0.83
7;120;893;899;6;28;0.83
7;121;899;903;4;28;0.83
7;122;903;907;4;28;0.83
7;123;907;908;1;28;0.83
7;124;908;912;4;28;0.83
7;125;912;913;1;28;0.83
7;126;913;919;6;28;0.83
7;127;919;923;4;28;0.83
7;128;923;928;5;28;0.83
7;129;928;932;4;28;0.83
7;130;932;933;1;28;0.83
7;131;933;939;6;28;0.83
7;132;939;943;4;28;0.83
7;133;943;947;4;28;0.83
7;134;947;948;1;28;0.83
7;135;948;952;4;28;0.83
7;136;952;953;1;28;0.83
7;137;953;959;6;28;0.83
7;138;959;963;4;28;0.83
7;139;963;967;4;28;0.83
7;140;967;968;1;28;0.83
7;141;968;972;4;28;0.83
7;142;972;973;1;28;0.83
7;143;973;979;6;28;0.83
7;144;979;983;4;28;0.83
7;145;983;988;5;28;0.83
7;146;988;993;5;28;0.83
7;147;993;995;2;28;0.83
7;148;995;999;4;28;0.83
7;149;999;1003;4;28;0.83
7;150;1003;1007;4;28;0.83
7;151;1007;1008;1;28;0.83
7;152;1008;1018;10;28;0.83
7;153;1018;1019;1;28;0.83
7;154;1019;1027;8;28;0.83
7;155;1027;1028;1;28;0.83
7;156;1028;1033;5;28;0.83
7;157;1033;1039;6;28;0.83
7;158;1039;1047;8;28;0.83
7;159;1047;1048;1;28;0.83
7;160;1048;1059;11;28;0.83
7;161;1059;1063;4;28;0.83
7;162;1063;1067;4;28;0.83
7;163;1067;1068;1;28;0.83
7;164;1068;1071;3;28;0.83
7;165;1071;1078;7;28;0.83
7;166;1078;1079;1;28;0.83
7;167;1079;1088;9;28;0.83
7;168;1088;1093;5;28;0.83
7;169;1093;1107;14;28;0.83
7;170;1107;1108;1;28;0.83
7;171;1108;1110;2;28;0.83
7;172;1110;1112;2;28;0.83
7;173;1112;1120;8;28;0.83
7;174;1120;1128;8;28;0.83
7;175;1128;1132;4;28;0.83
7;176;1132;1140;8;28;0.83
7;177;1140;1145;5;28;0.83
7;178;1145;1152;7;28;0.83
7;179;1152;1160;8;28;0.83
7;180;1160;1170;10;28;0.83
7;181;1170;1177;7;28;0.83
7;182;1177;1180;3;28;0.83
7;183;1180;1188;8;28;0.83
7;184;1188;1197;9;28;0.83
7;185;1197;1200;3;28;0.83
7;186;1200;1202;2;28;0.83
7;187;1202;1225;23;28;0.83
7;188;1225;1230;5;28;0.83
7;189;1230;1232;2;28;0.83
7;190;1232;1237;5;28;0.83
7;191;1237;1250;13;28;0.83
7;192;1250;1268;18;28;0.83
7;193;1268;1272;4;28;0.83
7;194;1272;1275;3;28;0.83
7;195;1275;1300;25;28;0.83
7;196;1300;1305;5;28;0.83
7;197;1305;1307;2;28;0.83
7;198;1307;1312;5;28;0.83
7;199;1312;1330;18;28;0.83
7;200;1330;1347;17;28;0.83
7;201;1347;1350;3;28;0.83
7;202;1350;1365;15;28;0.83
7;203;1365;1380;15;28;0.83
7;204;1380;1395;15;28;0.83
7;205;1395;1410;15;28;0.83
7;206;1410;1425;15;28;0.83
7;207;1425;1440;15;28;0.83
7;208;1440;1455;15;28;0.83
7;209;1455;1470;15;28;0.83
7;210;1470;1485;15;28;0.83
7;211;1485;1500;15;28;0.83
7;212;1500;1515;15;28;0.83
7;213;1515;1530;15;28;0.83
7;214;1530;1545;15;28;0.83
7;215;1545;1560;15;28;0.83
7;216;1560;1575;15;28;0.83
7;217;1575;1590;15;28;0.83
7;218;1590;1605;15;28;0.83
7;219;1605;1620;15;28;0.83
7;220;1620;1635;15;28;0.83
7;221;1635;1650;15;28;0.83
7;222;1650;1665;15;28;0.83
7;223;1665;1680;15;28;0.83
8;0;240;338;98;28;0.83
8;1;338;339;1;28;0.83
8;2;339;348;9;28;0.83
8;3;348;349;1;28;0.83
8;4;349;352;3;28;0.83
8;5;352;353;1;28;0.83
8;6;353;362;9;28;0.83
8;7;362;368;6;28;0.83
8;8;368;379;11;28;0.83
8;9;379;382;3;28;0.83
8;10;382;383;1;28;0.83
8;11;383;388;5;28;0.83
8;12;388;392;4;28;0.83
8;13;392;393;1;28;0.83
8;14;393;399;6;28;0.83
8;15;399;403;4;28;0.83
8;16;403;408;5;28;0.83
8;17;408;412;4;28;0.83
8;18;412;413;1;28;0.83
8;19;413;419;6;28;0.83
8;20;419;422;3;28;0.83
8;21;422;423;1;28;0.83
8;22;423;428;5;28;0.83
8;23;428;433;5;28;0.83
8;24;433;439;6;28;0.83
8;25;439;442;3;28;0.83
8;26;442;443;1;28;0.83
8;27;443;448;5;28;0.83
8;28;448;452;4;28;0.83
8;29;452;453;1;28;0.83
8;30;453;459;6;28;0.83
8;31;459;463;4;28;0.83
8;32;463;468;5;28;0.83
8;33;468;472;4;28;0.83
8;34;472;473;1;28;0.83
8;35;473;479;6;28;0.83
8;36;479;482;3;28;0.83
8;37;482;483;1;28;0.83
8;38;483;488;5;28;0.83
8;39;488;493;5;28;0.83
8;40;493;499;6;28;0.83
8;41;499;503;4;28;0.83
8;42;503;508;5;28;0.83
8;43;508;512;4;28;0.83
8;44;512;513;1;28;0.83
8;45;513;519;6;28;0.83
8;46;519;523;4;28;0.83
8;47;523;528;5;28;0.83
8;48;528;532;4;28;0.83
8;49;532;539;7;28;0.83
8;50;539;543;4;28;0.83
8;51;543;548;5;28;0.83
8;52;548;559;11;28;0.83
8;53;559;563;4;28;0.83
8;54;563;568;5;28;0.83
8;55;568;572;4;28;0.83
8;56;572;579;7;28;0.83
8;57;579;583;4;28;0.83
8;58;583;588;5;28;0.83
8;59;588;592;4;28;0.83
8;60;592;599;7;28;0.83
8;61;599;603;4;28;0.83
8;62;603;608;5;28;0.83
8;63;608;619;11;28;0.83
8;64;619;623;4;28;0.83
8;65;623;628;5;28;0.83
8;66;628;632;4;28;0.83
8;67;632;639;7;28;0.83
8;68;639;643;4;28;0.83
8;69;643;648;5;28;0.83
8;70;648;652;4;28;0.83
8;71;652;659;7;28;0.83
8;72;659;663;4;28;0.83
8;73;663;668;5;28;0.83
8;74;668;679;11;28;0.83
8;75;679;683;4;28;0.83
8;76;683;688;5;28;0.83
8;77;688;692;4;28;0.83
8;78;692;699;7;28;0.83
8;79;699;703;4;28;0.83
8;80;703;708;5;28;0.83
8;81;708;712;4;28;0.83
8;82;712;719;7;28;0.83
8;83;719;723;4;28;0.83
8;84;723;728;5;28;0.83
8;85;728;739;11;28;0.83
8;86;739;743;4;28;0.83
8;87;743;748;5;28;0.83
8;88;748;752;4;28;0.83
8;89;752;759;7;28;0.83
8;90;759;763;4;28;0.83
8;91;763;768;5;28;0.83
8;92;768;772;4;28;0.83
8;93;772;779;7;28;0.83
8;94;779;783;4;28;0.83
8;95;783;788;5;28;0.83
8;96;788;799;11;28;0.83
8;97;799;803;4;28;0.83
8;98;803;808;5;28;0.83
8;99;808;812;4;28;0.83
8;100;812;819;7;28;0.83
8;101;819;823;4;28;0.83
8;102;823;828;5;28;0.83
8;103;828;832;4;28;0.83
8;104;832;839;7;28;0.83
8;105;839;843;4;28;0.83
8;106;843;847;4;28;0.83
8;107;847;848;1;28;0.83
8;108;848;855;7;28;0.83
8;109;855;859;4;28;0.83
8;110;859;863;4;28;0.83
8;111;863;868;5;28;0.83
8;112;868;872;4;28;0.83
8;113;872;873;1;28;0.83
8;114;873;879;6;28;0.83
8;115;879;883;4;28;0.83
8;116;883;887;4;28;0.83
8;117;887;888;1;28;0.83
8;118;888;892;4;28;0.83
8;119;892;893;1;28;0.83
8;120;893;899;6;28;0.83
8;121;899;903;4;28;0.83
8;122;903;907;4;28;0.83
8;123;907;908;1;28;0.83
8;124;908;912;4;28;0.83
8;125;912;913;1;28;0.83
8;126;913;919;6;28;0.83
8;127;919;923;4;28;0.83
8;128;923;928;5;28;0.83
8;129;928;932;4;28;0.83
8;130;932;933;1;28;0.83
8;131;933;939;6;28;0.83
8;132;939;943;4;28;0.83
8;133;943;947;4;28;0.83
8;134;947;948;1;28;0.83
8;135;948;952;4;28;0.83
8;136;952;953;1;28;0.83
8;137;953;959;6;28;0.83
8;138;959;963;4;28;0.83
8;139;963;967;4;28;0.83
8;140;967;968;1;28;0.83
8;141;968;972;4;28;0.83
8;142;972;973;1;28;0.83
8;143;973;979;6;28;0.83
8;144;979;983;4;28;0.83
8;145;983;988;5;28;0.83
8;146;988;993;5;28;0.83
8;147;993;995;2;28;0.83
8;148;995;999;4;28;0.83
8;149;999;1003;4;28;0.83
8;150;1003;1007;4;28;0.83
8;151;1007;1008;1;28;0.83
8;152;1008;1018;10;28;0.83
8;153;1018;1019;1;28;0.83
8;154;1019;1027;8;28;0.83
8;155;1027;1028;1;28;0.83
8;156;1028;1033;5;28;0.83
8;157;1033;1039;6;28;0.83
8;158;1039;1047;8;28;0.83
8;159;1047;1048;1;28;0.83
8;160;1048;1059;11;28;0.83
8;161;1059;1063;4;28;0.83
8;162;1063;1067;4;28;0.83
8;163;1067;1068;1;28;0.83
8;164;1068;1071;3;28;0.83
8;165;1071;1078;7;28;0.83
8;166;1078;1079;1;28;0.83
8;167;1079;1088;9;28;0.83
8;168;1088;1093;5;28;0.83
8;169;1093;1107;14;28;0.83
8;170;1107;1108;1;28;0.83
8;171;1108;1110;2;28;0.83
8;172;1110;1112;2;28;0.83
8;173;1112;1120;8;28;0.83
8;174;1120;1128;8;28;0.83
8;175;1128;1132;4;28;0.83
8;176;1132;1140;8;28;0.83
8;177;1140;1145;5;28;0.83
8;178;1145;1152;7;28;0.83
8;179;1152;1160;8;28;0.83
8;180;1160;1170;10;28;0.83
8;181;1170;1177;7;28;0.83
8;182;1177;1180;3;28;0.83
8;183;1180;1188;8;28;0.83
8;184;1188;1197;9;28;0.83
8;185;1197;1200;3;28;0.83
8;186;1200;1202;2;28;0.83
8;187;1202;1225;23;28;0.83
8;188;1225;1230;5;28;0.83
8;189;1230;1232;2;28;0.83
8;190;1232;1237;5;28;0.83
8;191;1237;1250;13;28;0.83
8;192;1250;1268;18;28;0.83
8;193;1268;1272;4;28;0.83
8;194;1272;1275;3;28;0.83
8;195;1275;1300;25;28;0.83
8;196;1300;1305;5;28;0.83
8;197;1305;1307;2;28;0.83
8;198;1307;1312;5;28;0.83
8;199;1312;1330;18;28;0.83
8;200;1330;1347;17;28;0.83
8;201;1347;1350;3;28;0.83
8;202;1350;1365;15;28;0.83
8;203;1365;1380;15;28;0.83
8;204;1380;1395;15;28;0.83
8;205;1395;1410;15;28;0.83
8;206;1410;1425;15;28;0.83
8;207;1425;1440;15;28;0.83
8;208;1440;1455;15;28;0.83
8;209;1455;1470;15;28;0.83
8;210;1470;1485;15;28;0.83
8;211;1485;1500;15;28;0.83
8;212;1500;1515;15;28;0.83
8;213;1515;1530;15;28;0.83
8;214;1530;1545;15;28;0.83
8;215;1545;1560;15;28;0.83
8;216;1560;1575;15;28;0.83
8;217;1575;1590;15;28;0.83
8;218;1590;1605;15;28;0.83
8;219;1605;1620;15;28;0.83
8;220;1620;1635;15;28;0.83
8;221;1635;1650;15;28;0.83
8;222;1650;1665;15;28;0.83
8;223;1665;1680;15;28;0.83
9;0;240;338;98;28;0.83
9;1;338;339;1;28;0.83
9;2;339;348;9;28;0.83
9;3;348;349;1;28;0.83
9;4;349;352;3;28;0.83
9;5;352;353;1;28;0.83
9;6;353;362;9;28;0.83
9;7;362;368;6;28;0.83
9;8;368;379;11;28;0.83
9;9;379;382;3;28;0.83
9;10;382;383;1;28;0.83
9;11;383;388;5;28;0.83
9;12;388;392;4;28;0.83
9;13;392;393;1;28;0.83
9;14;393;399;6;28;0.83
9;15;399;403;4;28;0.83
9;16;403;408;5;28;0.83
9;17;408;412;4;28;0.83
9;18;412;413;1;28;0.83
9;19;413;419;6;28;0.83
9;20;419;422;3;28;0.83
9;21;422;423;1;28;0.83
9;22;423;428;5;28;0.83
9;23;428;433;5;28;0.83
9;24;433;439;6;28;0.83
9;25;439;442;3;28;0.83
9;26;442;443;1;28;0.83
9;27;443;448;5;28;0.83
9;28;448;452;4;28;0.83
9;29;452;453;1;28;0.83
9;30;453;459;6;28;0.83
9;31;459;463;4;28;0.83
9;32;463;468;5;28;0.83
9;33;468;472;4;28;0.83
9;34;472;473;1;28;0.83
9;35;473;479;6;28;0.83
9;36;479;482;3;28;0.83
9;37;482;483;1;28;0.83
9;38;483;488;5;28;0.83
9;39;488;493;5;28;0.83
9;40;493;499;6;28;0.83
9;41;499;503;4;28;0.83
9;42;503;508;5;28;0.83
9;43;508;512;4;28;0.83
9;44;512;513;1;28;0.83
9;45;513;519;6;28;0.83
9;46;519;523;4;28;0.83
9;47;523;528;5;28;0.83
9;48;528;532;4;28;0.83
9;49;532;539;7;28;0.83
9;50;539;543;4;28;0.83
9;51;543;548;5;28;0.83
9;52;548;559;11;28;0.83
9;53;559;563;4;28;0.83
9;54;563;568;5;28;0.83
9;55;568;572;4;28;0.83
9;56;572;579;7;28;0.83
9;57;579;583;4;28;0.83
9;58;583;588;5;28;0.83
9;59;588;592;4;28;0.83
9;60;592;599;7;28;0.83
9;61;599;603;4;28;0.83
9;62;603;608;5;28;0.83
9;63;608;619;11;28;0.83
9;64;619;623;4;28;0.83
9;65;623;628;5;28;0.83
9;66;628;632;4;28;0.83
9;67;632;639;7;28;0.83
9;68;639;643;4;28;0.83
9;69;643;648;5;28;0.83
9;70;648;652;4;28;0.83
9;71;652;659;7;28;0.83
9;72;659;663;4;28;0.83
9;73;663;668;5;28;0.83
9;74;668;679;11;28;0.83
9;75;679;683;4;28;0.83
9;76;683;688;5;28;0.83
9;77;688;692;4;28;0.83
9;78;692;699;7;28;0.83
9;79;699;703;4;28;0.83
9;80;703;708;5;28;0.83
9;81;708;712;4;28;0.83
9;82;712;719;7;28;0.83
9;83;719;723;4;28;0.83
9;84;723;728;5;28;0.83
9;85;728;739;11;28;0.83
9;86;739;743;4;28;0.83
9;87;743;748;5;28;0.83
9;88;748;752;4;28;0.83
9;89;752;759;7;28;0.83
9;90;759;763;4;28;0.83
9;91;763;768;5;28;0.83
9;92;768;772;4;28;0.83
9;93;772;779;7;28;0.83
9;94;779;783;4;28;0.83
9;95;783;788;5;28;0.83
9;96;788;799;11;28;0.83
9;97;799;803;4;28;0.83
9;98;803;808;5;28;0.83
9;99;808;812;4;28;0.83
9;100;812;819;7;28;0.83
9;101;819;823;4;28;0.83
9;102;823;828;5;28;0.83
9;103;828;832;4;28;0.83
9;104;832;839;7;28;0.83
9;105;839;843;4;28;0.83
9;106;843;847;4;28;0.83
9;107;847;848;1;28;0.83
9;108;848;855;7;28;0.83
9;109;855;859;4;28;0.83
9;110;859;863;4;28;0.83
9;111;863;868;5;28;0.83
9;112;868;872;4;28;0.83
9;113;872;873;1;28;0.83
9;114;873;879;6;28;0.83
9;115;879;883;4;28;0.83
9;116;883;887;4;28;0.83
9;117;887;888;1;28;0.83
9;118;888;892;4;28;0.83
9;119;892;893;1;28;0.83
9;120;893;899;6;28;0.83
9;121;899;903;4;28;0.83
9;122;903;907;4;28;0.83
9;123;907;908;1;28;0.83
9;124;908;912;4;28;0.83
9;125;912;913;1;28;0.83
9;126;913;919;6;28;0.83
9;127;919;923;4;28;0.83
9;128;923;928;5;28;0.83
9;129;928;932;4;28;0.83
9;130;932;933;1;28;0.83
9;131;933;939;6;28;0.83
9;132;939;943;4;28;0.83
9;133;943;947;4;28;0.83
9;134;947;948;1;28;0.83
9;135;948;952;4;28;0.83
9;136;952;953;1;28;0.83
9;137;953;959;6;28;0.83
9;138;959;963;4;28;0.83
9;139;963;967;4;28;0.83
9;140;967;968;1;28;0.83
9;141;968;972;4;28;0.83
9;142;972;973;1;28;0.83
9;143;973;979;6;28;0.83
9;144;979;983;4;28;0.83
9;145;983;988;5;28;0.83
9;146;988;993;5;28;0.83
9;147;993;995;2;28;0.83
9;148;995;999;4;28;0.83
9;149;999;1003;4;28;0.83
9;150;1003;1007;4;28;0.83
9;151;1007;1008;1;28;0.83
9;152;1008;1018;10;28;0.83
9;153;1018;1019;1;28;0.83
9;154;1019;1027;8;28;0.83
9;155;1027;1028;1;28;0.83
9;156;1028;1033;5;28;0.83
9;157;1033;1039;6;28;0.83
9;158;1039;1047;8;28;0.83
9;159;1047;1048;1;28;0.83
9;160;1048;1059;11;28;0.83
9;161;1059;1063;4;28;0.83
9;162;1063;1067;4;28;0.83
9;163;1067;1068;1;28;0.83
9;164;1068;1071;3;28;0.83
9;165;1071;1078;7;28;0.83
9;166;1078;1079;1;28;0.83
9;167;1079;1088;9;28;0.83
9;168;1088;1093;5;28;0.83
9;169;1093;1107;14;28;0.83
9;170;1107;1108;1;28;0.83
9;171;1108;1110;2;28;0.83
9;172;1110;1112;2;28;0.83
9;173;1112;1120;8;28;0.83
9;174;1120;1128;8;28;0.83
9;175;1128;1132;4;28;0.83
9;176;1132;1140;8;28;0.83
9;177;1140;1145;5;28;0.83
9;178;1145;1152;7;28;0.83
9;179;1152;1160;8;28;0.83
9;180;1160;1170;10;28;0.83
9;181;1170;1177;7;28;0.83
9;182;1177;1180;3;28;0.83
9;183;1180;1188;8;28;0.83
9;184;1188;1197;9;28;0.83
9;185;1197;1200;3;28;0.83
9;186;1200;1202;2;28;0.83
9;187;1202;1225;23;28;0.83
9;188;1225;1230;5;28;0.83
9;189;1230;1232;2;28;0.83
9;190;1232;1237;5;28;0.83
9;191;1237;1250;13;28;0.83
9;192;1250;1268;18;28;0.83
9;193;1268;1272;4;28;0.83
9;194;1272;1275;3;28;0.83
9;195;1275;1300;25;28;0.83
9;196;1300;1305;5;28;0.83
9;197;1305;1307;2;28;0.83
9;198;1307;1312;5;28;0.83
9;199;1312;1330;18;28;0.83
9;200;1330;1347;17;28;0.83
9;201;1347;1350;3;28;0.83
9;202;1350;1365;15;28;0.83
9;203;1365;1380;15;28;0.83
9;204;1380;1395;15;28;0.83
9;205;1395;1410;15;28;0.83
9;206;1410;1425;15;28;0.83
9;207;1425;1440;15;28;0.83
9;208;1440;1455;15;28;0.83
9;209;1455;1470;15;28;0.83
9;210;1470;1485;15;28;0.83
9;211;1485;1500;15;28;0.83
9;212;1500;1515;15;28;0.83
9;213;1515;1530;15;28;0.83
9;214;1530;1545;15;28;0.83
9;215;1545;1560;15;28;0.83
9;216;1560;1575;15;28;0.83
9;217;1575;1590;15;28;0.83
9;218;1590;1605;15;28;0.83
9;219;1605;1620;15;28;0.83
9;220;1620;1635;15;28;0.83
9;221;1635;1650;15;28;0.83
9;222;1650;1665;15;28;0.83
9;223;1665;1680;15;28;0.83
10;0;240;338;98;28;0.83
10;1;338;339;1;28;0.83
10;2;339;348;9;28;0.83
10;3;348;349;1;28;0.83
10;4;349;352;3;28;0.83
10;5;352;353;1;28;0.83
10;6;353;362;9;28;0.83
10;7;362;368;6;28;0.83
10;8;368;379;11;28;0.83
10;9;379;382;3;28;0.83
10;10;382;383;1;28;0.83
10;11;383;388;5;28;0.83
10;12;388;392;4;28;0.83
10;13;392;393;1;28;0.83
10;14;393;399;6;28;0.83
10;15;399;403;4;28;0.83
10;16;403;408;5;28;0.83
10;17;408;412;4;28;0.83
10;18;412;413;1;28;0.83
10;19;413;419;6;28;0.83
10;20;419;422;3;28;0.83
10;21;422;423;1;28;0.83
10;22;423;428;5;28;0.83
10;23;428;433;5;28;0.83
10;24;433;439;6;28;0.83
10;25;439;442;3;28;0.83
10;26;442;443;1;28;0.83
10;27;443;448;5;28;0.83
10;28;448;452;4;28;0.83
10;29;452;453;1;28;0.83
10;30;453;459;6;28;0.83
10;31;459;463;4;28;0.83
10;32;463;468;5;28;0.83
10;33;468;472;4;28;0.83
10;34;472;473;1;28;0.83
10;35;473;479;6;28;0.83
10;36;479;482;3;28;0.83
10;37;482;483;1;28;0.83
10;38;483;488;5;28;0.83
10;39;488;493;5;28;0.83
10;40;493;499;6;28;0.83
10;41;499;503;4;28;0.83
10;42;503;508;5;28;0.83
10;43;508;512;4;28;0.83
10;44;512;513;1;28;0.83
10;45;513;519;6;28;0.83
10;46;519;523;4;28;0.83
10;47;523;528;5;28;0.83
10;48;528;532;4;28;0.83
10;49;532;539;7;28;0.83
10;50;539;543;4;28;0.83
10;51;543;548;5;28;0.83
10;52;548;559;11;28;0.83
10;53;559;563;4;28;0.83
10;54;563;568;5;28;0.83
10;55;568;572;4;28;0.83
10;56;572;579;7;28;0.83
10;57;579;583;4;28;0.83
10;58;583;588;5;28;0.83
10;59;588;592;4;28;0.83
10;60;592;599;7;28;0.83
10;61;599;603;4;28;0.83
10;62;603;608;5;28;0.83
10;63;608;619;11;28;0.83
10;64;619;623;4;28;0.83
10;65;623;628;5;28;0.83
10;66;628;632;4;28;0.83
10;67;632;639;7;28;0.83
10;68;639;643;4;28;0.83
10;69;643;648;5;28;0.83
10;70;648;652;4;28;0.83
10;71;652;659;7;28;0.83
10;72;659;663;4;28;0.83
10;73;663;668;5;28;0.83
10;74;668;679;11;28;0.83
10;75;679;683;4;28;0.83
10;76;683;688;5;28;0.83
10;77;688;692;4;28;0.83
10;78;692;699;7;28;0.83
10;79;699;703;4;28;0.83
10;80;703;708;5;28;0.83
10;81;708;712;4;28;0.83
10;82;712;719;7;28;0.83
10;83;719;723;4;28;0.83
10;84;723;728;5;28;0.83
10;85;728;739;11;28;0.83
10;86;739;743;4;28;0.83
10;87;743;748;5;28;0.83
10;88;748;752;4;28;0.83
10;89;752;759;7;28;0.83
10;90;759;763;4;28;0.83
10;91;763;768;5;28;0.83
10;92;768;772;4;28;0.83
10;93;772;779;7;28;0.83
10;94;779;783;4;28;0.83
10;95;783;788;5;28;0.83
10;96;788;799;11;28;0.83
10;97;799;803;4;28;0.83
10;98;803;808;5;28;0.83
10;99;808;812;4;28;0.83
10;100;812;819;7;28;0.83
10;101;819;823;4;28;0.83
10;102;823;828;5;28;0.83
10;103;828;832;4;28;0.83
10;104;832;839;7;28;0.83
10;105;839;843;4;28;0.83
10;106;843;847;4;28;0.83
10;107;847;848;1;28;0.83
10;108;848;855;7;28;0.83
10;109;855;859;4;28;0.83
10;110;859;863;4;28;0.83
10;111;863;868;5;28;0.83
10;112;868;872;4;28;0.83
10;113;872;873;1;28;0.83
10;114;873;879;6;28;0.83
10;115;879;883;4;28;0.83
10;116;883;887;4;28;0.83
10;117;887;888;1;28;0.83
10;118;888;892;4;28;0.83
10;119;892;893;1;28;0.83
10;120;893;899;6;28;0.83
10;121;899;903;4;28;0.83
10;122;903;907;4;28;0.83
10;123;907;908;1;28;0.83
10;124;908;912;4;28;0.83
10;125;912;913;1;28;0.83
10;126;913;919;6;28;0.83
10;127;919;923;4;28;0.83
10;128;923;928;5;28;0.83
10;129;928;932;4;28;0.83
10;130;932;933;1;28;0.83
10;131;933;939;6;28;0.83
10;132;939;943;4;28;0.83
10;133;943;947;4;28;0.83
10;134;947;948;1;28;0.83
10;135;948;952;4;28;0.83
10;136;952;953;1;28;0.83
10;137;953;959;6;28;0.83
10;138;959;963;4;28;0.83
10;139;963;967;4;28;0.83
10;140;967;968;1;28;0.83
10;141;968;972;4;28;0.83
10;142;972;973;1;28;0.83
10;143;973;979;6;28;0.83
10;144;979;983;4;28;0.83
10;145;983;988;5;28;0.83
10;146;988;993;5;28;0.83
10;147;993;995;2;28;0.83
10;148;995;999;4;28;0.83
10;149;999;1003;4;28;0.83
10;150;1003;1007;4;28;0.83
10;151;1007;1008;1;28;0.83
10;152;1008;1018;10;28;0.83
10;153;1018;1019;1;28;0.83
10;154;1019;1027;8;28;0.83
10;155;1027;1028;1;28;0.83
10;156;1028;1033;5;28;0.83
10;157;1033;1039;6;28;0.83
10;158;1039;1047;8;28;0.83
10;159;1047;1048;1;28;0.83
10;160;1048;1059;11;28;0.83
10;161;1059;1063;4;28;0.83
10;162;1063;1067;4;28;0.83
10;163;1067;1068;1;28;0.83
10;164;1068;1071;3;28;0.83
10;165;1071;1078;7;28;0.83
10;166;1078;1079;1;28;0.83
10;167;1079;1088;9;28;0.83
10;168;1088;1093;5;28;0.83
10;169;1093;1107;14;28;0.83
10;170;1107;1108;1;28;0.83
10;171;1108;1110;2;28;0.83
10;172;1110;1112;2;28;0.83
10;173;1112;1120;8;28;0.83
10;174;1120;1128;8;28;0.83
10;175;1128;1132;4;28;0.83
10;176;1132;1140;8;28;0.83
10;177;1140;1145;5;28;0.83
10;178;1145;1152;7;28;0.83
10;179;1152;1160;8;28;0.83
10;180;1160;1170;10;28;0.83
10;181;1170;1177;7;28;0.83
10;182;1177;1180;3;28;0.83
10;183;1180;1188;8;28;0.83
10;184;1188;1197;9;28;0.83
10;185;1197;1200;3;28;0.83
10;186;1200;1202;2;28;0.83
10;187;1202;1225;23;28;0.83
10;188;1225;1230;5;28;0.83
10;189;1230;1232;2;28;0.83
10;190;1232;1237;5;28;0.83
10;191;1237;1250;13;28;0.83
10;192;1250;1268;18;28;0.83
10;193;1268;1272;4;28;0.83
10;194;1272;1275;3;28;0.83
10;195;1275;1300;25;28;0.83
10;196;1300;1305;5;28;0.83
10;197;1305;1307;2;28;0.83
10;198;1307;1312;5;28;0.83
10;199;1312;1330;18;28;0.83
10;200;1330;1347;17;28;0.83
10;201;1347;1350;3;28;0.83
10;202;1350;1365;15;28;0.83
10;203;1365;1380;15;28;0.83
10;204;1380;1395;15;28;0.83
10;205;1395;1410;15;28;0.83
10;206;1410;1425;15;28;0.83
10;207;1425;1440;15;28;0.83
10;208;1440;1455;15;28;0.83
10;209;1455;1470;15;28;0.83
10;210;1470;1485;15;28;0.83
10;211;1485;1500;15;28;0.83
10;212;1500;1515;15;28;0.83
10;213;1515;1530;15;28;0.83
10;214;1530;1545;15;28;0.83
10;215;1545;1560;15;28;0.83
10;216;1560;1575;15;28;0.83
10;217;1575;1590;15;28;0.83
10;218;1590;1605;15;28;0.83
10;219;1605;1620;15;28;0.83
10;220;1620;1635;15;28;0.83
10;221;1635;1650;15;28;0.83
10;222;1650;1665;15;28;0.83
10;223;1665;1680;15;28;0.83
