Index Nabijacky;Index Udalosti;Cas Zaciatku;Cas Konca;CasTrvania;Miesto;Rychlost nabijania
0;0;243;328;85;25;2.0
0;1;328;332;4;25;2.0
0;2;332;338;6;25;2.0
0;3;338;339;1;25;2.0
0;4;339;340;1;25;2.0
0;5;340;341;1;25;2.0
0;6;341;343;2;25;2.0
0;7;343;347;4;25;2.0
0;8;347;349;2;25;2.0
0;9;349;350;1;25;2.0
0;10;350;351;1;25;2.0
0;11;351;354;3;25;2.0
0;12;354;355;1;25;2.0
0;13;355;356;1;25;2.0
0;14;356;358;2;25;2.0
0;15;358;361;3;25;2.0
0;16;361;362;1;25;2.0
0;17;362;368;6;25;2.0
0;18;368;369;1;25;2.0
0;19;369;376;7;25;2.0
0;20;376;378;2;25;2.0
0;21;378;380;2;25;2.0
0;22;380;381;1;25;2.0
0;23;381;384;3;25;2.0
0;24;384;386;2;25;2.0
0;25;386;389;3;25;2.0
0;26;389;391;2;25;2.0
0;27;391;393;2;25;2.0
0;28;393;394;1;25;2.0
0;29;394;396;2;25;2.0
0;30;396;400;4;25;2.0
0;31;400;401;1;25;2.0
0;32;401;404;3;25;2.0
0;33;404;406;2;25;2.0
0;34;406;408;2;25;2.0
0;35;408;409;1;25;2.0
0;36;409;411;2;25;2.0
0;37;411;414;3;25;2.0
0;38;414;416;2;25;2.0
0;39;416;418;2;25;2.0
0;40;418;420;2;25;2.0
0;41;420;421;1;25;2.0
0;42;421;424;3;25;2.0
0;43;424;426;2;25;2.0
0;44;426;428;2;25;2.0
0;45;428;429;1;25;2.0
0;46;429;431;2;25;2.0
0;47;431;434;3;25;2.0
0;48;434;436;2;25;2.0
0;49;436;438;2;25;2.0
0;50;438;440;2;25;2.0
0;51;440;441;1;25;2.0
0;52;441;444;3;25;2.0
0;53;444;446;2;25;2.0
0;54;446;449;3;25;2.0
0;55;449;451;2;25;2.0
0;56;451;453;2;25;2.0
0;57;453;454;1;25;2.0
0;58;454;456;2;25;2.0
0;59;456;458;2;25;2.0
0;60;458;460;2;25;2.0
0;61;460;461;1;25;2.0
0;62;461;464;3;25;2.0
0;63;464;466;2;25;2.0
0;64;466;468;2;25;2.0
0;65;468;469;1;25;2.0
0;66;469;471;2;25;2.0
0;67;471;474;3;25;2.0
0;68;474;476;2;25;2.0
0;69;476;478;2;25;2.0
0;70;478;480;2;25;2.0
0;71;480;481;1;25;2.0
0;72;481;484;3;25;2.0
0;73;484;486;2;25;2.0
0;74;486;487;1;25;2.0
0;75;487;488;1;25;2.0
0;76;488;489;1;25;2.0
0;77;489;491;2;25;2.0
0;78;491;494;3;25;2.0
0;79;494;498;4;25;2.0
0;80;498;500;2;25;2.0
0;81;500;504;4;25;2.0
0;82;504;506;2;25;2.0
0;83;506;509;3;25;2.0
0;84;509;511;2;25;2.0
0;85;511;514;3;25;2.0
0;86;514;516;2;25;2.0
0;87;516;518;2;25;2.0
0;88;518;520;2;25;2.0
0;89;520;523;3;25;2.0
0;90;523;524;1;25;2.0
0;91;524;526;2;25;2.0
0;92;526;529;3;25;2.0
0;93;529;530;1;25;2.0
0;94;530;534;4;25;2.0
0;95;534;536;2;25;2.0
0;96;536;540;4;25;2.0
0;97;540;541;1;25;2.0
0;98;541;544;3;25;2.0
0;99;544;546;2;25;2.0
0;100;546;549;3;25;2.0
0;101;549;556;7;25;2.0
0;102;556;558;2;25;2.0
0;103;558;560;2;25;2.0
0;104;560;561;1;25;2.0
0;105;561;564;3;25;2.0
0;106;564;566;2;25;2.0
0;107;566;569;3;25;2.0
0;108;569;570;1;25;2.0
0;109;570;571;1;25;2.0
0;110;571;576;5;25;2.0
0;111;576;580;4;25;2.0
0;112;580;581;1;25;2.0
0;113;581;584;3;25;2.0
0;114;584;586;2;25;2.0
0;115;586;589;3;25;2.0
0;116;589;594;5;25;2.0
0;117;594;596;2;25;2.0
0;118;596;598;2;25;2.0
0;119;598;600;2;25;2.0
0;120;600;601;1;25;2.0
0;121;601;604;3;25;2.0
0;122;604;606;2;25;2.0
0;123;606;609;3;25;2.0
0;124;609;610;1;25;2.0
0;125;610;616;6;25;2.0
0;126;616;618;2;25;2.0
0;127;618;620;2;25;2.0
0;128;620;621;1;25;2.0
0;129;621;624;3;25;2.0
0;130;624;626;2;25;2.0
0;131;626;629;3;25;2.0
0;132;629;630;1;25;2.0
0;133;630;631;1;25;2.0
0;134;631;636;5;25;2.0
0;135;636;640;4;25;2.0
0;136;640;641;1;25;2.0
0;137;641;644;3;25;2.0
0;138;644;646;2;25;2.0
0;139;646;649;3;25;2.0
0;140;649;654;5;25;2.0
0;141;654;656;2;25;2.0
0;142;656;658;2;25;2.0
0;143;658;660;2;25;2.0
0;144;660;661;1;25;2.0
0;145;661;664;3;25;2.0
0;146;664;666;2;25;2.0
0;147;666;669;3;25;2.0
0;148;669;670;1;25;2.0
0;149;670;676;6;25;2.0
0;150;676;680;4;25;2.0
0;151;680;681;1;25;2.0
0;152;681;684;3;25;2.0
0;153;684;686;2;25;2.0
0;154;686;689;3;25;2.0
0;155;689;690;1;25;2.0
0;156;690;691;1;25;2.0
0;157;691;696;5;25;2.0
0;158;696;700;4;25;2.0
0;159;700;701;1;25;2.0
0;160;701;704;3;25;2.0
0;161;704;706;2;25;2.0
0;162;706;709;3;25;2.0
0;163;709;714;5;25;2.0
0;164;714;716;2;25;2.0
0;165;716;718;2;25;2.0
0;166;718;720;2;25;2.0
0;167;720;721;1;25;2.0
0;168;721;724;3;25;2.0
0;169;724;726;2;25;2.0
0;170;726;729;3;25;2.0
0;171;729;730;1;25;2.0
0;172;730;736;6;25;2.0
0;173;736;740;4;25;2.0
0;174;740;741;1;25;2.0
0;175;741;744;3;25;2.0
0;176;744;746;2;25;2.0
0;177;746;749;3;25;2.0
0;178;749;750;1;25;2.0
0;179;750;751;1;25;2.0
0;180;751;756;5;25;2.0
0;181;756;760;4;25;2.0
0;182;760;761;1;25;2.0
0;183;761;764;3;25;2.0
0;184;764;766;2;25;2.0
0;185;766;769;3;25;2.0
0;186;769;774;5;25;2.0
0;187;774;776;2;25;2.0
0;188;776;778;2;25;2.0
0;189;778;780;2;25;2.0
0;190;780;781;1;25;2.0
0;191;781;784;3;25;2.0
0;192;784;786;2;25;2.0
0;193;786;789;3;25;2.0
0;194;789;790;1;25;2.0
0;195;790;796;6;25;2.0
0;196;796;798;2;25;2.0
0;197;798;800;2;25;2.0
0;198;800;801;1;25;2.0
0;199;801;804;3;25;2.0
0;200;804;806;2;25;2.0
0;201;806;809;3;25;2.0
0;202;809;811;2;25;2.0
0;203;811;814;3;25;2.0
0;204;814;816;2;25;2.0
0;205;816;818;2;25;2.0
0;206;818;820;2;25;2.0
0;207;820;821;1;25;2.0
0;208;821;824;3;25;2.0
0;209;824;826;2;25;2.0
0;210;826;828;2;25;2.0
0;211;828;829;1;25;2.0
0;212;829;834;5;25;2.0
0;213;834;836;2;25;2.0
0;214;836;838;2;25;2.0
0;215;838;840;2;25;2.0
0;216;840;841;1;25;2.0
0;217;841;844;3;25;2.0
0;218;844;846;2;25;2.0
0;219;846;848;2;25;2.0
0;220;848;849;1;25;2.0
0;221;849;850;1;25;2.0
0;222;850;851;1;25;2.0
0;223;851;854;3;25;2.0
0;224;854;856;2;25;2.0
0;225;856;858;2;25;2.0
0;226;858;860;2;25;2.0
0;227;860;861;1;25;2.0
0;228;861;864;3;25;2.0
0;229;864;866;2;25;2.0
0;230;866;868;2;25;2.0
0;231;868;869;1;25;2.0
0;232;869;870;1;25;2.0
0;233;870;871;1;25;2.0
0;234;871;874;3;25;2.0
0;235;874;876;2;25;2.0
0;236;876;880;4;25;2.0
0;237;880;881;1;25;2.0
0;238;881;884;3;25;2.0
0;239;884;886;2;25;2.0
0;240;886;888;2;25;2.0
0;241;888;889;1;25;2.0
0;242;889;891;2;25;2.0
0;243;891;894;3;25;2.0
0;244;894;896;2;25;2.0
0;245;896;898;2;25;2.0
0;246;898;900;2;25;2.0
0;247;900;901;1;25;2.0
0;248;901;904;3;25;2.0
0;249;904;906;2;25;2.0
0;250;906;908;2;25;2.0
0;251;908;909;1;25;2.0
0;252;909;910;1;25;2.0
0;253;910;911;1;25;2.0
0;254;911;914;3;25;2.0
0;255;914;916;2;25;2.0
0;256;916;918;2;25;2.0
0;257;918;920;2;25;2.0
0;258;920;921;1;25;2.0
0;259;921;924;3;25;2.0
0;260;924;926;2;25;2.0
0;261;926;928;2;25;2.0
0;262;928;929;1;25;2.0
0;263;929;930;1;25;2.0
0;264;930;931;1;25;2.0
0;265;931;934;3;25;2.0
0;266;934;936;2;25;2.0
0;267;936;940;4;25;2.0
0;268;940;941;1;25;2.0
0;269;941;944;3;25;2.0
0;270;944;946;2;25;2.0
0;271;946;948;2;25;2.0
0;272;948;949;1;25;2.0
0;273;949;951;2;25;2.0
0;274;951;954;3;25;2.0
0;275;954;956;2;25;2.0
0;276;956;958;2;25;2.0
0;277;958;960;2;25;2.0
0;278;960;961;1;25;2.0
0;279;961;964;3;25;2.0
0;280;964;966;2;25;2.0
0;281;966;968;2;25;2.0
0;282;968;969;1;25;2.0
0;283;969;970;1;25;2.0
0;284;970;971;1;25;2.0
0;285;971;974;3;25;2.0
0;286;974;976;2;25;2.0
0;287;976;978;2;25;2.0
0;288;978;980;2;25;2.0
0;289;980;981;1;25;2.0
0;290;981;984;3;25;2.0
0;291;984;986;2;25;2.0
0;292;986;988;2;25;2.0
0;293;988;989;1;25;2.0
0;294;989;990;1;25;2.0
0;295;990;991;1;25;2.0
0;296;991;994;3;25;2.0
0;297;994;996;2;25;2.0
0;298;996;1000;4;25;2.0
0;299;1000;1001;1;25;2.0
0;300;1001;1004;3;25;2.0
0;301;1004;1006;2;25;2.0
0;302;1006;1008;2;25;2.0
0;303;1008;1009;1;25;2.0
0;304;1009;1011;2;25;2.0
0;305;1011;1016;5;25;2.0
0;306;1016;1018;2;25;2.0
0;307;1018;1019;1;25;2.0
0;308;1019;1020;1;25;2.0
0;309;1020;1026;6;25;2.0
0;310;1026;1028;2;25;2.0
0;311;1028;1029;1;25;2.0
0;312;1029;1030;1;25;2.0
0;313;1030;1031;1;25;2.0
0;314;1031;1034;3;25;2.0
0;315;1034;1036;2;25;2.0
0;316;1036;1040;4;25;2.0
0;317;1040;1041;1;25;2.0
0;318;1041;1046;5;25;2.0
0;319;1046;1048;2;25;2.0
0;320;1048;1049;1;25;2.0
0;321;1049;1050;1;25;2.0
0;322;1050;1056;6;25;2.0
0;323;1056;1060;4;25;2.0
0;324;1060;1061;1;25;2.0
0;325;1061;1064;3;25;2.0
0;326;1064;1066;2;25;2.0
0;327;1066;1068;2;25;2.0
0;328;1068;1069;1;25;2.0
0;329;1069;1071;2;25;2.0
0;330;1071;1073;2;25;2.0
0;331;1073;1076;3;25;2.0
0;332;1076;1078;2;25;2.0
0;333;1078;1079;1;25;2.0
0;334;1079;1080;1;25;2.0
0;335;1080;1086;6;25;2.0
0;336;1086;1088;2;25;2.0
0;337;1088;1089;1;25;2.0
0;338;1089;1090;1;25;2.0
0;339;1090;1091;1;25;2.0
0;340;1091;1094;3;25;2.0
0;341;1094;1096;2;25;2.0
0;342;1096;1101;5;25;2.0
0;343;1101;1106;5;25;2.0
0;344;1106;1108;2;25;2.0
0;345;1108;1109;1;25;2.0
0;346;1109;1111;2;25;2.0
0;347;1111;1116;5;25;2.0
0;348;1116;1118;2;25;2.0
0;349;1118;1121;3;25;2.0
0;350;1121;1127;6;25;2.0
0;351;1127;1128;1;25;2.0
0;352;1128;1130;2;25;2.0
0;353;1130;1133;3;25;2.0
0;354;1133;1136;3;25;2.0
0;355;1136;1141;5;25;2.0
0;356;1141;1142;1;25;2.0
0;357;1142;1143;1;25;2.0
0;358;1143;1146;3;25;2.0
0;359;1146;1148;2;25;2.0
0;360;1148;1153;5;25;2.0
0;361;1153;1154;1;25;2.0
0;362;1154;1156;2;25;2.0
0;363;1156;1158;2;25;2.0
0;364;1158;1161;3;25;2.0
0;365;1161;1163;2;25;2.0
0;366;1163;1169;6;25;2.0
0;367;1169;1171;2;25;2.0
0;368;1171;1176;5;25;2.0
0;369;1176;1178;2;25;2.0
0;370;1178;1179;1;25;2.0
0;371;1179;1181;2;25;2.0
0;372;1181;1183;2;25;2.0
0;373;1183;1190;7;25;2.0
0;374;1190;1198;8;25;2.0
0;375;1198;1201;3;25;2.0
0;376;1201;1203;2;25;2.0
0;377;1203;1212;9;25;2.0
0;378;1212;1218;6;25;2.0
0;379;1218;1221;3;25;2.0
0;380;1221;1226;5;25;2.0
0;381;1226;1228;2;25;2.0
0;382;1228;1229;1;25;2.0
0;383;1229;1233;4;25;2.0
0;384;1233;1238;5;25;2.0
0;385;1238;1246;8;25;2.0
0;386;1246;1251;5;25;2.0
0;387;1251;1253;2;25;2.0
0;388;1253;1254;1;25;2.0
0;389;1254;1263;9;25;2.0
0;390;1263;1270;7;25;2.0
0;391;1270;1271;1;25;2.0
0;392;1271;1273;2;25;2.0
0;393;1273;1276;3;25;2.0
0;394;1276;1278;2;25;2.0
0;395;1278;1287;9;25;2.0
0;396;1287;1288;1;25;2.0
0;397;1288;1298;10;25;2.0
0;398;1298;1301;3;25;2.0
0;399;1301;1303;2;25;2.0
0;400;1303;1304;1;25;2.0
0;401;1304;1308;4;25;2.0
0;402;1308;1312;4;25;2.0
0;403;1312;1313;1;25;2.0
0;404;1313;1323;10;25;2.0
0;405;1323;1326;3;25;2.0
0;406;1326;1331;5;25;2.0
0;407;1331;1337;6;25;2.0
0;408;1337;1338;1;25;2.0
0;409;1338;1341;3;25;2.0
0;410;1341;1343;2;25;2.0
0;411;1343;1348;5;25;2.0
0;412;1348;1351;3;25;2.0
0;413;1351;1356;5;25;2.0
0;414;1356;1364;8;25;2.0
0;415;1364;1366;2;25;2.0
0;416;1366;1381;15;25;2.0
0;417;1381;1383;2;25;2.0
0;418;1383;1398;15;25;2.0
0;419;1398;1413;15;25;2.0
0;420;1413;1428;15;25;2.0
0;421;1428;1443;15;25;2.0
0;422;1443;1458;15;25;2.0
0;423;1458;1473;15;25;2.0
0;424;1473;1488;15;25;2.0
0;425;1488;1503;15;25;2.0
0;426;1503;1518;15;25;2.0
0;427;1518;1533;15;25;2.0
0;428;1533;1548;15;25;2.0
0;429;1548;1563;15;25;2.0
0;430;1563;1578;15;25;2.0
0;431;1578;1593;15;25;2.0
0;432;1593;1608;15;25;2.0
0;433;1608;1623;15;25;2.0
0;434;1623;1638;15;25;2.0
0;435;1638;1653;15;25;2.0
0;436;1653;1668;15;25;2.0
0;437;1668;1680;12;25;2.0
1;0;242;327;85;42;2.0
1;1;327;332;5;42;2.0
1;2;332;338;6;42;2.0
1;3;338;339;1;42;2.0
1;4;339;340;1;42;2.0
1;5;340;341;1;42;2.0
1;6;341;343;2;42;2.0
1;7;343;347;4;42;2.0
1;8;347;349;2;42;2.0
1;9;349;351;2;42;2.0
1;10;351;353;2;42;2.0
1;11;353;355;2;42;2.0
1;12;355;357;2;42;2.0
1;13;357;361;4;42;2.0
1;14;361;362;1;42;2.0
1;15;362;368;6;42;2.0
1;16;368;369;1;42;2.0
1;17;369;376;7;42;2.0
1;18;376;377;1;42;2.0
1;19;377;379;2;42;2.0
1;20;379;380;1;42;2.0
1;21;380;383;3;42;2.0
1;22;383;386;3;42;2.0
1;23;386;389;3;42;2.0
1;24;389;390;1;42;2.0
1;25;390;391;1;42;2.0
1;26;391;393;2;42;2.0
1;27;393;396;3;42;2.0
1;28;396;399;3;42;2.0
1;29;399;400;1;42;2.0
1;30;400;403;3;42;2.0
1;31;403;406;3;42;2.0
1;32;406;407;1;42;2.0
1;33;407;408;1;42;2.0
1;34;408;409;1;42;2.0
1;35;409;410;1;42;2.0
1;36;410;411;1;42;2.0
1;37;411;413;2;42;2.0
1;38;413;416;3;42;2.0
1;39;416;417;1;42;2.0
1;40;417;418;1;42;2.0
1;41;418;419;1;42;2.0
1;42;419;420;1;42;2.0
1;43;420;421;1;42;2.0
1;44;421;423;2;42;2.0
1;45;423;426;3;42;2.0
1;46;426;427;1;42;2.0
1;47;427;428;1;42;2.0
1;48;428;429;1;42;2.0
1;49;429;430;1;42;2.0
1;50;430;433;3;42;2.0
1;51;433;436;3;42;2.0
1;52;436;438;2;42;2.0
1;53;438;439;1;42;2.0
1;54;439;440;1;42;2.0
1;55;440;441;1;42;2.0
1;56;441;443;2;42;2.0
1;57;443;446;3;42;2.0
1;58;446;449;3;42;2.0
1;59;449;450;1;42;2.0
1;60;450;451;1;42;2.0
1;61;451;453;2;42;2.0
1;62;453;456;3;42;2.0
1;63;456;457;1;42;2.0
1;64;457;459;2;42;2.0
1;65;459;460;1;42;2.0
1;66;460;463;3;42;2.0
1;67;463;466;3;42;2.0
1;68;466;467;1;42;2.0
1;69;467;468;1;42;2.0
1;70;468;469;1;42;2.0
1;71;469;470;1;42;2.0
1;72;470;471;1;42;2.0
1;73;471;473;2;42;2.0
1;74;473;476;3;42;2.0
1;75;476;477;1;42;2.0
1;76;477;478;1;42;2.0
1;77;478;479;1;42;2.0
1;78;479;480;1;42;2.0
1;79;480;481;1;42;2.0
1;80;481;483;2;42;2.0
1;81;483;486;3;42;2.0
1;82;486;488;2;42;2.0
1;83;488;489;1;42;2.0
1;84;489;490;1;42;2.0
1;85;490;491;1;42;2.0
1;86;491;493;2;42;2.0
1;87;493;497;4;42;2.0
1;88;497;498;1;42;2.0
1;89;498;499;1;42;2.0
1;90;499;503;4;42;2.0
1;91;503;505;2;42;2.0
1;92;505;506;1;42;2.0
1;93;506;509;3;42;2.0
1;94;509;511;2;42;2.0
1;95;511;513;2;42;2.0
1;96;513;516;3;42;2.0
1;97;516;517;1;42;2.0
1;98;517;519;2;42;2.0
1;99;519;522;3;42;2.0
1;100;522;523;1;42;2.0
1;101;523;526;3;42;2.0
1;102;526;529;3;42;2.0
1;103;529;530;1;42;2.0
1;104;530;533;3;42;2.0
1;105;533;536;3;42;2.0
1;106;536;539;3;42;2.0
1;107;539;540;1;42;2.0
1;108;540;543;3;42;2.0
1;109;543;546;3;42;2.0
1;110;546;549;3;42;2.0
1;111;549;556;7;42;2.0
1;112;556;557;1;42;2.0
1;113;557;558;1;42;2.0
1;114;558;559;1;42;2.0
1;115;559;560;1;42;2.0
1;116;560;563;3;42;2.0
1;117;563;566;3;42;2.0
1;118;566;569;3;42;2.0
1;119;569;570;1;42;2.0
1;120;570;571;1;42;2.0
1;121;571;576;5;42;2.0
1;122;576;579;3;42;2.0
1;123;579;580;1;42;2.0
1;124;580;583;3;42;2.0
1;125;583;586;3;42;2.0
1;126;586;589;3;42;2.0
1;127;589;593;4;42;2.0
1;128;593;596;3;42;2.0
1;129;596;597;1;42;2.0
1;130;597;599;2;42;2.0
1;131;599;600;1;42;2.0
1;132;600;603;3;42;2.0
1;133;603;606;3;42;2.0
1;134;606;609;3;42;2.0
1;135;609;610;1;42;2.0
1;136;610;616;6;42;2.0
1;137;616;618;2;42;2.0
1;138;618;619;1;42;2.0
1;139;619;620;1;42;2.0
1;140;620;623;3;42;2.0
1;141;623;626;3;42;2.0
1;142;626;629;3;42;2.0
1;143;629;630;1;42;2.0
1;144;630;631;1;42;2.0
1;145;631;636;5;42;2.0
1;146;636;639;3;42;2.0
1;147;639;640;1;42;2.0
1;148;640;643;3;42;2.0
1;149;643;646;3;42;2.0
1;150;646;649;3;42;2.0
1;151;649;653;4;42;2.0
1;152;653;656;3;42;2.0
1;153;656;657;1;42;2.0
1;154;657;659;2;42;2.0
1;155;659;660;1;42;2.0
1;156;660;663;3;42;2.0
1;157;663;666;3;42;2.0
1;158;666;669;3;42;2.0
1;159;669;670;1;42;2.0
1;160;670;676;6;42;2.0
1;161;676;679;3;42;2.0
1;162;679;680;1;42;2.0
1;163;680;683;3;42;2.0
1;164;683;686;3;42;2.0
1;165;686;689;3;42;2.0
1;166;689;690;1;42;2.0
1;167;690;691;1;42;2.0
1;168;691;696;5;42;2.0
1;169;696;699;3;42;2.0
1;170;699;700;1;42;2.0
1;171;700;703;3;42;2.0
1;172;703;706;3;42;2.0
1;173;706;709;3;42;2.0
1;174;709;713;4;42;2.0
1;175;713;716;3;42;2.0
1;176;716;717;1;42;2.0
1;177;717;719;2;42;2.0
1;178;719;720;1;42;2.0
1;179;720;723;3;42;2.0
1;180;723;726;3;42;2.0
1;181;726;729;3;42;2.0
1;182;729;730;1;42;2.0
1;183;730;736;6;42;2.0
1;184;736;739;3;42;2.0
1;185;739;740;1;42;2.0
1;186;740;743;3;42;2.0
1;187;743;746;3;42;2.0
1;188;746;749;3;42;2.0
1;189;749;750;1;42;2.0
1;190;750;751;1;42;2.0
1;191;751;756;5;42;2.0
1;192;756;759;3;42;2.0
1;193;759;760;1;42;2.0
1;194;760;763;3;42;2.0
1;195;763;766;3;42;2.0
1;196;766;769;3;42;2.0
1;197;769;773;4;42;2.0
1;198;773;776;3;42;2.0
1;199;776;777;1;42;2.0
1;200;777;779;2;42;2.0
1;201;779;780;1;42;2.0
1;202;780;783;3;42;2.0
1;203;783;786;3;42;2.0
1;204;786;789;3;42;2.0
1;205;789;790;1;42;2.0
1;206;790;796;6;42;2.0
1;207;796;798;2;42;2.0
1;208;798;799;1;42;2.0
1;209;799;800;1;42;2.0
1;210;800;803;3;42;2.0
1;211;803;806;3;42;2.0
1;212;806;809;3;42;2.0
1;213;809;811;2;42;2.0
1;214;811;813;2;42;2.0
1;215;813;816;3;42;2.0
1;216;816;817;1;42;2.0
1;217;817;819;2;42;2.0
1;218;819;820;1;42;2.0
1;219;820;823;3;42;2.0
1;220;823;826;3;42;2.0
1;221;826;828;2;42;2.0
1;222;828;829;1;42;2.0
1;223;829;833;4;42;2.0
1;224;833;836;3;42;2.0
1;225;836;837;1;42;2.0
1;226;837;839;2;42;2.0
1;227;839;840;1;42;2.0
1;228;840;843;3;42;2.0
1;229;843;846;3;42;2.0
1;230;846;848;2;42;2.0
1;231;848;849;1;42;2.0
1;232;849;850;1;42;2.0
1;233;850;854;4;42;2.0
1;234;854;856;2;42;2.0
1;235;856;858;2;42;2.0
1;236;858;859;1;42;2.0
1;237;859;860;1;42;2.0
1;238;860;863;3;42;2.0
1;239;863;866;3;42;2.0
1;240;866;868;2;42;2.0
1;241;868;869;1;42;2.0
1;242;869;870;1;42;2.0
1;243;870;871;1;42;2.0
1;244;871;873;2;42;2.0
1;245;873;876;3;42;2.0
1;246;876;879;3;42;2.0
1;247;879;880;1;42;2.0
1;248;880;883;3;42;2.0
1;249;883;886;3;42;2.0
1;250;886;888;2;42;2.0
1;251;888;889;1;42;2.0
1;252;889;890;1;42;2.0
1;253;890;893;3;42;2.0
1;254;893;896;3;42;2.0
1;255;896;897;1;42;2.0
1;256;897;899;2;42;2.0
1;257;899;900;1;42;2.0
1;258;900;903;3;42;2.0
1;259;903;906;3;42;2.0
1;260;906;908;2;42;2.0
1;261;908;909;1;42;2.0
1;262;909;910;1;42;2.0
1;263;910;911;1;42;2.0
1;264;911;913;2;42;2.0
1;265;913;916;3;42;2.0
1;266;916;918;2;42;2.0
1;267;918;919;1;42;2.0
1;268;919;920;1;42;2.0
1;269;920;923;3;42;2.0
1;270;923;926;3;42;2.0
1;271;926;928;2;42;2.0
1;272;928;929;1;42;2.0
1;273;929;930;1;42;2.0
1;274;930;931;1;42;2.0
1;275;931;933;2;42;2.0
1;276;933;936;3;42;2.0
1;277;936;939;3;42;2.0
1;278;939;940;1;42;2.0
1;279;940;943;3;42;2.0
1;280;943;946;3;42;2.0
1;281;946;948;2;42;2.0
1;282;948;949;1;42;2.0
1;283;949;950;1;42;2.0
1;284;950;953;3;42;2.0
1;285;953;956;3;42;2.0
1;286;956;957;1;42;2.0
1;287;957;959;2;42;2.0
1;288;959;960;1;42;2.0
1;289;960;963;3;42;2.0
1;290;963;966;3;42;2.0
1;291;966;968;2;42;2.0
1;292;968;969;1;42;2.0
1;293;969;970;1;42;2.0
1;294;970;971;1;42;2.0
1;295;971;973;2;42;2.0
1;296;973;976;3;42;2.0
1;297;976;978;2;42;2.0
1;298;978;979;1;42;2.0
1;299;979;980;1;42;2.0
1;300;980;983;3;42;2.0
1;301;983;986;3;42;2.0
1;302;986;988;2;42;2.0
1;303;988;989;1;42;2.0
1;304;989;990;1;42;2.0
1;305;990;993;3;42;2.0
1;306;993;994;1;42;2.0
1;307;994;996;2;42;2.0
1;308;996;999;3;42;2.0
1;309;999;1000;1;42;2.0
1;310;1000;1003;3;42;2.0
1;311;1003;1006;3;42;2.0
1;312;1006;1008;2;42;2.0
1;313;1008;1009;1;42;2.0
1;314;1009;1010;1;42;2.0
1;315;1010;1016;6;42;2.0
1;316;1016;1017;1;42;2.0
1;317;1017;1018;1;42;2.0
1;318;1018;1019;1;42;2.0
1;319;1019;1025;6;42;2.0
1;320;1025;1028;3;42;2.0
1;321;1028;1029;1;42;2.0
1;322;1029;1030;1;42;2.0
1;323;1030;1031;1;42;2.0
1;324;1031;1033;2;42;2.0
1;325;1033;1036;3;42;2.0
1;326;1036;1039;3;42;2.0
1;327;1039;1040;1;42;2.0
1;328;1040;1046;6;42;2.0
1;329;1046;1048;2;42;2.0
1;330;1048;1049;1;42;2.0
1;331;1049;1050;1;42;2.0
1;332;1050;1055;5;42;2.0
1;333;1055;1056;1;42;2.0
1;334;1056;1059;3;42;2.0
1;335;1059;1061;2;42;2.0
1;336;1061;1063;2;42;2.0
1;337;1063;1066;3;42;2.0
1;338;1066;1068;2;42;2.0
1;339;1068;1069;1;42;2.0
1;340;1069;1070;1;42;2.0
1;341;1070;1072;2;42;2.0
1;342;1072;1076;4;42;2.0
1;343;1076;1077;1;42;2.0
1;344;1077;1078;1;42;2.0
1;345;1078;1079;1;42;2.0
1;346;1079;1085;6;42;2.0
1;347;1085;1088;3;42;2.0
1;348;1088;1089;1;42;2.0
1;349;1089;1090;1;42;2.0
1;350;1090;1091;1;42;2.0
1;351;1091;1093;2;42;2.0
1;352;1093;1096;3;42;2.0
1;353;1096;1100;4;42;2.0
1;354;1100;1106;6;42;2.0
1;355;1106;1107;1;42;2.0
1;356;1107;1108;1;42;2.0
1;357;1108;1109;1;42;2.0
1;358;1109;1111;2;42;2.0
1;359;1111;1115;4;42;2.0
1;360;1115;1116;1;42;2.0
1;361;1116;1118;2;42;2.0
1;362;1118;1120;2;42;2.0
1;363;1120;1127;7;42;2.0
1;364;1127;1129;2;42;2.0
1;365;1129;1132;3;42;2.0
1;366;1132;1133;1;42;2.0
1;367;1133;1136;3;42;2.0
1;368;1136;1140;4;42;2.0
1;369;1140;1141;1;42;2.0
1;370;1141;1142;1;42;2.0
1;371;1142;1146;4;42;2.0
1;372;1146;1148;2;42;2.0
1;373;1148;1152;4;42;2.0
1;374;1152;1154;2;42;2.0
1;375;1154;1156;2;42;2.0
1;376;1156;1157;1;42;2.0
1;377;1157;1160;3;42;2.0
1;378;1160;1163;3;42;2.0
1;379;1163;1169;6;42;2.0
1;380;1169;1171;2;42;2.0
1;381;1171;1176;5;42;2.0
1;382;1176;1177;1;42;2.0
1;383;1177;1179;2;42;2.0
1;384;1179;1180;1;42;2.0
1;385;1180;1183;3;42;2.0
1;386;1183;1189;6;42;2.0
1;387;1189;1197;8;42;2.0
1;388;1197;1198;1;42;2.0
1;389;1198;1200;2;42;2.0
1;390;1200;1201;1;42;2.0
1;391;1201;1202;1;42;2.0
1;392;1202;1203;1;42;2.0
1;393;1203;1211;8;42;2.0
1;394;1211;1217;6;42;2.0
1;395;1217;1221;4;42;2.0
1;396;1221;1225;4;42;2.0
1;397;1225;1228;3;42;2.0
1;398;1228;1229;1;42;2.0
1;399;1229;1233;4;42;2.0
1;400;1233;1237;4;42;2.0
1;401;1237;1246;9;42;2.0
1;402;1246;1250;4;42;2.0
1;403;1250;1253;3;42;2.0
1;404;1253;1254;1;42;2.0
1;405;1254;1262;8;42;2.0
1;406;1262;1269;7;42;2.0
1;407;1269;1271;2;42;2.0
1;408;1271;1272;1;42;2.0
1;409;1272;1273;1;42;2.0
1;410;1273;1275;2;42;2.0
1;411;1275;1278;3;42;2.0
1;412;1278;1286;8;42;2.0
1;413;1286;1287;1;42;2.0
1;414;1287;1298;11;42;2.0
1;415;1298;1300;2;42;2.0
1;416;1300;1303;3;42;2.0
1;417;1303;1304;1;42;2.0
1;418;1304;1307;3;42;2.0
1;419;1307;1311;4;42;2.0
1;420;1311;1312;1;42;2.0
1;421;1312;1313;1;42;2.0
1;422;1313;1323;10;42;2.0
1;423;1323;1326;3;42;2.0
1;424;1326;1330;4;42;2.0
1;425;1330;1336;6;42;2.0
1;426;1336;1337;1;42;2.0
1;427;1337;1340;3;42;2.0
1;428;1340;1343;3;42;2.0
1;429;1343;1348;5;42;2.0
1;430;1348;1350;2;42;2.0
1;431;1350;1356;6;42;2.0
1;432;1356;1364;8;42;2.0
1;433;1364;1365;1;42;2.0
1;434;1365;1381;16;42;2.0
1;435;1381;1382;1;42;2.0
1;436;1382;1397;15;42;2.0
1;437;1397;1412;15;42;2.0
1;438;1412;1427;15;42;2.0
1;439;1427;1442;15;42;2.0
1;440;1442;1457;15;42;2.0
1;441;1457;1472;15;42;2.0
1;442;1472;1487;15;42;2.0
1;443;1487;1502;15;42;2.0
1;444;1502;1517;15;42;2.0
1;445;1517;1532;15;42;2.0
1;446;1532;1547;15;42;2.0
1;447;1547;1562;15;42;2.0
1;448;1562;1577;15;42;2.0
1;449;1577;1592;15;42;2.0
1;450;1592;1607;15;42;2.0
1;451;1607;1622;15;42;2.0
1;452;1622;1637;15;42;2.0
1;453;1637;1652;15;42;2.0
1;454;1652;1667;15;42;2.0
1;455;1667;1680;13;42;2.0
2;0;246;330;84;49;2.0
2;1;330;333;3;49;2.0
2;2;333;335;2;49;2.0
2;3;335;336;1;49;2.0
2;4;336;338;2;49;2.0
2;5;338;340;2;49;2.0
2;6;340;342;2;49;2.0
2;7;342;343;1;49;2.0
2;8;343;349;6;49;2.0
2;9;349;350;1;49;2.0
2;10;350;351;1;49;2.0
2;11;351;352;1;49;2.0
2;12;352;355;3;49;2.0
2;13;355;356;1;49;2.0
2;14;356;357;1;49;2.0
2;15;357;358;1;49;2.0
2;16;358;360;2;49;2.0
2;17;360;363;3;49;2.0
2;18;363;365;2;49;2.0
2;19;365;370;5;49;2.0
2;20;370;371;1;49;2.0
2;21;371;372;1;49;2.0
2;22;372;379;7;49;2.0
2;23;379;380;1;49;2.0
2;24;380;381;1;49;2.0
2;25;381;383;2;49;2.0
2;26;383;385;2;49;2.0
2;27;385;386;1;49;2.0
2;28;386;387;1;49;2.0
2;29;387;388;1;49;2.0
2;30;388;389;1;49;2.0
2;31;389;392;3;49;2.0
2;32;392;393;1;49;2.0
2;33;393;395;2;49;2.0
2;34;395;399;4;49;2.0
2;35;399;401;2;49;2.0
2;36;401;403;2;49;2.0
2;37;403;405;2;49;2.0
2;38;405;406;1;49;2.0
2;39;406;409;3;49;2.0
2;40;409;410;1;49;2.0
2;41;410;412;2;49;2.0
2;42;412;413;1;49;2.0
2;43;413;415;2;49;2.0
2;44;415;416;1;49;2.0
2;45;416;417;1;49;2.0
2;46;417;419;2;49;2.0
2;47;419;420;1;49;2.0
2;48;420;421;1;49;2.0
2;49;421;423;2;49;2.0
2;50;423;425;2;49;2.0
2;51;425;429;4;49;2.0
2;52;429;430;1;49;2.0
2;53;430;432;2;49;2.0
2;54;432;433;1;49;2.0
2;55;433;435;2;49;2.0
2;56;435;436;1;49;2.0
2;57;436;439;3;49;2.0
2;58;439;441;2;49;2.0
2;59;441;443;2;49;2.0
2;60;443;445;2;49;2.0
2;61;445;446;1;49;2.0
2;62;446;447;1;49;2.0
2;63;447;448;1;49;2.0
2;64;448;449;1;49;2.0
2;65;449;451;2;49;2.0
2;66;451;452;1;49;2.0
2;67;452;453;1;49;2.0
2;68;453;455;2;49;2.0
2;69;455;459;4;49;2.0
2;70;459;460;1;49;2.0
2;71;460;461;1;49;2.0
2;72;461;463;2;49;2.0
2;73;463;465;2;49;2.0
2;74;465;466;1;49;2.0
2;75;466;469;3;49;2.0
2;76;469;470;1;49;2.0
2;77;470;472;2;49;2.0
2;78;472;473;1;49;2.0
2;79;473;475;2;49;2.0
2;80;475;476;1;49;2.0
2;81;476;477;1;49;2.0
2;82;477;479;2;49;2.0
2;83;479;480;1;49;2.0
2;84;480;481;1;49;2.0
2;85;481;483;2;49;2.0
2;86;483;485;2;49;2.0
2;87;485;486;1;49;2.0
2;88;486;489;3;49;2.0
2;89;489;492;3;49;2.0
2;90;492;493;1;49;2.0
2;91;493;495;2;49;2.0
2;92;495;500;5;49;2.0
2;93;500;501;1;49;2.0
2;94;501;505;4;49;2.0
2;95;505;506;1;49;2.0
2;96;506;508;2;49;2.0
2;97;508;509;1;49;2.0
2;98;509;511;2;49;2.0
2;99;511;512;1;49;2.0
2;100;512;515;3;49;2.0
2;101;515;520;5;49;2.0
2;102;520;521;1;49;2.0
2;103;521;525;4;49;2.0
2;104;525;529;4;49;2.0
2;105;529;531;2;49;2.0
2;106;531;532;1;49;2.0
2;107;532;533;1;49;2.0
2;108;533;537;4;49;2.0
2;109;537;541;4;49;2.0
2;110;541;543;2;49;2.0
2;111;543;545;2;49;2.0
2;112;545;549;4;49;2.0
2;113;549;551;2;49;2.0
2;114;551;552;1;49;2.0
2;115;552;556;4;49;2.0
2;116;556;560;4;49;2.0
2;117;560;561;1;49;2.0
2;118;561;563;2;49;2.0
2;119;563;565;2;49;2.0
2;120;565;566;1;49;2.0
2;121;566;569;3;49;2.0
2;122;569;571;2;49;2.0
2;123;571;572;1;49;2.0
2;124;572;573;1;49;2.0
2;125;573;581;8;49;2.0
2;126;581;583;2;49;2.0
2;127;583;585;2;49;2.0
2;128;585;589;4;49;2.0
2;129;589;591;2;49;2.0
2;130;591;592;1;49;2.0
2;131;592;597;5;49;2.0
2;132;597;600;3;49;2.0
2;133;600;601;1;49;2.0
2;134;601;603;2;49;2.0
2;135;603;605;2;49;2.0
2;136;605;609;4;49;2.0
2;137;609;611;2;49;2.0
2;138;611;612;1;49;2.0
2;139;612;613;1;49;2.0
2;140;613;616;3;49;2.0
2;141;616;621;5;49;2.0
2;142;621;623;2;49;2.0
2;143;623;625;2;49;2.0
2;144;625;626;1;49;2.0
2;145;626;629;3;49;2.0
2;146;629;631;2;49;2.0
2;147;631;632;1;49;2.0
2;148;632;633;1;49;2.0
2;149;633;641;8;49;2.0
2;150;641;643;2;49;2.0
2;151;643;645;2;49;2.0
2;152;645;649;4;49;2.0
2;153;649;651;2;49;2.0
2;154;651;652;1;49;2.0
2;155;652;657;5;49;2.0
2;156;657;660;3;49;2.0
2;157;660;661;1;49;2.0
2;158;661;663;2;49;2.0
2;159;663;665;2;49;2.0
2;160;665;669;4;49;2.0
2;161;669;671;2;49;2.0
2;162;671;672;1;49;2.0
2;163;672;673;1;49;2.0
2;164;673;681;8;49;2.0
2;165;681;683;2;49;2.0
2;166;683;685;2;49;2.0
2;167;685;686;1;49;2.0
2;168;686;689;3;49;2.0
2;169;689;691;2;49;2.0
2;170;691;692;1;49;2.0
2;171;692;693;1;49;2.0
2;172;693;701;8;49;2.0
2;173;701;703;2;49;2.0
2;174;703;705;2;49;2.0
2;175;705;709;4;49;2.0
2;176;709;711;2;49;2.0
2;177;711;712;1;49;2.0
2;178;712;717;5;49;2.0
2;179;717;720;3;49;2.0
2;180;720;721;1;49;2.0
2;181;721;723;2;49;2.0
2;182;723;725;2;49;2.0
2;183;725;729;4;49;2.0
2;184;729;731;2;49;2.0
2;185;731;732;1;49;2.0
2;186;732;733;1;49;2.0
2;187;733;741;8;49;2.0
2;188;741;743;2;49;2.0
2;189;743;745;2;49;2.0
2;190;745;746;1;49;2.0
2;191;746;749;3;49;2.0
2;192;749;751;2;49;2.0
2;193;751;752;1;49;2.0
2;194;752;753;1;49;2.0
2;195;753;761;8;49;2.0
2;196;761;763;2;49;2.0
2;197;763;765;2;49;2.0
2;198;765;769;4;49;2.0
2;199;769;771;2;49;2.0
2;200;771;772;1;49;2.0
2;201;772;777;5;49;2.0
2;202;777;780;3;49;2.0
2;203;780;781;1;49;2.0
2;204;781;783;2;49;2.0
2;205;783;785;2;49;2.0
2;206;785;789;4;49;2.0
2;207;789;791;2;49;2.0
2;208;791;792;1;49;2.0
2;209;792;793;1;49;2.0
2;210;793;796;3;49;2.0
2;211;796;799;3;49;2.0
2;212;799;801;2;49;2.0
2;213;801;803;2;49;2.0
2;214;803;805;2;49;2.0
2;215;805;806;1;49;2.0
2;216;806;809;3;49;2.0
2;217;809;811;2;49;2.0
2;218;811;812;1;49;2.0
2;219;812;817;5;49;2.0
2;220;817;819;2;49;2.0
2;221;819;820;1;49;2.0
2;222;820;821;1;49;2.0
2;223;821;823;2;49;2.0
2;224;823;825;2;49;2.0
2;225;825;829;4;49;2.0
2;226;829;831;2;49;2.0
2;227;831;832;1;49;2.0
2;228;832;837;5;49;2.0
2;229;837;839;2;49;2.0
2;230;839;840;1;49;2.0
2;231;840;841;1;49;2.0
2;232;841;843;2;49;2.0
2;233;843;845;2;49;2.0
2;234;845;849;4;49;2.0
2;235;849;851;2;49;2.0
2;236;851;852;1;49;2.0
2;237;852;853;1;49;2.0
2;238;853;856;3;49;2.0
2;239;856;859;3;49;2.0
2;240;859;861;2;49;2.0
2;241;861;863;2;49;2.0
2;242;863;865;2;49;2.0
2;243;865;866;1;49;2.0
2;244;866;869;3;49;2.0
2;245;869;871;2;49;2.0
2;246;871;872;1;49;2.0
2;247;872;873;1;49;2.0
2;248;873;875;2;49;2.0
2;249;875;877;2;49;2.0
2;250;877;879;2;49;2.0
2;251;879;881;2;49;2.0
2;252;881;883;2;49;2.0
2;253;883;885;2;49;2.0
2;254;885;889;4;49;2.0
2;255;889;891;2;49;2.0
2;256;891;892;1;49;2.0
2;257;892;893;1;49;2.0
2;258;893;895;2;49;2.0
2;259;895;897;2;49;2.0
2;260;897;899;2;49;2.0
2;261;899;900;1;49;2.0
2;262;900;901;1;49;2.0
2;263;901;903;2;49;2.0
2;264;903;905;2;49;2.0
2;265;905;906;1;49;2.0
2;266;906;909;3;49;2.0
2;267;909;911;2;49;2.0
2;268;911;912;1;49;2.0
2;269;912;913;1;49;2.0
2;270;913;915;2;49;2.0
2;271;915;916;1;49;2.0
2;272;916;919;3;49;2.0
2;273;919;921;2;49;2.0
2;274;921;923;2;49;2.0
2;275;923;925;2;49;2.0
2;276;925;926;1;49;2.0
2;277;926;929;3;49;2.0
2;278;929;931;2;49;2.0
2;279;931;932;1;49;2.0
2;280;932;933;1;49;2.0
2;281;933;935;2;49;2.0
2;282;935;937;2;49;2.0
2;283;937;939;2;49;2.0
2;284;939;941;2;49;2.0
2;285;941;943;2;49;2.0
2;286;943;945;2;49;2.0
2;287;945;949;4;49;2.0
2;288;949;951;2;49;2.0
2;289;951;952;1;49;2.0
2;290;952;953;1;49;2.0
2;291;953;955;2;49;2.0
2;292;955;957;2;49;2.0
2;293;957;959;2;49;2.0
2;294;959;960;1;49;2.0
2;295;960;961;1;49;2.0
2;296;961;963;2;49;2.0
2;297;963;965;2;49;2.0
2;298;965;966;1;49;2.0
2;299;966;969;3;49;2.0
2;300;969;971;2;49;2.0
2;301;971;972;1;49;2.0
2;302;972;973;1;49;2.0
2;303;973;975;2;49;2.0
2;304;975;976;1;49;2.0
2;305;976;979;3;49;2.0
2;306;979;981;2;49;2.0
2;307;981;983;2;49;2.0
2;308;983;985;2;49;2.0
2;309;985;989;4;49;2.0
2;310;989;991;2;49;2.0
2;311;991;992;1;49;2.0
2;312;992;993;1;49;2.0
2;313;993;995;2;49;2.0
2;314;995;999;4;49;2.0
2;315;999;1001;2;49;2.0
2;316;1001;1003;2;49;2.0
2;317;1003;1005;2;49;2.0
2;318;1005;1009;4;49;2.0
2;319;1009;1011;2;49;2.0
2;320;1011;1012;1;49;2.0
2;321;1012;1013;1;49;2.0
2;322;1013;1019;6;49;2.0
2;323;1019;1020;1;49;2.0
2;324;1020;1021;1;49;2.0
2;325;1021;1023;2;49;2.0
2;326;1023;1028;5;49;2.0
2;327;1028;1031;3;49;2.0
2;328;1031;1032;1;49;2.0
2;329;1032;1033;1;49;2.0
2;330;1033;1034;1;49;2.0
2;331;1034;1035;1;49;2.0
2;332;1035;1041;6;49;2.0
2;333;1041;1043;2;49;2.0
2;334;1043;1049;6;49;2.0
2;335;1049;1050;1;49;2.0
2;336;1050;1051;1;49;2.0
2;337;1051;1052;1;49;2.0
2;338;1052;1053;1;49;2.0
2;339;1053;1058;5;49;2.0
2;340;1058;1061;3;49;2.0
2;341;1061;1063;2;49;2.0
2;342;1063;1064;1;49;2.0
2;343;1064;1065;1;49;2.0
2;344;1065;1071;6;49;2.0
2;345;1071;1072;1;49;2.0
2;346;1072;1073;1;49;2.0
2;347;1073;1076;3;49;2.0
2;348;1076;1079;3;49;2.0
2;349;1079;1080;1;49;2.0
2;350;1080;1081;1;49;2.0
2;351;1081;1083;2;49;2.0
2;352;1083;1088;5;49;2.0
2;353;1088;1091;3;49;2.0
2;354;1091;1092;1;49;2.0
2;355;1092;1093;1;49;2.0
2;356;1093;1094;1;49;2.0
2;357;1094;1095;1;49;2.0
2;358;1095;1103;8;49;2.0
2;359;1103;1106;3;49;2.0
2;360;1106;1109;3;49;2.0
2;361;1109;1110;1;49;2.0
2;362;1110;1111;1;49;2.0
2;363;1111;1112;1;49;2.0
2;364;1112;1114;2;49;2.0
2;365;1114;1118;4;49;2.0
2;366;1118;1121;3;49;2.0
2;367;1121;1122;1;49;2.0
2;368;1122;1130;8;49;2.0
2;369;1130;1131;1;49;2.0
2;370;1131;1133;2;49;2.0
2;371;1133;1134;1;49;2.0
2;372;1134;1136;2;49;2.0
2;373;1136;1142;6;49;2.0
2;374;1142;1144;2;49;2.0
2;375;1144;1145;1;49;2.0
2;376;1145;1149;4;49;2.0
2;377;1149;1151;2;49;2.0
2;378;1151;1154;3;49;2.0
2;379;1154;1157;3;49;2.0
2;380;1157;1160;3;49;2.0
2;381;1160;1162;2;49;2.0
2;382;1162;1164;2;49;2.0
2;383;1164;1166;2;49;2.0
2;384;1166;1171;5;49;2.0
2;385;1171;1174;3;49;2.0
2;386;1174;1179;5;49;2.0
2;387;1179;1180;1;49;2.0
2;388;1180;1182;2;49;2.0
2;389;1182;1186;4;49;2.0
2;390;1186;1193;7;49;2.0
2;391;1193;1196;3;49;2.0
2;392;1196;1200;4;49;2.0
2;393;1200;1201;1;49;2.0
2;394;1201;1202;1;49;2.0
2;395;1202;1204;2;49;2.0
2;396;1204;1206;2;49;2.0
2;397;1206;1214;8;49;2.0
2;398;1214;1216;2;49;2.0
2;399;1216;1220;4;49;2.0
2;400;1220;1224;4;49;2.0
2;401;1224;1227;3;49;2.0
2;402;1227;1231;4;49;2.0
2;403;1231;1232;1;49;2.0
2;404;1232;1236;4;49;2.0
2;405;1236;1239;3;49;2.0
2;406;1239;1240;1;49;2.0
2;407;1240;1241;1;49;2.0
2;408;1241;1252;11;49;2.0
2;409;1252;1256;4;49;2.0
2;410;1256;1257;1;49;2.0
2;411;1257;1265;8;49;2.0
2;412;1265;1266;1;49;2.0
2;413;1266;1273;7;49;2.0
2;414;1273;1274;1;49;2.0
2;415;1274;1276;2;49;2.0
2;416;1276;1277;1;49;2.0
2;417;1277;1281;4;49;2.0
2;418;1281;1289;8;49;2.0
2;419;1289;1290;1;49;2.0
2;420;1290;1293;3;49;2.0
2;421;1293;1299;6;49;2.0
2;422;1299;1302;3;49;2.0
2;423;1302;1306;4;49;2.0
2;424;1306;1309;3;49;2.0
2;425;1309;1314;5;49;2.0
2;426;1314;1315;1;49;2.0
2;427;1315;1316;1;49;2.0
2;428;1316;1321;5;49;2.0
2;429;1321;1326;5;49;2.0
2;430;1326;1332;6;49;2.0
2;431;1332;1339;7;49;2.0
2;432;1339;1340;1;49;2.0
2;433;1340;1345;5;49;2.0
2;434;1345;1346;1;49;2.0
2;435;1346;1351;5;49;2.0
2;436;1351;1352;1;49;2.0
2;437;1352;1367;15;49;2.0
2;438;1367;1368;1;49;2.0
2;439;1368;1376;8;49;2.0
2;440;1376;1385;9;49;2.0
2;441;1385;1400;15;49;2.0
2;442;1400;1415;15;49;2.0
2;443;1415;1430;15;49;2.0
2;444;1430;1445;15;49;2.0
2;445;1445;1460;15;49;2.0
2;446;1460;1475;15;49;2.0
2;447;1475;1490;15;49;2.0
2;448;1490;1505;15;49;2.0
2;449;1505;1520;15;49;2.0
2;450;1520;1535;15;49;2.0
2;451;1535;1550;15;49;2.0
2;452;1550;1565;15;49;2.0
2;453;1565;1580;15;49;2.0
2;454;1580;1595;15;49;2.0
2;455;1595;1610;15;49;2.0
2;456;1610;1625;15;49;2.0
2;457;1625;1640;15;49;2.0
2;458;1640;1655;15;49;2.0
2;459;1655;1670;15;49;2.0
2;460;1670;1680;10;49;2.0
3;0;244;327;83;77;2.0
3;1;327;331;4;77;2.0
3;2;331;334;3;77;2.0
3;3;334;339;5;77;2.0
3;4;339;340;1;77;2.0
3;5;340;342;2;77;2.0
3;6;342;344;2;77;2.0
3;7;344;345;1;77;2.0
3;8;345;346;1;77;2.0
3;9;346;348;2;77;2.0
3;10;348;349;1;77;2.0
3;11;349;352;3;77;2.0
3;12;352;354;2;77;2.0
3;13;354;355;1;77;2.0
3;14;355;357;2;77;2.0
3;15;357;361;4;77;2.0
3;16;361;362;1;77;2.0
3;17;362;364;2;77;2.0
3;18;364;368;4;77;2.0
3;19;368;369;1;77;2.0
3;20;369;375;6;77;2.0
3;21;375;377;2;77;2.0
3;22;377;379;2;77;2.0
3;23;379;380;1;77;2.0
3;24;380;384;4;77;2.0
3;25;384;385;1;77;2.0
3;26;385;388;3;77;2.0
3;27;388;389;1;77;2.0
3;28;389;390;1;77;2.0
3;29;390;392;2;77;2.0
3;30;392;394;2;77;2.0
3;31;394;395;1;77;2.0
3;32;395;399;4;77;2.0
3;33;399;400;1;77;2.0
3;34;400;405;5;77;2.0
3;35;405;407;2;77;2.0
3;36;407;408;1;77;2.0
3;37;408;409;1;77;2.0
3;38;409;410;1;77;2.0
3;39;410;412;2;77;2.0
3;40;412;414;2;77;2.0
3;41;414;415;1;77;2.0
3;42;415;417;2;77;2.0
3;43;417;419;2;77;2.0
3;44;419;420;1;77;2.0
3;45;420;422;2;77;2.0
3;46;422;425;3;77;2.0
3;47;425;427;2;77;2.0
3;48;427;428;1;77;2.0
3;49;428;429;1;77;2.0
3;50;429;430;1;77;2.0
3;51;430;435;5;77;2.0
3;52;435;439;4;77;2.0
3;53;439;440;1;77;2.0
3;54;440;442;2;77;2.0
3;55;442;444;2;77;2.0
3;56;444;445;1;77;2.0
3;57;445;448;3;77;2.0
3;58;448;449;1;77;2.0
3;59;449;450;1;77;2.0
3;60;450;452;2;77;2.0
3;61;452;454;2;77;2.0
3;62;454;455;1;77;2.0
3;63;455;457;2;77;2.0
3;64;457;459;2;77;2.0
3;65;459;460;1;77;2.0
3;66;460;465;5;77;2.0
3;67;465;467;2;77;2.0
3;68;467;468;1;77;2.0
3;69;468;469;1;77;2.0
3;70;469;470;1;77;2.0
3;71;470;472;2;77;2.0
3;72;472;474;2;77;2.0
3;73;474;475;1;77;2.0
3;74;475;477;2;77;2.0
3;75;477;479;2;77;2.0
3;76;479;480;1;77;2.0
3;77;480;482;2;77;2.0
3;78;482;485;3;77;2.0
3;79;485;488;3;77;2.0
3;80;488;489;1;77;2.0
3;81;489;490;1;77;2.0
3;82;490;492;2;77;2.0
3;83;492;495;3;77;2.0
3;84;495;497;2;77;2.0
3;85;497;499;2;77;2.0
3;86;499;505;6;77;2.0
3;87;505;508;3;77;2.0
3;88;508;509;1;77;2.0
3;89;509;512;3;77;2.0
3;90;512;515;3;77;2.0
3;91;515;517;2;77;2.0
3;92;517;519;2;77;2.0
3;93;519;522;3;77;2.0
3;94;522;525;3;77;2.0
3;95;525;528;3;77;2.0
3;96;528;530;2;77;2.0
3;97;530;534;4;77;2.0
3;98;534;535;1;77;2.0
3;99;535;537;2;77;2.0
3;100;537;539;2;77;2.0
3;101;539;540;1;77;2.0
3;102;540;545;5;77;2.0
3;103;545;548;3;77;2.0
3;104;548;555;7;77;2.0
3;105;555;557;2;77;2.0
3;106;557;559;2;77;2.0
3;107;559;560;1;77;2.0
3;108;560;565;5;77;2.0
3;109;565;568;3;77;2.0
3;110;568;570;2;77;2.0
3;111;570;572;2;77;2.0
3;112;572;575;3;77;2.0
3;113;575;577;2;77;2.0
3;114;577;579;2;77;2.0
3;115;579;580;1;77;2.0
3;116;580;585;5;77;2.0
3;117;585;588;3;77;2.0
3;118;588;594;6;77;2.0
3;119;594;595;1;77;2.0
3;120;595;597;2;77;2.0
3;121;597;599;2;77;2.0
3;122;599;600;1;77;2.0
3;123;600;605;5;77;2.0
3;124;605;608;3;77;2.0
3;125;608;610;2;77;2.0
3;126;610;615;5;77;2.0
3;127;615;617;2;77;2.0
3;128;617;619;2;77;2.0
3;129;619;620;1;77;2.0
3;130;620;625;5;77;2.0
3;131;625;628;3;77;2.0
3;132;628;630;2;77;2.0
3;133;630;632;2;77;2.0
3;134;632;635;3;77;2.0
3;135;635;637;2;77;2.0
3;136;637;639;2;77;2.0
3;137;639;640;1;77;2.0
3;138;640;645;5;77;2.0
3;139;645;648;3;77;2.0
3;140;648;654;6;77;2.0
3;141;654;655;1;77;2.0
3;142;655;657;2;77;2.0
3;143;657;659;2;77;2.0
3;144;659;660;1;77;2.0
3;145;660;665;5;77;2.0
3;146;665;668;3;77;2.0
3;147;668;670;2;77;2.0
3;148;670;675;5;77;2.0
3;149;675;677;2;77;2.0
3;150;677;679;2;77;2.0
3;151;679;680;1;77;2.0
3;152;680;685;5;77;2.0
3;153;685;688;3;77;2.0
3;154;688;690;2;77;2.0
3;155;690;692;2;77;2.0
3;156;692;695;3;77;2.0
3;157;695;697;2;77;2.0
3;158;697;699;2;77;2.0
3;159;699;700;1;77;2.0
3;160;700;705;5;77;2.0
3;161;705;708;3;77;2.0
3;162;708;714;6;77;2.0
3;163;714;715;1;77;2.0
3;164;715;717;2;77;2.0
3;165;717;719;2;77;2.0
3;166;719;720;1;77;2.0
3;167;720;725;5;77;2.0
3;168;725;728;3;77;2.0
3;169;728;730;2;77;2.0
3;170;730;735;5;77;2.0
3;171;735;737;2;77;2.0
3;172;737;739;2;77;2.0
3;173;739;740;1;77;2.0
3;174;740;745;5;77;2.0
3;175;745;748;3;77;2.0
3;176;748;750;2;77;2.0
3;177;750;752;2;77;2.0
3;178;752;755;3;77;2.0
3;179;755;757;2;77;2.0
3;180;757;759;2;77;2.0
3;181;759;760;1;77;2.0
3;182;760;765;5;77;2.0
3;183;765;768;3;77;2.0
3;184;768;774;6;77;2.0
3;185;774;775;1;77;2.0
3;186;775;777;2;77;2.0
3;187;777;779;2;77;2.0
3;188;779;780;1;77;2.0
3;189;780;785;5;77;2.0
3;190;785;788;3;77;2.0
3;191;788;790;2;77;2.0
3;192;790;795;5;77;2.0
3;193;795;797;2;77;2.0
3;194;797;799;2;77;2.0
3;195;799;800;1;77;2.0
3;196;800;805;5;77;2.0
3;197;805;808;3;77;2.0
3;198;808;812;4;77;2.0
3;199;812;814;2;77;2.0
3;200;814;815;1;77;2.0
3;201;815;817;2;77;2.0
3;202;817;819;2;77;2.0
3;203;819;820;1;77;2.0
3;204;820;825;5;77;2.0
3;205;825;828;3;77;2.0
3;206;828;829;1;77;2.0
3;207;829;834;5;77;2.0
3;208;834;835;1;77;2.0
3;209;835;837;2;77;2.0
3;210;837;839;2;77;2.0
3;211;839;840;1;77;2.0
3;212;840;845;5;77;2.0
3;213;845;848;3;77;2.0
3;214;848;849;1;77;2.0
3;215;849;850;1;77;2.0
3;216;850;855;5;77;2.0
3;217;855;857;2;77;2.0
3;218;857;859;2;77;2.0
3;219;859;860;1;77;2.0
3;220;860;865;5;77;2.0
3;221;865;868;3;77;2.0
3;222;868;869;1;77;2.0
3;223;869;870;1;77;2.0
3;224;870;872;2;77;2.0
3;225;872;874;2;77;2.0
3;226;874;875;1;77;2.0
3;227;875;877;2;77;2.0
3;228;877;879;2;77;2.0
3;229;879;880;1;77;2.0
3;230;880;885;5;77;2.0
3;231;885;887;2;77;2.0
3;232;887;888;1;77;2.0
3;233;888;889;1;77;2.0
3;234;889;890;1;77;2.0
3;235;890;894;4;77;2.0
3;236;894;895;1;77;2.0
3;237;895;897;2;77;2.0
3;238;897;899;2;77;2.0
3;239;899;900;1;77;2.0
3;240;900;905;5;77;2.0
3;241;905;908;3;77;2.0
3;242;908;909;1;77;2.0
3;243;909;910;1;77;2.0
3;244;910;912;2;77;2.0
3;245;912;915;3;77;2.0
3;246;915;917;2;77;2.0
3;247;917;919;2;77;2.0
3;248;919;920;1;77;2.0
3;249;920;925;5;77;2.0
3;250;925;928;3;77;2.0
3;251;928;929;1;77;2.0
3;252;929;930;1;77;2.0
3;253;930;932;2;77;2.0
3;254;932;934;2;77;2.0
3;255;934;935;1;77;2.0
3;256;935;937;2;77;2.0
3;257;937;939;2;77;2.0
3;258;939;940;1;77;2.0
3;259;940;945;5;77;2.0
3;260;945;947;2;77;2.0
3;261;947;948;1;77;2.0
3;262;948;949;1;77;2.0
3;263;949;950;1;77;2.0
3;264;950;954;4;77;2.0
3;265;954;955;1;77;2.0
3;266;955;957;2;77;2.0
3;267;957;959;2;77;2.0
3;268;959;960;1;77;2.0
3;269;960;965;5;77;2.0
3;270;965;968;3;77;2.0
3;271;968;969;1;77;2.0
3;272;969;970;1;77;2.0
3;273;970;972;2;77;2.0
3;274;972;975;3;77;2.0
3;275;975;977;2;77;2.0
3;276;977;979;2;77;2.0
3;277;979;980;1;77;2.0
3;278;980;985;5;77;2.0
3;279;985;988;3;77;2.0
3;280;988;989;1;77;2.0
3;281;989;990;1;77;2.0
3;282;990;995;5;77;2.0
3;283;995;997;2;77;2.0
3;284;997;999;2;77;2.0
3;285;999;1000;1;77;2.0
3;286;1000;1005;5;77;2.0
3;287;1005;1007;2;77;2.0
3;288;1007;1008;1;77;2.0
3;289;1008;1009;1;77;2.0
3;290;1009;1010;1;77;2.0
3;291;1010;1014;4;77;2.0
3;292;1014;1015;1;77;2.0
3;293;1015;1017;2;77;2.0
3;294;1017;1025;8;77;2.0
3;295;1025;1028;3;77;2.0
3;296;1028;1029;1;77;2.0
3;297;1029;1030;1;77;2.0
3;298;1030;1035;5;77;2.0
3;299;1035;1037;2;77;2.0
3;300;1037;1040;3;77;2.0
3;301;1040;1044;4;77;2.0
3;302;1044;1045;1;77;2.0
3;303;1045;1047;2;77;2.0
3;304;1047;1048;1;77;2.0
3;305;1048;1049;1;77;2.0
3;306;1049;1050;1;77;2.0
3;307;1050;1055;5;77;2.0
3;308;1055;1057;2;77;2.0
3;309;1057;1059;2;77;2.0
3;310;1059;1060;1;77;2.0
3;311;1060;1067;7;77;2.0
3;312;1067;1068;1;77;2.0
3;313;1068;1069;1;77;2.0
3;314;1069;1070;1;77;2.0
3;315;1070;1073;3;77;2.0
3;316;1073;1074;1;77;2.0
3;317;1074;1075;1;77;2.0
3;318;1075;1077;2;77;2.0
3;319;1077;1085;8;77;2.0
3;320;1085;1088;3;77;2.0
3;321;1088;1089;1;77;2.0
3;322;1089;1090;1;77;2.0
3;323;1090;1097;7;77;2.0
3;324;1097;1100;3;77;2.0
3;325;1100;1103;3;77;2.0
3;326;1103;1104;1;77;2.0
3;327;1104;1105;1;77;2.0
3;328;1105;1109;4;77;2.0
3;329;1109;1110;1;77;2.0
3;330;1110;1112;2;77;2.0
3;331;1112;1115;3;77;2.0
3;332;1115;1116;1;77;2.0
3;333;1116;1117;1;77;2.0
3;334;1117;1127;10;77;2.0
3;335;1127;1128;1;77;2.0
3;336;1128;1130;2;77;2.0
3;337;1130;1132;2;77;2.0
3;338;1132;1136;4;77;2.0
3;339;1136;1137;1;77;2.0
3;340;1137;1141;4;77;2.0
3;341;1141;1142;1;77;2.0
3;342;1142;1145;3;77;2.0
3;343;1145;1147;2;77;2.0
3;344;1147;1148;1;77;2.0
3;345;1148;1154;6;77;2.0
3;346;1154;1156;2;77;2.0
3;347;1156;1157;1;77;2.0
3;348;1157;1162;5;77;2.0
3;349;1162;1170;8;77;2.0
3;350;1170;1173;3;77;2.0
3;351;1173;1176;3;77;2.0
3;352;1176;1177;1;77;2.0
3;353;1177;1179;2;77;2.0
3;354;1179;1182;3;77;2.0
3;355;1182;1190;8;77;2.0
3;356;1190;1196;6;77;2.0
3;357;1196;1197;1;77;2.0
3;358;1197;1198;1;77;2.0
3;359;1198;1202;4;77;2.0
3;360;1202;1211;9;77;2.0
3;361;1211;1217;6;77;2.0
3;362;1217;1221;4;77;2.0
3;363;1221;1222;1;77;2.0
3;364;1222;1227;5;77;2.0
3;365;1227;1229;2;77;2.0
3;366;1229;1230;1;77;2.0
3;367;1230;1232;2;77;2.0
3;368;1232;1233;1;77;2.0
3;369;1233;1237;4;77;2.0
3;370;1237;1246;9;77;2.0
3;371;1246;1247;1;77;2.0
3;372;1247;1252;5;77;2.0
3;373;1252;1254;2;77;2.0
3;374;1254;1262;8;77;2.0
3;375;1262;1268;6;77;2.0
3;376;1268;1270;2;77;2.0
3;377;1270;1271;1;77;2.0
3;378;1271;1272;1;77;2.0
3;379;1272;1277;5;77;2.0
3;380;1277;1286;9;77;2.0
3;381;1286;1287;1;77;2.0
3;382;1287;1296;9;77;2.0
3;383;1296;1299;3;77;2.0
3;384;1299;1302;3;77;2.0
3;385;1302;1303;1;77;2.0
3;386;1303;1305;2;77;2.0
3;387;1305;1311;6;77;2.0
3;388;1311;1312;1;77;2.0
3;389;1312;1322;10;77;2.0
3;390;1322;1326;4;77;2.0
3;391;1326;1327;1;77;2.0
3;392;1327;1336;9;77;2.0
3;393;1336;1337;1;77;2.0
3;394;1337;1342;5;77;2.0
3;395;1342;1344;2;77;2.0
3;396;1344;1346;2;77;2.0
3;397;1346;1347;1;77;2.0
3;398;1347;1357;10;77;2.0
3;399;1357;1361;4;77;2.0
3;400;1361;1363;2;77;2.0
3;401;1363;1365;2;77;2.0
3;402;1365;1382;17;77;2.0
3;403;1382;1397;15;77;2.0
3;404;1397;1412;15;77;2.0
3;405;1412;1427;15;77;2.0
3;406;1427;1442;15;77;2.0
3;407;1442;1457;15;77;2.0
3;408;1457;1472;15;77;2.0
3;409;1472;1487;15;77;2.0
3;410;1487;1502;15;77;2.0
3;411;1502;1517;15;77;2.0
3;412;1517;1532;15;77;2.0
3;413;1532;1547;15;77;2.0
3;414;1547;1562;15;77;2.0
3;415;1562;1577;15;77;2.0
3;416;1577;1592;15;77;2.0
3;417;1592;1607;15;77;2.0
3;418;1607;1622;15;77;2.0
3;419;1622;1637;15;77;2.0
3;420;1637;1652;15;77;2.0
3;421;1652;1667;15;77;2.0
3;422;1667;1680;13;77;2.0
4;0;243;323;80;93;2.0
4;1;323;329;6;93;2.0
4;2;329;335;6;93;2.0
4;3;335;336;1;93;2.0
4;4;336;338;2;93;2.0
4;5;338;340;2;93;2.0
4;6;340;343;3;93;2.0
4;7;343;344;1;93;2.0
4;8;344;345;1;93;2.0
4;9;345;346;1;93;2.0
4;10;346;349;3;93;2.0
4;11;349;351;2;93;2.0
4;12;351;352;1;93;2.0
4;13;352;353;1;93;2.0
4;14;353;359;6;93;2.0
4;15;359;363;4;93;2.0
4;16;363;364;1;93;2.0
4;17;364;366;2;93;2.0
4;18;366;368;2;93;2.0
4;19;368;370;2;93;2.0
4;20;370;373;3;93;2.0
4;21;373;376;3;93;2.0
4;22;376;378;2;93;2.0
4;23;378;379;1;93;2.0
4;24;379;382;3;93;2.0
4;25;382;383;1;93;2.0
4;26;383;386;3;93;2.0
4;27;386;393;7;93;2.0
4;28;393;395;2;93;2.0
4;29;395;396;1;93;2.0
4;30;396;399;3;93;2.0
4;31;399;403;4;93;2.0
4;32;403;406;3;93;2.0
4;33;406;410;4;93;2.0
4;34;410;412;2;93;2.0
4;35;412;413;1;93;2.0
4;36;413;416;3;93;2.0
4;37;416;419;3;93;2.0
4;38;419;420;1;93;2.0
4;39;420;423;3;93;2.0
4;40;423;426;3;93;2.0
4;41;426;430;4;93;2.0
4;42;430;433;3;93;2.0
4;43;433;436;3;93;2.0
4;44;436;439;3;93;2.0
4;45;439;440;1;93;2.0
4;46;440;442;2;93;2.0
4;47;442;443;1;93;2.0
4;48;443;446;3;93;2.0
4;49;446;453;7;93;2.0
4;50;453;455;2;93;2.0
4;51;455;456;1;93;2.0
4;52;456;458;2;93;2.0
4;53;458;459;1;93;2.0
4;54;459;463;4;93;2.0
4;55;463;466;3;93;2.0
4;56;466;470;4;93;2.0
4;57;470;472;2;93;2.0
4;58;472;473;1;93;2.0
4;59;473;476;3;93;2.0
4;60;476;479;3;93;2.0
4;61;479;480;1;93;2.0
4;62;480;483;3;93;2.0
4;63;483;486;3;93;2.0
4;64;486;490;4;93;2.0
4;65;490;493;3;93;2.0
4;66;493;499;6;93;2.0
4;67;499;500;1;93;2.0
4;68;500;501;1;93;2.0
4;69;501;503;2;93;2.0
4;70;503;506;3;93;2.0
4;71;506;513;7;93;2.0
4;72;513;518;5;93;2.0
4;73;518;519;1;93;2.0
4;74;519;523;4;93;2.0
4;75;523;526;3;93;2.0
4;76;526;529;3;93;2.0
4;77;529;532;3;93;2.0
4;78;532;536;4;93;2.0
4;79;536;538;2;93;2.0
4;80;538;539;1;93;2.0
4;81;539;543;4;93;2.0
4;82;543;546;3;93;2.0
4;83;546;553;7;93;2.0
4;84;553;556;3;93;2.0
4;85;556;558;2;93;2.0
4;86;558;559;1;93;2.0
4;87;559;560;1;93;2.0
4;88;560;563;3;93;2.0
4;89;563;566;3;93;2.0
4;90;566;569;3;93;2.0
4;91;569;573;4;93;2.0
4;92;573;576;3;93;2.0
4;93;576;578;2;93;2.0
4;94;578;579;1;93;2.0
4;95;579;583;4;93;2.0
4;96;583;586;3;93;2.0
4;97;586;592;6;93;2.0
4;98;592;593;1;93;2.0
4;99;593;596;3;93;2.0
4;100;596;598;2;93;2.0
4;101;598;599;1;93;2.0
4;102;599;603;4;93;2.0
4;103;603;606;3;93;2.0
4;104;606;609;3;93;2.0
4;105;609;616;7;93;2.0
4;106;616;618;2;93;2.0
4;107;618;619;1;93;2.0
4;108;619;620;1;93;2.0
4;109;620;623;3;93;2.0
4;110;623;626;3;93;2.0
4;111;626;629;3;93;2.0
4;112;629;633;4;93;2.0
4;113;633;636;3;93;2.0
4;114;636;638;2;93;2.0
4;115;638;639;1;93;2.0
4;116;639;643;4;93;2.0
4;117;643;646;3;93;2.0
4;118;646;652;6;93;2.0
4;119;652;653;1;93;2.0
4;120;653;656;3;93;2.0
4;121;656;658;2;93;2.0
4;122;658;659;1;93;2.0
4;123;659;663;4;93;2.0
4;124;663;666;3;93;2.0
4;125;666;669;3;93;2.0
4;126;669;676;7;93;2.0
4;127;676;678;2;93;2.0
4;128;678;679;1;93;2.0
4;129;679;683;4;93;2.0
4;130;683;686;3;93;2.0
4;131;686;689;3;93;2.0
4;132;689;693;4;93;2.0
4;133;693;696;3;93;2.0
4;134;696;698;2;93;2.0
4;135;698;699;1;93;2.0
4;136;699;703;4;93;2.0
4;137;703;706;3;93;2.0
4;138;706;712;6;93;2.0
4;139;712;713;1;93;2.0
4;140;713;716;3;93;2.0
4;141;716;718;2;93;2.0
4;142;718;719;1;93;2.0
4;143;719;723;4;93;2.0
4;144;723;726;3;93;2.0
4;145;726;729;3;93;2.0
4;146;729;736;7;93;2.0
4;147;736;738;2;93;2.0
4;148;738;739;1;93;2.0
4;149;739;743;4;93;2.0
4;150;743;746;3;93;2.0
4;151;746;749;3;93;2.0
4;152;749;753;4;93;2.0
4;153;753;756;3;93;2.0
4;154;756;758;2;93;2.0
4;155;758;759;1;93;2.0
4;156;759;763;4;93;2.0
4;157;763;766;3;93;2.0
4;158;766;772;6;93;2.0
4;159;772;773;1;93;2.0
4;160;773;776;3;93;2.0
4;161;776;778;2;93;2.0
4;162;778;779;1;93;2.0
4;163;779;783;4;93;2.0
4;164;783;786;3;93;2.0
4;165;786;789;3;93;2.0
4;166;789;793;4;93;2.0
4;167;793;796;3;93;2.0
4;168;796;798;2;93;2.0
4;169;798;799;1;93;2.0
4;170;799;800;1;93;2.0
4;171;800;803;3;93;2.0
4;172;803;806;3;93;2.0
4;173;806;812;6;93;2.0
4;174;812;813;1;93;2.0
4;175;813;816;3;93;2.0
4;176;816;818;2;93;2.0
4;177;818;819;1;93;2.0
4;178;819;823;4;93;2.0
4;179;823;826;3;93;2.0
4;180;826;830;4;93;2.0
4;181;830;832;2;93;2.0
4;182;832;833;1;93;2.0
4;183;833;836;3;93;2.0
4;184;836;838;2;93;2.0
4;185;838;839;1;93;2.0
4;186;839;843;4;93;2.0
4;187;843;846;3;93;2.0
4;188;846;847;1;93;2.0
4;189;847;849;2;93;2.0
4;190;849;850;1;93;2.0
4;191;850;853;3;93;2.0
4;192;853;856;3;93;2.0
4;193;856;858;2;93;2.0
4;194;858;859;1;93;2.0
4;195;859;860;1;93;2.0
4;196;860;863;3;93;2.0
4;197;863;866;3;93;2.0
4;198;866;869;3;93;2.0
4;199;869;870;1;93;2.0
4;200;870;872;2;93;2.0
4;201;872;873;1;93;2.0
4;202;873;876;3;93;2.0
4;203;876;878;2;93;2.0
4;204;878;879;1;93;2.0
4;205;879;883;4;93;2.0
4;206;883;886;3;93;2.0
4;207;886;888;2;93;2.0
4;208;888;890;2;93;2.0
4;209;890;892;2;93;2.0
4;210;892;893;1;93;2.0
4;211;893;896;3;93;2.0
4;212;896;898;2;93;2.0
4;213;898;899;1;93;2.0
4;214;899;903;4;93;2.0
4;215;903;906;3;93;2.0
4;216;906;907;1;93;2.0
4;217;907;909;2;93;2.0
4;218;909;910;1;93;2.0
4;219;910;913;3;93;2.0
4;220;913;916;3;93;2.0
4;221;916;918;2;93;2.0
4;222;918;919;1;93;2.0
4;223;919;920;1;93;2.0
4;224;920;923;3;93;2.0
4;225;923;926;3;93;2.0
4;226;926;929;3;93;2.0
4;227;929;930;1;93;2.0
4;228;930;932;2;93;2.0
4;229;932;933;1;93;2.0
4;230;933;936;3;93;2.0
4;231;936;938;2;93;2.0
4;232;938;939;1;93;2.0
4;233;939;943;4;93;2.0
4;234;943;946;3;93;2.0
4;235;946;948;2;93;2.0
4;236;948;950;2;93;2.0
4;237;950;952;2;93;2.0
4;238;952;953;1;93;2.0
4;239;953;956;3;93;2.0
4;240;956;958;2;93;2.0
4;241;958;959;1;93;2.0
4;242;959;963;4;93;2.0
4;243;963;966;3;93;2.0
4;244;966;967;1;93;2.0
4;245;967;969;2;93;2.0
4;246;969;970;1;93;2.0
4;247;970;973;3;93;2.0
4;248;973;976;3;93;2.0
4;249;976;978;2;93;2.0
4;250;978;979;1;93;2.0
4;251;979;980;1;93;2.0
4;252;980;983;3;93;2.0
4;253;983;986;3;93;2.0
4;254;986;989;3;93;2.0
4;255;989;990;1;93;2.0
4;256;990;993;3;93;2.0
4;257;993;996;3;93;2.0
4;258;996;998;2;93;2.0
4;259;998;999;1;93;2.0
4;260;999;1003;4;93;2.0
4;261;1003;1006;3;93;2.0
4;262;1006;1007;1;93;2.0
4;263;1007;1008;1;93;2.0
4;264;1008;1010;2;93;2.0
4;265;1010;1013;3;93;2.0
4;266;1013;1018;5;93;2.0
4;267;1018;1019;1;93;2.0
4;268;1019;1021;2;93;2.0
4;269;1021;1026;5;93;2.0
4;270;1026;1027;1;93;2.0
4;271;1027;1028;1;93;2.0
4;272;1028;1029;1;93;2.0
4;273;1029;1030;1;93;2.0
4;274;1030;1033;3;93;2.0
4;275;1033;1036;3;93;2.0
4;276;1036;1038;2;93;2.0
4;277;1038;1039;1;93;2.0
4;278;1039;1043;4;93;2.0
4;279;1043;1046;3;93;2.0
4;280;1046;1048;2;93;2.0
4;281;1048;1049;1;93;2.0
4;282;1049;1050;1;93;2.0
4;283;1050;1051;1;93;2.0
4;284;1051;1058;7;93;2.0
4;285;1058;1059;1;93;2.0
4;286;1059;1063;4;93;2.0
4;287;1063;1066;3;93;2.0
4;288;1066;1068;2;93;2.0
4;289;1068;1070;2;93;2.0
4;290;1070;1071;1;93;2.0
4;291;1071;1073;2;93;2.0
4;292;1073;1078;5;93;2.0
4;293;1078;1079;1;93;2.0
4;294;1079;1081;2;93;2.0
4;295;1081;1086;5;93;2.0
4;296;1086;1088;2;93;2.0
4;297;1088;1089;1;93;2.0
4;298;1089;1090;1;93;2.0
4;299;1090;1093;3;93;2.0
4;300;1093;1096;3;93;2.0
4;301;1096;1098;2;93;2.0
4;302;1098;1103;5;93;2.0
4;303;1103;1107;4;93;2.0
4;304;1107;1108;1;93;2.0
4;305;1108;1110;2;93;2.0
4;306;1110;1111;1;93;2.0
4;307;1111;1113;2;93;2.0
4;308;1113;1115;2;93;2.0
4;309;1115;1118;3;93;2.0
4;310;1118;1120;2;93;2.0
4;311;1120;1123;3;93;2.0
4;312;1123;1128;5;93;2.0
4;313;1128;1129;1;93;2.0
4;314;1129;1130;1;93;2.0
4;315;1130;1132;2;93;2.0
4;316;1132;1137;5;93;2.0
4;317;1137;1138;1;93;2.0
4;318;1138;1140;2;93;2.0
4;319;1140;1143;3;93;2.0
4;320;1143;1145;2;93;2.0
4;321;1145;1152;7;93;2.0
4;322;1152;1153;1;93;2.0
4;323;1153;1158;5;93;2.0
4;324;1158;1160;2;93;2.0
4;325;1160;1168;8;93;2.0
4;326;1168;1171;3;93;2.0
4;327;1171;1173;2;93;2.0
4;328;1173;1177;4;93;2.0
4;329;1177;1178;1;93;2.0
4;330;1178;1180;2;93;2.0
4;331;1180;1188;8;93;2.0
4;332;1188;1193;5;93;2.0
4;333;1193;1195;2;93;2.0
4;334;1195;1200;5;93;2.0
4;335;1200;1202;2;93;2.0
4;336;1202;1203;1;93;2.0
4;337;1203;1207;4;93;2.0
4;338;1207;1213;6;93;2.0
4;339;1213;1223;10;93;2.0
4;340;1223;1225;2;93;2.0
4;341;1225;1228;3;93;2.0
4;342;1228;1230;2;93;2.0
4;343;1230;1231;1;93;2.0
4;344;1231;1233;2;93;2.0
4;345;1233;1237;4;93;2.0
4;346;1237;1248;11;93;2.0
4;347;1248;1250;2;93;2.0
4;348;1250;1253;3;93;2.0
4;349;1253;1258;5;93;2.0
4;350;1258;1268;10;93;2.0
4;351;1268;1270;2;93;2.0
4;352;1270;1272;2;93;2.0
4;353;1272;1273;1;93;2.0
4;354;1273;1275;2;93;2.0
4;355;1275;1282;7;93;2.0
4;356;1282;1283;1;93;2.0
4;357;1283;1300;17;93;2.0
4;358;1300;1306;6;93;2.0
4;359;1306;1307;1;93;2.0
4;360;1307;1308;1;93;2.0
4;361;1308;1310;2;93;2.0
4;362;1310;1320;10;93;2.0
4;363;1320;1328;8;93;2.0
4;364;1328;1330;2;93;2.0
4;365;1330;1332;2;93;2.0
4;366;1332;1333;1;93;2.0
4;367;1333;1340;7;93;2.0
4;368;1340;1344;4;93;2.0
4;369;1344;1345;1;93;2.0
4;370;1345;1350;5;93;2.0
4;371;1350;1358;8;93;2.0
4;372;1358;1361;3;93;2.0
4;373;1361;1365;4;93;2.0
4;374;1365;1378;13;93;2.0
4;375;1378;1383;5;93;2.0
4;376;1383;1398;15;93;2.0
4;377;1398;1413;15;93;2.0
4;378;1413;1428;15;93;2.0
4;379;1428;1443;15;93;2.0
4;380;1443;1458;15;93;2.0
4;381;1458;1473;15;93;2.0
4;382;1473;1488;15;93;2.0
4;383;1488;1503;15;93;2.0
4;384;1503;1518;15;93;2.0
4;385;1518;1533;15;93;2.0
4;386;1533;1548;15;93;2.0
4;387;1548;1563;15;93;2.0
4;388;1563;1578;15;93;2.0
4;389;1578;1593;15;93;2.0
4;390;1593;1608;15;93;2.0
4;391;1608;1623;15;93;2.0
4;392;1623;1638;15;93;2.0
4;393;1638;1653;15;93;2.0
4;394;1653;1668;15;93;2.0
4;395;1668;1680;12;93;2.0
5;0;245;329;84;112;2.0
5;1;329;334;5;112;2.0
5;2;334;335;1;112;2.0
5;3;335;338;3;112;2.0
5;4;338;339;1;112;2.0
5;5;339;340;1;112;2.0
5;6;340;341;1;112;2.0
5;7;341;342;1;112;2.0
5;8;342;347;5;112;2.0
5;9;347;349;2;112;2.0
5;10;349;350;1;112;2.0
5;11;350;351;1;112;2.0
5;12;351;354;3;112;2.0
5;13;354;356;2;112;2.0
5;14;356;357;1;112;2.0
5;15;357;358;1;112;2.0
5;16;358;359;1;112;2.0
5;17;359;364;5;112;2.0
5;18;364;365;1;112;2.0
5;19;365;369;4;112;2.0
5;20;369;370;1;112;2.0
5;21;370;371;1;112;2.0
5;22;371;373;2;112;2.0
5;23;373;378;5;112;2.0
5;24;378;379;1;112;2.0
5;25;379;380;1;112;2.0
5;26;380;382;2;112;2.0
5;27;382;384;2;112;2.0
5;28;384;386;2;112;2.0
5;29;386;388;2;112;2.0
5;30;388;390;2;112;2.0
5;31;390;391;1;112;2.0
5;32;391;392;1;112;2.0
5;33;392;394;2;112;2.0
5;34;394;398;4;112;2.0
5;35;398;400;2;112;2.0
5;36;400;402;2;112;2.0
5;37;402;404;2;112;2.0
5;38;404;405;1;112;2.0
5;39;405;408;3;112;2.0
5;40;408;409;1;112;2.0
5;41;409;411;2;112;2.0
5;42;411;412;1;112;2.0
5;43;412;414;2;112;2.0
5;44;414;416;2;112;2.0
5;45;416;418;2;112;2.0
5;46;418;419;1;112;2.0
5;47;419;420;1;112;2.0
5;48;420;422;2;112;2.0
5;49;422;424;2;112;2.0
5;50;424;425;1;112;2.0
5;51;425;428;3;112;2.0
5;52;428;429;1;112;2.0
5;53;429;431;2;112;2.0
5;54;431;432;1;112;2.0
5;55;432;434;2;112;2.0
5;56;434;435;1;112;2.0
5;57;435;438;3;112;2.0
5;58;438;440;2;112;2.0
5;59;440;442;2;112;2.0
5;60;442;444;2;112;2.0
5;61;444;446;2;112;2.0
5;62;446;448;2;112;2.0
5;63;448;450;2;112;2.0
5;64;450;451;1;112;2.0
5;65;451;452;1;112;2.0
5;66;452;453;1;112;2.0
5;67;453;454;1;112;2.0
5;68;454;458;4;112;2.0
5;69;458;459;1;112;2.0
5;70;459;460;1;112;2.0
5;71;460;462;2;112;2.0
5;72;462;464;2;112;2.0
5;73;464;465;1;112;2.0
5;74;465;468;3;112;2.0
5;75;468;469;1;112;2.0
5;76;469;471;2;112;2.0
5;77;471;472;1;112;2.0
5;78;472;474;2;112;2.0
5;79;474;476;2;112;2.0
5;80;476;478;2;112;2.0
5;81;478;479;1;112;2.0
5;82;479;480;1;112;2.0
5;83;480;482;2;112;2.0
5;84;482;484;2;112;2.0
5;85;484;485;1;112;2.0
5;86;485;488;3;112;2.0
5;87;488;491;3;112;2.0
5;88;491;492;1;112;2.0
5;89;492;494;2;112;2.0
5;90;494;495;1;112;2.0
5;91;495;499;4;112;2.0
5;92;499;500;1;112;2.0
5;93;500;504;4;112;2.0
5;94;504;507;3;112;2.0
5;95;507;508;1;112;2.0
5;96;508;511;3;112;2.0
5;97;511;513;2;112;2.0
5;98;513;514;1;112;2.0
5;99;514;519;5;112;2.0
5;100;519;520;1;112;2.0
5;101;520;524;4;112;2.0
5;102;524;528;4;112;2.0
5;103;528;531;3;112;2.0
5;104;531;532;1;112;2.0
5;105;532;533;1;112;2.0
5;106;533;536;3;112;2.0
5;107;536;540;4;112;2.0
5;108;540;542;2;112;2.0
5;109;542;544;2;112;2.0
5;110;544;548;4;112;2.0
5;111;548;551;3;112;2.0
5;112;551;553;2;112;2.0
5;113;553;554;1;112;2.0
5;114;554;559;5;112;2.0
5;115;559;560;1;112;2.0
5;116;560;562;2;112;2.0
5;117;562;564;2;112;2.0
5;118;564;568;4;112;2.0
5;119;568;571;3;112;2.0
5;120;571;572;1;112;2.0
5;121;572;573;1;112;2.0
5;122;573;580;7;112;2.0
5;123;580;582;2;112;2.0
5;124;582;584;2;112;2.0
5;125;584;588;4;112;2.0
5;126;588;591;3;112;2.0
5;127;591;593;2;112;2.0
5;128;593;596;3;112;2.0
5;129;596;599;3;112;2.0
5;130;599;600;1;112;2.0
5;131;600;602;2;112;2.0
5;132;602;604;2;112;2.0
5;133;604;608;4;112;2.0
5;134;608;611;3;112;2.0
5;135;611;612;1;112;2.0
5;136;612;613;1;112;2.0
5;137;613;614;1;112;2.0
5;138;614;620;6;112;2.0
5;139;620;622;2;112;2.0
5;140;622;624;2;112;2.0
5;141;624;628;4;112;2.0
5;142;628;631;3;112;2.0
5;143;631;632;1;112;2.0
5;144;632;633;1;112;2.0
5;145;633;640;7;112;2.0
5;146;640;642;2;112;2.0
5;147;642;644;2;112;2.0
5;148;644;648;4;112;2.0
5;149;648;651;3;112;2.0
5;150;651;653;2;112;2.0
5;151;653;656;3;112;2.0
5;152;656;659;3;112;2.0
5;153;659;660;1;112;2.0
5;154;660;662;2;112;2.0
5;155;662;664;2;112;2.0
5;156;664;668;4;112;2.0
5;157;668;671;3;112;2.0
5;158;671;672;1;112;2.0
5;159;672;673;1;112;2.0
5;160;673;680;7;112;2.0
5;161;680;682;2;112;2.0
5;162;682;684;2;112;2.0
5;163;684;688;4;112;2.0
5;164;688;691;3;112;2.0
5;165;691;692;1;112;2.0
5;166;692;693;1;112;2.0
5;167;693;700;7;112;2.0
5;168;700;702;2;112;2.0
5;169;702;704;2;112;2.0
5;170;704;708;4;112;2.0
5;171;708;711;3;112;2.0
5;172;711;713;2;112;2.0
5;173;713;716;3;112;2.0
5;174;716;719;3;112;2.0
5;175;719;720;1;112;2.0
5;176;720;722;2;112;2.0
5;177;722;724;2;112;2.0
5;178;724;728;4;112;2.0
5;179;728;731;3;112;2.0
5;180;731;732;1;112;2.0
5;181;732;733;1;112;2.0
5;182;733;740;7;112;2.0
5;183;740;742;2;112;2.0
5;184;742;744;2;112;2.0
5;185;744;748;4;112;2.0
5;186;748;751;3;112;2.0
5;187;751;752;1;112;2.0
5;188;752;753;1;112;2.0
5;189;753;760;7;112;2.0
5;190;760;762;2;112;2.0
5;191;762;764;2;112;2.0
5;192;764;768;4;112;2.0
5;193;768;771;3;112;2.0
5;194;771;773;2;112;2.0
5;195;773;776;3;112;2.0
5;196;776;779;3;112;2.0
5;197;779;780;1;112;2.0
5;198;780;782;2;112;2.0
5;199;782;784;2;112;2.0
5;200;784;788;4;112;2.0
5;201;788;791;3;112;2.0
5;202;791;792;1;112;2.0
5;203;792;793;1;112;2.0
5;204;793;794;1;112;2.0
5;205;794;798;4;112;2.0
5;206;798;800;2;112;2.0
5;207;800;802;2;112;2.0
5;208;802;804;2;112;2.0
5;209;804;808;4;112;2.0
5;210;808;811;3;112;2.0
5;211;811;813;2;112;2.0
5;212;813;816;3;112;2.0
5;213;816;818;2;112;2.0
5;214;818;819;1;112;2.0
5;215;819;820;1;112;2.0
5;216;820;822;2;112;2.0
5;217;822;824;2;112;2.0
5;218;824;825;1;112;2.0
5;219;825;828;3;112;2.0
5;220;828;831;3;112;2.0
5;221;831;833;2;112;2.0
5;222;833;836;3;112;2.0
5;223;836;838;2;112;2.0
5;224;838;839;1;112;2.0
5;225;839;840;1;112;2.0
5;226;840;842;2;112;2.0
5;227;842;844;2;112;2.0
5;228;844;845;1;112;2.0
5;229;845;848;3;112;2.0
5;230;848;851;3;112;2.0
5;231;851;852;1;112;2.0
5;232;852;853;1;112;2.0
5;233;853;854;1;112;2.0
5;234;854;858;4;112;2.0
5;235;858;860;2;112;2.0
5;236;860;862;2;112;2.0
5;237;862;864;2;112;2.0
5;238;864;865;1;112;2.0
5;239;865;868;3;112;2.0
5;240;868;871;3;112;2.0
5;241;871;872;1;112;2.0
5;242;872;873;1;112;2.0
5;243;873;874;1;112;2.0
5;244;874;876;2;112;2.0
5;245;876;878;2;112;2.0
5;246;878;880;2;112;2.0
5;247;880;882;2;112;2.0
5;248;882;883;1;112;2.0
5;249;883;884;1;112;2.0
5;250;884;885;1;112;2.0
5;251;885;888;3;112;2.0
5;252;888;891;3;112;2.0
5;253;891;892;1;112;2.0
5;254;892;893;1;112;2.0
5;255;893;894;1;112;2.0
5;256;894;896;2;112;2.0
5;257;896;898;2;112;2.0
5;258;898;899;1;112;2.0
5;259;899;900;1;112;2.0
5;260;900;902;2;112;2.0
5;261;902;904;2;112;2.0
5;262;904;905;1;112;2.0
5;263;905;908;3;112;2.0
5;264;908;911;3;112;2.0
5;265;911;912;1;112;2.0
5;266;912;913;1;112;2.0
5;267;913;914;1;112;2.0
5;268;914;918;4;112;2.0
5;269;918;920;2;112;2.0
5;270;920;922;2;112;2.0
5;271;922;924;2;112;2.0
5;272;924;925;1;112;2.0
5;273;925;928;3;112;2.0
5;274;928;931;3;112;2.0
5;275;931;932;1;112;2.0
5;276;932;933;1;112;2.0
5;277;933;934;1;112;2.0
5;278;934;936;2;112;2.0
5;279;936;938;2;112;2.0
5;280;938;940;2;112;2.0
5;281;940;942;2;112;2.0
5;282;942;943;1;112;2.0
5;283;943;944;1;112;2.0
5;284;944;945;1;112;2.0
5;285;945;948;3;112;2.0
5;286;948;951;3;112;2.0
5;287;951;952;1;112;2.0
5;288;952;953;1;112;2.0
5;289;953;954;1;112;2.0
5;290;954;956;2;112;2.0
5;291;956;958;2;112;2.0
5;292;958;959;1;112;2.0
5;293;959;960;1;112;2.0
5;294;960;962;2;112;2.0
5;295;962;964;2;112;2.0
5;296;964;965;1;112;2.0
5;297;965;968;3;112;2.0
5;298;968;971;3;112;2.0
5;299;971;972;1;112;2.0
5;300;972;973;1;112;2.0
5;301;973;974;1;112;2.0
5;302;974;978;4;112;2.0
5;303;978;980;2;112;2.0
5;304;980;982;2;112;2.0
5;305;982;984;2;112;2.0
5;306;984;985;1;112;2.0
5;307;985;988;3;112;2.0
5;308;988;991;3;112;2.0
5;309;991;992;1;112;2.0
5;310;992;993;1;112;2.0
5;311;993;994;1;112;2.0
5;312;994;998;4;112;2.0
5;313;998;1000;2;112;2.0
5;314;1000;1002;2;112;2.0
5;315;1002;1003;1;112;2.0
5;316;1003;1004;1;112;2.0
5;317;1004;1005;1;112;2.0
5;318;1005;1008;3;112;2.0
5;319;1008;1011;3;112;2.0
5;320;1011;1012;1;112;2.0
5;321;1012;1013;1;112;2.0
5;322;1013;1018;5;112;2.0
5;323;1018;1019;1;112;2.0
5;324;1019;1020;1;112;2.0
5;325;1020;1025;5;112;2.0
5;326;1025;1027;2;112;2.0
5;327;1027;1031;4;112;2.0
5;328;1031;1032;1;112;2.0
5;329;1032;1033;1;112;2.0
5;330;1033;1034;1;112;2.0
5;331;1034;1040;6;112;2.0
5;332;1040;1042;2;112;2.0
5;333;1042;1043;1;112;2.0
5;334;1043;1045;2;112;2.0
5;335;1045;1048;3;112;2.0
5;336;1048;1049;1;112;2.0
5;337;1049;1051;2;112;2.0
5;338;1051;1052;1;112;2.0
5;339;1052;1053;1;112;2.0
5;340;1053;1057;4;112;2.0
5;341;1057;1060;3;112;2.0
5;342;1060;1063;3;112;2.0
5;343;1063;1064;1;112;2.0
5;344;1064;1065;1;112;2.0
5;345;1065;1071;6;112;2.0
5;346;1071;1072;1;112;2.0
5;347;1072;1073;1;112;2.0
5;348;1073;1075;2;112;2.0
5;349;1075;1078;3;112;2.0
5;350;1078;1079;1;112;2.0
5;351;1079;1080;1;112;2.0
5;352;1080;1085;5;112;2.0
5;353;1085;1087;2;112;2.0
5;354;1087;1091;4;112;2.0
5;355;1091;1092;1;112;2.0
5;356;1092;1093;1;112;2.0
5;357;1093;1094;1;112;2.0
5;358;1094;1102;8;112;2.0
5;359;1102;1105;3;112;2.0
5;360;1105;1108;3;112;2.0
5;361;1108;1109;1;112;2.0
5;362;1109;1111;2;112;2.0
5;363;1111;1113;2;112;2.0
5;364;1113;1117;4;112;2.0
5;365;1117;1120;3;112;2.0
5;366;1120;1121;1;112;2.0
5;367;1121;1124;3;112;2.0
5;368;1124;1129;5;112;2.0
5;369;1129;1132;3;112;2.0
5;370;1132;1133;1;112;2.0
5;371;1133;1135;2;112;2.0
5;372;1135;1141;6;112;2.0
5;373;1141;1143;2;112;2.0
5;374;1143;1144;1;112;2.0
5;375;1144;1148;4;112;2.0
5;376;1148;1150;2;112;2.0
5;377;1150;1153;3;112;2.0
5;378;1153;1156;3;112;2.0
5;379;1156;1159;3;112;2.0
5;380;1159;1161;2;112;2.0
5;381;1161;1165;4;112;2.0
5;382;1165;1166;1;112;2.0
5;383;1166;1173;7;112;2.0
5;384;1173;1178;5;112;2.0
5;385;1178;1179;1;112;2.0
5;386;1179;1181;2;112;2.0
5;387;1181;1185;4;112;2.0
5;388;1185;1192;7;112;2.0
5;389;1192;1198;6;112;2.0
5;390;1198;1199;1;112;2.0
5;391;1199;1200;1;112;2.0
5;392;1200;1201;1;112;2.0
5;393;1201;1203;2;112;2.0
5;394;1203;1205;2;112;2.0
5;395;1205;1213;8;112;2.0
5;396;1213;1218;5;112;2.0
5;397;1218;1219;1;112;2.0
5;398;1219;1226;7;112;2.0
5;399;1226;1230;4;112;2.0
5;400;1230;1231;1;112;2.0
5;401;1231;1235;4;112;2.0
5;402;1235;1238;3;112;2.0
5;403;1238;1239;1;112;2.0
5;404;1239;1243;4;112;2.0
5;405;1243;1251;8;112;2.0
5;406;1251;1255;4;112;2.0
5;407;1255;1256;1;112;2.0
5;408;1256;1264;8;112;2.0
5;409;1264;1268;4;112;2.0
5;410;1268;1272;4;112;2.0
5;411;1272;1273;1;112;2.0
5;412;1273;1275;2;112;2.0
5;413;1275;1276;1;112;2.0
5;414;1276;1280;4;112;2.0
5;415;1280;1288;8;112;2.0
5;416;1288;1289;1;112;2.0
5;417;1289;1295;6;112;2.0
5;418;1295;1301;6;112;2.0
5;419;1301;1305;4;112;2.0
5;420;1305;1308;3;112;2.0
5;421;1308;1313;5;112;2.0
5;422;1313;1314;1;112;2.0
5;423;1314;1315;1;112;2.0
5;424;1315;1323;8;112;2.0
5;425;1323;1325;2;112;2.0
5;426;1325;1331;6;112;2.0
5;427;1331;1338;7;112;2.0
5;428;1338;1339;1;112;2.0
5;429;1339;1344;5;112;2.0
5;430;1344;1345;1;112;2.0
5;431;1345;1350;5;112;2.0
5;432;1350;1351;1;112;2.0
5;433;1351;1353;2;112;2.0
5;434;1353;1366;13;112;2.0
5;435;1366;1367;1;112;2.0
5;436;1367;1378;11;112;2.0
5;437;1378;1384;6;112;2.0
5;438;1384;1399;15;112;2.0
5;439;1399;1414;15;112;2.0
5;440;1414;1429;15;112;2.0
5;441;1429;1444;15;112;2.0
5;442;1444;1459;15;112;2.0
5;443;1459;1474;15;112;2.0
5;444;1474;1489;15;112;2.0
5;445;1489;1504;15;112;2.0
5;446;1504;1519;15;112;2.0
5;447;1519;1534;15;112;2.0
5;448;1534;1549;15;112;2.0
5;449;1549;1564;15;112;2.0
5;450;1564;1579;15;112;2.0
5;451;1579;1594;15;112;2.0
5;452;1594;1609;15;112;2.0
5;453;1609;1624;15;112;2.0
5;454;1624;1639;15;112;2.0
5;455;1639;1654;15;112;2.0
5;456;1654;1669;15;112;2.0
5;457;1669;1680;11;112;2.0
6;0;245;329;84;112;2.0
6;1;329;334;5;112;2.0
6;2;334;335;1;112;2.0
6;3;335;338;3;112;2.0
6;4;338;339;1;112;2.0
6;5;339;340;1;112;2.0
6;6;340;341;1;112;2.0
6;7;341;342;1;112;2.0
6;8;342;347;5;112;2.0
6;9;347;349;2;112;2.0
6;10;349;350;1;112;2.0
6;11;350;351;1;112;2.0
6;12;351;354;3;112;2.0
6;13;354;356;2;112;2.0
6;14;356;357;1;112;2.0
6;15;357;358;1;112;2.0
6;16;358;359;1;112;2.0
6;17;359;364;5;112;2.0
6;18;364;365;1;112;2.0
6;19;365;369;4;112;2.0
6;20;369;370;1;112;2.0
6;21;370;371;1;112;2.0
6;22;371;373;2;112;2.0
6;23;373;378;5;112;2.0
6;24;378;379;1;112;2.0
6;25;379;380;1;112;2.0
6;26;380;382;2;112;2.0
6;27;382;384;2;112;2.0
6;28;384;386;2;112;2.0
6;29;386;388;2;112;2.0
6;30;388;390;2;112;2.0
6;31;390;391;1;112;2.0
6;32;391;392;1;112;2.0
6;33;392;394;2;112;2.0
6;34;394;398;4;112;2.0
6;35;398;400;2;112;2.0
6;36;400;402;2;112;2.0
6;37;402;404;2;112;2.0
6;38;404;405;1;112;2.0
6;39;405;408;3;112;2.0
6;40;408;409;1;112;2.0
6;41;409;411;2;112;2.0
6;42;411;412;1;112;2.0
6;43;412;414;2;112;2.0
6;44;414;416;2;112;2.0
6;45;416;418;2;112;2.0
6;46;418;419;1;112;2.0
6;47;419;420;1;112;2.0
6;48;420;422;2;112;2.0
6;49;422;424;2;112;2.0
6;50;424;425;1;112;2.0
6;51;425;428;3;112;2.0
6;52;428;429;1;112;2.0
6;53;429;431;2;112;2.0
6;54;431;432;1;112;2.0
6;55;432;434;2;112;2.0
6;56;434;435;1;112;2.0
6;57;435;438;3;112;2.0
6;58;438;440;2;112;2.0
6;59;440;442;2;112;2.0
6;60;442;444;2;112;2.0
6;61;444;446;2;112;2.0
6;62;446;448;2;112;2.0
6;63;448;450;2;112;2.0
6;64;450;451;1;112;2.0
6;65;451;452;1;112;2.0
6;66;452;453;1;112;2.0
6;67;453;454;1;112;2.0
6;68;454;458;4;112;2.0
6;69;458;459;1;112;2.0
6;70;459;460;1;112;2.0
6;71;460;462;2;112;2.0
6;72;462;464;2;112;2.0
6;73;464;465;1;112;2.0
6;74;465;468;3;112;2.0
6;75;468;469;1;112;2.0
6;76;469;471;2;112;2.0
6;77;471;472;1;112;2.0
6;78;472;474;2;112;2.0
6;79;474;476;2;112;2.0
6;80;476;478;2;112;2.0
6;81;478;479;1;112;2.0
6;82;479;480;1;112;2.0
6;83;480;482;2;112;2.0
6;84;482;484;2;112;2.0
6;85;484;485;1;112;2.0
6;86;485;488;3;112;2.0
6;87;488;491;3;112;2.0
6;88;491;492;1;112;2.0
6;89;492;494;2;112;2.0
6;90;494;495;1;112;2.0
6;91;495;499;4;112;2.0
6;92;499;500;1;112;2.0
6;93;500;504;4;112;2.0
6;94;504;507;3;112;2.0
6;95;507;508;1;112;2.0
6;96;508;511;3;112;2.0
6;97;511;513;2;112;2.0
6;98;513;514;1;112;2.0
6;99;514;519;5;112;2.0
6;100;519;520;1;112;2.0
6;101;520;524;4;112;2.0
6;102;524;528;4;112;2.0
6;103;528;531;3;112;2.0
6;104;531;532;1;112;2.0
6;105;532;533;1;112;2.0
6;106;533;536;3;112;2.0
6;107;536;540;4;112;2.0
6;108;540;542;2;112;2.0
6;109;542;544;2;112;2.0
6;110;544;548;4;112;2.0
6;111;548;551;3;112;2.0
6;112;551;553;2;112;2.0
6;113;553;554;1;112;2.0
6;114;554;559;5;112;2.0
6;115;559;560;1;112;2.0
6;116;560;562;2;112;2.0
6;117;562;564;2;112;2.0
6;118;564;568;4;112;2.0
6;119;568;571;3;112;2.0
6;120;571;572;1;112;2.0
6;121;572;573;1;112;2.0
6;122;573;580;7;112;2.0
6;123;580;582;2;112;2.0
6;124;582;584;2;112;2.0
6;125;584;588;4;112;2.0
6;126;588;591;3;112;2.0
6;127;591;593;2;112;2.0
6;128;593;596;3;112;2.0
6;129;596;599;3;112;2.0
6;130;599;600;1;112;2.0
6;131;600;602;2;112;2.0
6;132;602;604;2;112;2.0
6;133;604;608;4;112;2.0
6;134;608;611;3;112;2.0
6;135;611;612;1;112;2.0
6;136;612;613;1;112;2.0
6;137;613;614;1;112;2.0
6;138;614;620;6;112;2.0
6;139;620;622;2;112;2.0
6;140;622;624;2;112;2.0
6;141;624;628;4;112;2.0
6;142;628;631;3;112;2.0
6;143;631;632;1;112;2.0
6;144;632;633;1;112;2.0
6;145;633;640;7;112;2.0
6;146;640;642;2;112;2.0
6;147;642;644;2;112;2.0
6;148;644;648;4;112;2.0
6;149;648;651;3;112;2.0
6;150;651;653;2;112;2.0
6;151;653;656;3;112;2.0
6;152;656;659;3;112;2.0
6;153;659;660;1;112;2.0
6;154;660;662;2;112;2.0
6;155;662;664;2;112;2.0
6;156;664;668;4;112;2.0
6;157;668;671;3;112;2.0
6;158;671;672;1;112;2.0
6;159;672;673;1;112;2.0
6;160;673;680;7;112;2.0
6;161;680;682;2;112;2.0
6;162;682;684;2;112;2.0
6;163;684;688;4;112;2.0
6;164;688;691;3;112;2.0
6;165;691;692;1;112;2.0
6;166;692;693;1;112;2.0
6;167;693;700;7;112;2.0
6;168;700;702;2;112;2.0
6;169;702;704;2;112;2.0
6;170;704;708;4;112;2.0
6;171;708;711;3;112;2.0
6;172;711;713;2;112;2.0
6;173;713;716;3;112;2.0
6;174;716;719;3;112;2.0
6;175;719;720;1;112;2.0
6;176;720;722;2;112;2.0
6;177;722;724;2;112;2.0
6;178;724;728;4;112;2.0
6;179;728;731;3;112;2.0
6;180;731;732;1;112;2.0
6;181;732;733;1;112;2.0
6;182;733;740;7;112;2.0
6;183;740;742;2;112;2.0
6;184;742;744;2;112;2.0
6;185;744;748;4;112;2.0
6;186;748;751;3;112;2.0
6;187;751;752;1;112;2.0
6;188;752;753;1;112;2.0
6;189;753;760;7;112;2.0
6;190;760;762;2;112;2.0
6;191;762;764;2;112;2.0
6;192;764;768;4;112;2.0
6;193;768;771;3;112;2.0
6;194;771;773;2;112;2.0
6;195;773;776;3;112;2.0
6;196;776;779;3;112;2.0
6;197;779;780;1;112;2.0
6;198;780;782;2;112;2.0
6;199;782;784;2;112;2.0
6;200;784;788;4;112;2.0
6;201;788;791;3;112;2.0
6;202;791;792;1;112;2.0
6;203;792;793;1;112;2.0
6;204;793;794;1;112;2.0
6;205;794;798;4;112;2.0
6;206;798;800;2;112;2.0
6;207;800;802;2;112;2.0
6;208;802;804;2;112;2.0
6;209;804;808;4;112;2.0
6;210;808;811;3;112;2.0
6;211;811;813;2;112;2.0
6;212;813;816;3;112;2.0
6;213;816;818;2;112;2.0
6;214;818;819;1;112;2.0
6;215;819;820;1;112;2.0
6;216;820;822;2;112;2.0
6;217;822;824;2;112;2.0
6;218;824;825;1;112;2.0
6;219;825;828;3;112;2.0
6;220;828;831;3;112;2.0
6;221;831;833;2;112;2.0
6;222;833;836;3;112;2.0
6;223;836;838;2;112;2.0
6;224;838;839;1;112;2.0
6;225;839;840;1;112;2.0
6;226;840;842;2;112;2.0
6;227;842;844;2;112;2.0
6;228;844;845;1;112;2.0
6;229;845;848;3;112;2.0
6;230;848;851;3;112;2.0
6;231;851;852;1;112;2.0
6;232;852;853;1;112;2.0
6;233;853;854;1;112;2.0
6;234;854;858;4;112;2.0
6;235;858;860;2;112;2.0
6;236;860;862;2;112;2.0
6;237;862;864;2;112;2.0
6;238;864;865;1;112;2.0
6;239;865;868;3;112;2.0
6;240;868;871;3;112;2.0
6;241;871;872;1;112;2.0
6;242;872;873;1;112;2.0
6;243;873;874;1;112;2.0
6;244;874;876;2;112;2.0
6;245;876;878;2;112;2.0
6;246;878;880;2;112;2.0
6;247;880;882;2;112;2.0
6;248;882;883;1;112;2.0
6;249;883;884;1;112;2.0
6;250;884;885;1;112;2.0
6;251;885;888;3;112;2.0
6;252;888;891;3;112;2.0
6;253;891;892;1;112;2.0
6;254;892;893;1;112;2.0
6;255;893;894;1;112;2.0
6;256;894;896;2;112;2.0
6;257;896;898;2;112;2.0
6;258;898;899;1;112;2.0
6;259;899;900;1;112;2.0
6;260;900;902;2;112;2.0
6;261;902;904;2;112;2.0
6;262;904;905;1;112;2.0
6;263;905;908;3;112;2.0
6;264;908;911;3;112;2.0
6;265;911;912;1;112;2.0
6;266;912;913;1;112;2.0
6;267;913;914;1;112;2.0
6;268;914;918;4;112;2.0
6;269;918;920;2;112;2.0
6;270;920;922;2;112;2.0
6;271;922;924;2;112;2.0
6;272;924;925;1;112;2.0
6;273;925;928;3;112;2.0
6;274;928;931;3;112;2.0
6;275;931;932;1;112;2.0
6;276;932;933;1;112;2.0
6;277;933;934;1;112;2.0
6;278;934;936;2;112;2.0
6;279;936;938;2;112;2.0
6;280;938;940;2;112;2.0
6;281;940;942;2;112;2.0
6;282;942;943;1;112;2.0
6;283;943;944;1;112;2.0
6;284;944;945;1;112;2.0
6;285;945;948;3;112;2.0
6;286;948;951;3;112;2.0
6;287;951;952;1;112;2.0
6;288;952;953;1;112;2.0
6;289;953;954;1;112;2.0
6;290;954;956;2;112;2.0
6;291;956;958;2;112;2.0
6;292;958;959;1;112;2.0
6;293;959;960;1;112;2.0
6;294;960;962;2;112;2.0
6;295;962;964;2;112;2.0
6;296;964;965;1;112;2.0
6;297;965;968;3;112;2.0
6;298;968;971;3;112;2.0
6;299;971;972;1;112;2.0
6;300;972;973;1;112;2.0
6;301;973;974;1;112;2.0
6;302;974;978;4;112;2.0
6;303;978;980;2;112;2.0
6;304;980;982;2;112;2.0
6;305;982;984;2;112;2.0
6;306;984;985;1;112;2.0
6;307;985;988;3;112;2.0
6;308;988;991;3;112;2.0
6;309;991;992;1;112;2.0
6;310;992;993;1;112;2.0
6;311;993;994;1;112;2.0
6;312;994;998;4;112;2.0
6;313;998;1000;2;112;2.0
6;314;1000;1002;2;112;2.0
6;315;1002;1003;1;112;2.0
6;316;1003;1004;1;112;2.0
6;317;1004;1005;1;112;2.0
6;318;1005;1008;3;112;2.0
6;319;1008;1011;3;112;2.0
6;320;1011;1012;1;112;2.0
6;321;1012;1013;1;112;2.0
6;322;1013;1018;5;112;2.0
6;323;1018;1019;1;112;2.0
6;324;1019;1020;1;112;2.0
6;325;1020;1025;5;112;2.0
6;326;1025;1027;2;112;2.0
6;327;1027;1031;4;112;2.0
6;328;1031;1032;1;112;2.0
6;329;1032;1033;1;112;2.0
6;330;1033;1034;1;112;2.0
6;331;1034;1040;6;112;2.0
6;332;1040;1042;2;112;2.0
6;333;1042;1043;1;112;2.0
6;334;1043;1045;2;112;2.0
6;335;1045;1048;3;112;2.0
6;336;1048;1049;1;112;2.0
6;337;1049;1051;2;112;2.0
6;338;1051;1052;1;112;2.0
6;339;1052;1053;1;112;2.0
6;340;1053;1057;4;112;2.0
6;341;1057;1060;3;112;2.0
6;342;1060;1063;3;112;2.0
6;343;1063;1064;1;112;2.0
6;344;1064;1065;1;112;2.0
6;345;1065;1071;6;112;2.0
6;346;1071;1072;1;112;2.0
6;347;1072;1073;1;112;2.0
6;348;1073;1075;2;112;2.0
6;349;1075;1078;3;112;2.0
6;350;1078;1079;1;112;2.0
6;351;1079;1080;1;112;2.0
6;352;1080;1085;5;112;2.0
6;353;1085;1087;2;112;2.0
6;354;1087;1091;4;112;2.0
6;355;1091;1092;1;112;2.0
6;356;1092;1093;1;112;2.0
6;357;1093;1094;1;112;2.0
6;358;1094;1102;8;112;2.0
6;359;1102;1105;3;112;2.0
6;360;1105;1108;3;112;2.0
6;361;1108;1109;1;112;2.0
6;362;1109;1111;2;112;2.0
6;363;1111;1113;2;112;2.0
6;364;1113;1117;4;112;2.0
6;365;1117;1120;3;112;2.0
6;366;1120;1121;1;112;2.0
6;367;1121;1124;3;112;2.0
6;368;1124;1129;5;112;2.0
6;369;1129;1132;3;112;2.0
6;370;1132;1133;1;112;2.0
6;371;1133;1135;2;112;2.0
6;372;1135;1141;6;112;2.0
6;373;1141;1143;2;112;2.0
6;374;1143;1144;1;112;2.0
6;375;1144;1148;4;112;2.0
6;376;1148;1150;2;112;2.0
6;377;1150;1153;3;112;2.0
6;378;1153;1156;3;112;2.0
6;379;1156;1159;3;112;2.0
6;380;1159;1161;2;112;2.0
6;381;1161;1165;4;112;2.0
6;382;1165;1166;1;112;2.0
6;383;1166;1173;7;112;2.0
6;384;1173;1178;5;112;2.0
6;385;1178;1179;1;112;2.0
6;386;1179;1181;2;112;2.0
6;387;1181;1185;4;112;2.0
6;388;1185;1192;7;112;2.0
6;389;1192;1198;6;112;2.0
6;390;1198;1199;1;112;2.0
6;391;1199;1200;1;112;2.0
6;392;1200;1201;1;112;2.0
6;393;1201;1203;2;112;2.0
6;394;1203;1205;2;112;2.0
6;395;1205;1213;8;112;2.0
6;396;1213;1218;5;112;2.0
6;397;1218;1219;1;112;2.0
6;398;1219;1226;7;112;2.0
6;399;1226;1230;4;112;2.0
6;400;1230;1231;1;112;2.0
6;401;1231;1235;4;112;2.0
6;402;1235;1238;3;112;2.0
6;403;1238;1239;1;112;2.0
6;404;1239;1243;4;112;2.0
6;405;1243;1251;8;112;2.0
6;406;1251;1255;4;112;2.0
6;407;1255;1256;1;112;2.0
6;408;1256;1264;8;112;2.0
6;409;1264;1268;4;112;2.0
6;410;1268;1272;4;112;2.0
6;411;1272;1273;1;112;2.0
6;412;1273;1275;2;112;2.0
6;413;1275;1276;1;112;2.0
6;414;1276;1280;4;112;2.0
6;415;1280;1288;8;112;2.0
6;416;1288;1289;1;112;2.0
6;417;1289;1295;6;112;2.0
6;418;1295;1301;6;112;2.0
6;419;1301;1305;4;112;2.0
6;420;1305;1308;3;112;2.0
6;421;1308;1313;5;112;2.0
6;422;1313;1314;1;112;2.0
6;423;1314;1315;1;112;2.0
6;424;1315;1323;8;112;2.0
6;425;1323;1325;2;112;2.0
6;426;1325;1331;6;112;2.0
6;427;1331;1338;7;112;2.0
6;428;1338;1339;1;112;2.0
6;429;1339;1344;5;112;2.0
6;430;1344;1345;1;112;2.0
6;431;1345;1350;5;112;2.0
6;432;1350;1351;1;112;2.0
6;433;1351;1353;2;112;2.0
6;434;1353;1366;13;112;2.0
6;435;1366;1367;1;112;2.0
6;436;1367;1378;11;112;2.0
6;437;1378;1384;6;112;2.0
6;438;1384;1399;15;112;2.0
6;439;1399;1414;15;112;2.0
6;440;1414;1429;15;112;2.0
6;441;1429;1444;15;112;2.0
6;442;1444;1459;15;112;2.0
6;443;1459;1474;15;112;2.0
6;444;1474;1489;15;112;2.0
6;445;1489;1504;15;112;2.0
6;446;1504;1519;15;112;2.0
6;447;1519;1534;15;112;2.0
6;448;1534;1549;15;112;2.0
6;449;1549;1564;15;112;2.0
6;450;1564;1579;15;112;2.0
6;451;1579;1594;15;112;2.0
6;452;1594;1609;15;112;2.0
6;453;1609;1624;15;112;2.0
6;454;1624;1639;15;112;2.0
6;455;1639;1654;15;112;2.0
6;456;1654;1669;15;112;2.0
6;457;1669;1680;11;112;2.0
7;0;240;325;85;28;0.83
7;1;325;331;6;28;0.83
7;2;331;337;6;28;0.83
7;3;337;338;1;28;0.83
7;4;338;339;1;28;0.83
7;5;339;342;3;28;0.83
7;6;342;344;2;28;0.83
7;7;344;346;2;28;0.83
7;8;346;348;2;28;0.83
7;9;348;349;1;28;0.83
7;10;349;352;3;28;0.83
7;11;352;353;1;28;0.83
7;12;353;354;1;28;0.83
7;13;354;355;1;28;0.83
7;14;355;361;6;28;0.83
7;15;361;362;1;28;0.83
7;16;362;366;4;28;0.83
7;17;366;368;2;28;0.83
7;18;368;369;1;28;0.83
7;19;369;375;6;28;0.83
7;20;375;377;2;28;0.83
7;21;377;378;1;28;0.83
7;22;378;379;1;28;0.83
7;23;379;382;3;28;0.83
7;24;382;383;1;28;0.83
7;25;383;385;2;28;0.83
7;26;385;388;3;28;0.83
7;27;388;392;4;28;0.83
7;28;392;393;1;28;0.83
7;29;393;394;1;28;0.83
7;30;394;395;1;28;0.83
7;31;395;398;3;28;0.83
7;32;398;399;1;28;0.83
7;33;399;403;4;28;0.83
7;34;403;405;2;28;0.83
7;35;405;408;3;28;0.83
7;36;408;409;1;28;0.83
7;37;409;412;3;28;0.83
7;38;412;413;1;28;0.83
7;39;413;415;2;28;0.83
7;40;415;418;3;28;0.83
7;41;418;419;1;28;0.83
7;42;419;422;3;28;0.83
7;43;422;423;1;28;0.83
7;44;423;425;2;28;0.83
7;45;425;428;3;28;0.83
7;46;428;429;1;28;0.83
7;47;429;433;4;28;0.83
7;48;433;435;2;28;0.83
7;49;435;438;3;28;0.83
7;50;438;439;1;28;0.83
7;51;439;442;3;28;0.83
7;52;442;443;1;28;0.83
7;53;443;445;2;28;0.83
7;54;445;448;3;28;0.83
7;55;448;452;4;28;0.83
7;56;452;453;1;28;0.83
7;57;453;454;1;28;0.83
7;58;454;455;1;28;0.83
7;59;455;457;2;28;0.83
7;60;457;458;1;28;0.83
7;61;458;459;1;28;0.83
7;62;459;463;4;28;0.83
7;63;463;465;2;28;0.83
7;64;465;468;3;28;0.83
7;65;468;469;1;28;0.83
7;66;469;472;3;28;0.83
7;67;472;473;1;28;0.83
7;68;473;475;2;28;0.83
7;69;475;478;3;28;0.83
7;70;478;479;1;28;0.83
7;71;479;482;3;28;0.83
7;72;482;483;1;28;0.83
7;73;483;485;2;28;0.83
7;74;485;488;3;28;0.83
7;75;488;489;1;28;0.83
7;76;489;492;3;28;0.83
7;77;492;493;1;28;0.83
7;78;493;495;2;28;0.83
7;79;495;499;4;28;0.83
7;80;499;503;4;28;0.83
7;81;503;505;2;28;0.83
7;82;505;508;3;28;0.83
7;83;508;512;4;28;0.83
7;84;512;513;1;28;0.83
7;85;513;515;2;28;0.83
7;86;515;517;2;28;0.83
7;87;517;519;2;28;0.83
7;88;519;520;1;28;0.83
7;89;520;523;3;28;0.83
7;90;523;525;2;28;0.83
7;91;525;528;3;28;0.83
7;92;528;529;1;28;0.83
7;93;529;532;3;28;0.83
7;94;532;537;5;28;0.83
7;95;537;538;1;28;0.83
7;96;538;539;1;28;0.83
7;97;539;543;4;28;0.83
7;98;543;545;2;28;0.83
7;99;545;548;3;28;0.83
7;100;548;555;7;28;0.83
7;101;555;557;2;28;0.83
7;102;557;558;1;28;0.83
7;103;558;559;1;28;0.83
7;104;559;563;4;28;0.83
7;105;563;565;2;28;0.83
7;106;565;568;3;28;0.83
7;107;568;569;1;28;0.83
7;108;569;572;3;28;0.83
7;109;572;577;5;28;0.83
7;110;577;578;1;28;0.83
7;111;578;579;1;28;0.83
7;112;579;583;4;28;0.83
7;113;583;585;2;28;0.83
7;114;585;588;3;28;0.83
7;115;588;592;4;28;0.83
7;116;592;595;3;28;0.83
7;117;595;597;2;28;0.83
7;118;597;598;1;28;0.83
7;119;598;599;1;28;0.83
7;120;599;603;4;28;0.83
7;121;603;605;2;28;0.83
7;122;605;608;3;28;0.83
7;123;608;609;1;28;0.83
7;124;609;617;8;28;0.83
7;125;617;618;1;28;0.83
7;126;618;619;1;28;0.83
7;127;619;623;4;28;0.83
7;128;623;625;2;28;0.83
7;129;625;628;3;28;0.83
7;130;628;629;1;28;0.83
7;131;629;632;3;28;0.83
7;132;632;637;5;28;0.83
7;133;637;638;1;28;0.83
7;134;638;639;1;28;0.83
7;135;639;643;4;28;0.83
7;136;643;645;2;28;0.83
7;137;645;648;3;28;0.83
7;138;648;652;4;28;0.83
7;139;652;655;3;28;0.83
7;140;655;657;2;28;0.83
7;141;657;658;1;28;0.83
7;142;658;659;1;28;0.83
7;143;659;663;4;28;0.83
7;144;663;665;2;28;0.83
7;145;665;668;3;28;0.83
7;146;668;669;1;28;0.83
7;147;669;677;8;28;0.83
7;148;677;678;1;28;0.83
7;149;678;679;1;28;0.83
7;150;679;683;4;28;0.83
7;151;683;685;2;28;0.83
7;152;685;688;3;28;0.83
7;153;688;689;1;28;0.83
7;154;689;692;3;28;0.83
7;155;692;697;5;28;0.83
7;156;697;698;1;28;0.83
7;157;698;699;1;28;0.83
7;158;699;703;4;28;0.83
7;159;703;705;2;28;0.83
7;160;705;708;3;28;0.83
7;161;708;712;4;28;0.83
7;162;712;715;3;28;0.83
7;163;715;717;2;28;0.83
7;164;717;718;1;28;0.83
7;165;718;719;1;28;0.83
7;166;719;723;4;28;0.83
7;167;723;725;2;28;0.83
7;168;725;728;3;28;0.83
7;169;728;729;1;28;0.83
7;170;729;737;8;28;0.83
7;171;737;738;1;28;0.83
7;172;738;739;1;28;0.83
7;173;739;743;4;28;0.83
7;174;743;745;2;28;0.83
7;175;745;748;3;28;0.83
7;176;748;749;1;28;0.83
7;177;749;752;3;28;0.83
7;178;752;757;5;28;0.83
7;179;757;758;1;28;0.83
7;180;758;759;1;28;0.83
7;181;759;763;4;28;0.83
7;182;763;765;2;28;0.83
7;183;765;768;3;28;0.83
7;184;768;772;4;28;0.83
7;185;772;775;3;28;0.83
7;186;775;777;2;28;0.83
7;187;777;778;1;28;0.83
7;188;778;779;1;28;0.83
7;189;779;783;4;28;0.83
7;190;783;785;2;28;0.83
7;191;785;788;3;28;0.83
7;192;788;789;1;28;0.83
7;193;789;795;6;28;0.83
7;194;795;797;2;28;0.83
7;195;797;798;1;28;0.83
7;196;798;799;1;28;0.83
7;197;799;803;4;28;0.83
7;198;803;805;2;28;0.83
7;199;805;808;3;28;0.83
7;200;808;812;4;28;0.83
7;201;812;815;3;28;0.83
7;202;815;817;2;28;0.83
7;203;817;818;1;28;0.83
7;204;818;819;1;28;0.83
7;205;819;823;4;28;0.83
7;206;823;825;2;28;0.83
7;207;825;828;3;28;0.83
7;208;828;829;1;28;0.83
7;209;829;832;3;28;0.83
7;210;832;835;3;28;0.83
7;211;835;837;2;28;0.83
7;212;837;838;1;28;0.83
7;213;838;839;1;28;0.83
7;214;839;843;4;28;0.83
7;215;843;845;2;28;0.83
7;216;845;847;2;28;0.83
7;217;847;848;1;28;0.83
7;218;848;849;1;28;0.83
7;219;849;855;6;28;0.83
7;220;855;857;2;28;0.83
7;221;857;858;1;28;0.83
7;222;858;859;1;28;0.83
7;223;859;863;4;28;0.83
7;224;863;865;2;28;0.83
7;225;865;868;3;28;0.83
7;226;868;869;1;28;0.83
7;227;869;872;3;28;0.83
7;228;872;873;1;28;0.83
7;229;873;875;2;28;0.83
7;230;875;877;2;28;0.83
7;231;877;878;1;28;0.83
7;232;878;879;1;28;0.83
7;233;879;883;4;28;0.83
7;234;883;885;2;28;0.83
7;235;885;887;2;28;0.83
7;236;887;888;1;28;0.83
7;237;888;889;1;28;0.83
7;238;889;892;3;28;0.83
7;239;892;893;1;28;0.83
7;240;893;895;2;28;0.83
7;241;895;897;2;28;0.83
7;242;897;898;1;28;0.83
7;243;898;899;1;28;0.83
7;244;899;903;4;28;0.83
7;245;903;905;2;28;0.83
7;246;905;907;2;28;0.83
7;247;907;908;1;28;0.83
7;248;908;909;1;28;0.83
7;249;909;912;3;28;0.83
7;250;912;913;1;28;0.83
7;251;913;915;2;28;0.83
7;252;915;917;2;28;0.83
7;253;917;918;1;28;0.83
7;254;918;919;1;28;0.83
7;255;919;923;4;28;0.83
7;256;923;925;2;28;0.83
7;257;925;928;3;28;0.83
7;258;928;929;1;28;0.83
7;259;929;932;3;28;0.83
7;260;932;933;1;28;0.83
7;261;933;935;2;28;0.83
7;262;935;937;2;28;0.83
7;263;937;938;1;28;0.83
7;264;938;939;1;28;0.83
7;265;939;943;4;28;0.83
7;266;943;945;2;28;0.83
7;267;945;947;2;28;0.83
7;268;947;948;1;28;0.83
7;269;948;949;1;28;0.83
7;270;949;952;3;28;0.83
7;271;952;953;1;28;0.83
7;272;953;955;2;28;0.83
7;273;955;957;2;28;0.83
7;274;957;958;1;28;0.83
7;275;958;959;1;28;0.83
7;276;959;963;4;28;0.83
7;277;963;965;2;28;0.83
7;278;965;967;2;28;0.83
7;279;967;968;1;28;0.83
7;280;968;969;1;28;0.83
7;281;969;972;3;28;0.83
7;282;972;973;1;28;0.83
7;283;973;975;2;28;0.83
7;284;975;977;2;28;0.83
7;285;977;978;1;28;0.83
7;286;978;979;1;28;0.83
7;287;979;983;4;28;0.83
7;288;983;985;2;28;0.83
7;289;985;988;3;28;0.83
7;290;988;989;1;28;0.83
7;291;989;993;4;28;0.83
7;292;993;995;2;28;0.83
7;293;995;997;2;28;0.83
7;294;997;998;1;28;0.83
7;295;998;999;1;28;0.83
7;296;999;1003;4;28;0.83
7;297;1003;1005;2;28;0.83
7;298;1005;1007;2;28;0.83
7;299;1007;1008;1;28;0.83
7;300;1008;1009;1;28;0.83
7;301;1009;1015;6;28;0.83
7;302;1015;1017;2;28;0.83
7;303;1017;1018;1;28;0.83
7;304;1018;1019;1;28;0.83
7;305;1019;1023;4;28;0.83
7;306;1023;1027;4;28;0.83
7;307;1027;1028;1;28;0.83
7;308;1028;1029;1;28;0.83
7;309;1029;1030;1;28;0.83
7;310;1030;1033;3;28;0.83
7;311;1033;1037;4;28;0.83
7;312;1037;1038;1;28;0.83
7;313;1038;1039;1;28;0.83
7;314;1039;1045;6;28;0.83
7;315;1045;1047;2;28;0.83
7;316;1047;1048;1;28;0.83
7;317;1048;1049;1;28;0.83
7;318;1049;1053;4;28;0.83
7;319;1053;1057;4;28;0.83
7;320;1057;1059;2;28;0.83
7;321;1059;1060;1;28;0.83
7;322;1060;1063;3;28;0.83
7;323;1063;1067;4;28;0.83
7;324;1067;1068;1;28;0.83
7;325;1068;1069;1;28;0.83
7;326;1069;1071;2;28;0.83
7;327;1071;1075;4;28;0.83
7;328;1075;1077;2;28;0.83
7;329;1077;1078;1;28;0.83
7;330;1078;1079;1;28;0.83
7;331;1079;1083;4;28;0.83
7;332;1083;1088;5;28;0.83
7;333;1088;1089;1;28;0.83
7;334;1089;1090;1;28;0.83
7;335;1090;1093;3;28;0.83
7;336;1093;1097;4;28;0.83
7;337;1097;1098;1;28;0.83
7;338;1098;1105;7;28;0.83
7;339;1105;1107;2;28;0.83
7;340;1107;1108;1;28;0.83
7;341;1108;1109;1;28;0.83
7;342;1109;1110;1;28;0.83
7;343;1110;1112;2;28;0.83
7;344;1112;1113;1;28;0.83
7;345;1113;1117;4;28;0.83
7;346;1117;1120;3;28;0.83
7;347;1120;1125;5;28;0.83
7;348;1125;1128;3;28;0.83
7;349;1128;1132;4;28;0.83
7;350;1132;1137;5;28;0.83
7;351;1137;1139;2;28;0.83
7;352;1139;1140;1;28;0.83
7;353;1140;1145;5;28;0.83
7;354;1145;1147;2;28;0.83
7;355;1147;1152;5;28;0.83
7;356;1152;1153;1;28;0.83
7;357;1153;1155;2;28;0.83
7;358;1155;1157;2;28;0.83
7;359;1157;1160;3;28;0.83
7;360;1160;1162;2;28;0.83
7;361;1162;1170;8;28;0.83
7;362;1170;1175;5;28;0.83
7;363;1175;1177;2;28;0.83
7;364;1177;1178;1;28;0.83
7;365;1178;1180;2;28;0.83
7;366;1180;1182;2;28;0.83
7;367;1182;1188;6;28;0.83
7;368;1188;1195;7;28;0.83
7;369;1195;1197;2;28;0.83
7;370;1197;1200;3;28;0.83
7;371;1200;1202;2;28;0.83
7;372;1202;1209;7;28;0.83
7;373;1209;1215;6;28;0.83
7;374;1215;1222;7;28;0.83
7;375;1222;1225;3;28;0.83
7;376;1225;1227;2;28;0.83
7;377;1227;1228;1;28;0.83
7;378;1228;1230;2;28;0.83
7;379;1230;1232;2;28;0.83
7;380;1232;1235;3;28;0.83
7;381;1235;1237;2;28;0.83
7;382;1237;1247;10;28;0.83
7;383;1247;1250;3;28;0.83
7;384;1250;1252;2;28;0.83
7;385;1252;1253;1;28;0.83
7;386;1253;1260;7;28;0.83
7;387;1260;1268;8;28;0.83
7;388;1268;1272;4;28;0.83
7;389;1272;1275;3;28;0.83
7;390;1275;1277;2;28;0.83
7;391;1277;1284;7;28;0.83
7;392;1284;1285;1;28;0.83
7;393;1285;1299;14;28;0.83
7;394;1299;1300;1;28;0.83
7;395;1300;1302;2;28;0.83
7;396;1302;1305;3;28;0.83
7;397;1305;1307;2;28;0.83
7;398;1307;1309;2;28;0.83
7;399;1309;1310;1;28;0.83
7;400;1310;1312;2;28;0.83
7;401;1312;1322;10;28;0.83
7;402;1322;1327;5;28;0.83
7;403;1327;1330;3;28;0.83
7;404;1330;1334;4;28;0.83
7;405;1334;1335;1;28;0.83
7;406;1335;1342;7;28;0.83
7;407;1342;1347;5;28;0.83
7;408;1347;1350;3;28;0.83
7;409;1350;1357;7;28;0.83
7;410;1357;1363;6;28;0.83
7;411;1363;1365;2;28;0.83
7;412;1365;1380;15;28;0.83
7;413;1380;1382;2;28;0.83
7;414;1382;1397;15;28;0.83
7;415;1397;1412;15;28;0.83
7;416;1412;1427;15;28;0.83
7;417;1427;1442;15;28;0.83
7;418;1442;1457;15;28;0.83
7;419;1457;1472;15;28;0.83
7;420;1472;1487;15;28;0.83
7;421;1487;1502;15;28;0.83
7;422;1502;1517;15;28;0.83
7;423;1517;1532;15;28;0.83
7;424;1532;1547;15;28;0.83
7;425;1547;1562;15;28;0.83
7;426;1562;1577;15;28;0.83
7;427;1577;1592;15;28;0.83
7;428;1592;1607;15;28;0.83
7;429;1607;1622;15;28;0.83
7;430;1622;1637;15;28;0.83
7;431;1637;1652;15;28;0.83
7;432;1652;1667;15;28;0.83
7;433;1667;1680;13;28;0.83
8;0;240;325;85;28;0.83
8;1;325;331;6;28;0.83
8;2;331;337;6;28;0.83
8;3;337;338;1;28;0.83
8;4;338;339;1;28;0.83
8;5;339;342;3;28;0.83
8;6;342;344;2;28;0.83
8;7;344;346;2;28;0.83
8;8;346;348;2;28;0.83
8;9;348;349;1;28;0.83
8;10;349;352;3;28;0.83
8;11;352;353;1;28;0.83
8;12;353;354;1;28;0.83
8;13;354;355;1;28;0.83
8;14;355;361;6;28;0.83
8;15;361;362;1;28;0.83
8;16;362;366;4;28;0.83
8;17;366;368;2;28;0.83
8;18;368;369;1;28;0.83
8;19;369;375;6;28;0.83
8;20;375;377;2;28;0.83
8;21;377;378;1;28;0.83
8;22;378;379;1;28;0.83
8;23;379;382;3;28;0.83
8;24;382;383;1;28;0.83
8;25;383;385;2;28;0.83
8;26;385;388;3;28;0.83
8;27;388;392;4;28;0.83
8;28;392;393;1;28;0.83
8;29;393;394;1;28;0.83
8;30;394;395;1;28;0.83
8;31;395;398;3;28;0.83
8;32;398;399;1;28;0.83
8;33;399;403;4;28;0.83
8;34;403;405;2;28;0.83
8;35;405;408;3;28;0.83
8;36;408;409;1;28;0.83
8;37;409;412;3;28;0.83
8;38;412;413;1;28;0.83
8;39;413;415;2;28;0.83
8;40;415;418;3;28;0.83
8;41;418;419;1;28;0.83
8;42;419;422;3;28;0.83
8;43;422;423;1;28;0.83
8;44;423;425;2;28;0.83
8;45;425;428;3;28;0.83
8;46;428;429;1;28;0.83
8;47;429;433;4;28;0.83
8;48;433;435;2;28;0.83
8;49;435;438;3;28;0.83
8;50;438;439;1;28;0.83
8;51;439;442;3;28;0.83
8;52;442;443;1;28;0.83
8;53;443;445;2;28;0.83
8;54;445;448;3;28;0.83
8;55;448;452;4;28;0.83
8;56;452;453;1;28;0.83
8;57;453;454;1;28;0.83
8;58;454;455;1;28;0.83
8;59;455;457;2;28;0.83
8;60;457;458;1;28;0.83
8;61;458;459;1;28;0.83
8;62;459;463;4;28;0.83
8;63;463;465;2;28;0.83
8;64;465;468;3;28;0.83
8;65;468;469;1;28;0.83
8;66;469;472;3;28;0.83
8;67;472;473;1;28;0.83
8;68;473;475;2;28;0.83
8;69;475;478;3;28;0.83
8;70;478;479;1;28;0.83
8;71;479;482;3;28;0.83
8;72;482;483;1;28;0.83
8;73;483;485;2;28;0.83
8;74;485;488;3;28;0.83
8;75;488;489;1;28;0.83
8;76;489;492;3;28;0.83
8;77;492;493;1;28;0.83
8;78;493;495;2;28;0.83
8;79;495;499;4;28;0.83
8;80;499;503;4;28;0.83
8;81;503;505;2;28;0.83
8;82;505;508;3;28;0.83
8;83;508;512;4;28;0.83
8;84;512;513;1;28;0.83
8;85;513;515;2;28;0.83
8;86;515;517;2;28;0.83
8;87;517;519;2;28;0.83
8;88;519;520;1;28;0.83
8;89;520;523;3;28;0.83
8;90;523;525;2;28;0.83
8;91;525;528;3;28;0.83
8;92;528;529;1;28;0.83
8;93;529;532;3;28;0.83
8;94;532;537;5;28;0.83
8;95;537;538;1;28;0.83
8;96;538;539;1;28;0.83
8;97;539;543;4;28;0.83
8;98;543;545;2;28;0.83
8;99;545;548;3;28;0.83
8;100;548;555;7;28;0.83
8;101;555;557;2;28;0.83
8;102;557;558;1;28;0.83
8;103;558;559;1;28;0.83
8;104;559;563;4;28;0.83
8;105;563;565;2;28;0.83
8;106;565;568;3;28;0.83
8;107;568;569;1;28;0.83
8;108;569;572;3;28;0.83
8;109;572;577;5;28;0.83
8;110;577;578;1;28;0.83
8;111;578;579;1;28;0.83
8;112;579;583;4;28;0.83
8;113;583;585;2;28;0.83
8;114;585;588;3;28;0.83
8;115;588;592;4;28;0.83
8;116;592;595;3;28;0.83
8;117;595;597;2;28;0.83
8;118;597;598;1;28;0.83
8;119;598;599;1;28;0.83
8;120;599;603;4;28;0.83
8;121;603;605;2;28;0.83
8;122;605;608;3;28;0.83
8;123;608;609;1;28;0.83
8;124;609;617;8;28;0.83
8;125;617;618;1;28;0.83
8;126;618;619;1;28;0.83
8;127;619;623;4;28;0.83
8;128;623;625;2;28;0.83
8;129;625;628;3;28;0.83
8;130;628;629;1;28;0.83
8;131;629;632;3;28;0.83
8;132;632;637;5;28;0.83
8;133;637;638;1;28;0.83
8;134;638;639;1;28;0.83
8;135;639;643;4;28;0.83
8;136;643;645;2;28;0.83
8;137;645;648;3;28;0.83
8;138;648;652;4;28;0.83
8;139;652;655;3;28;0.83
8;140;655;657;2;28;0.83
8;141;657;658;1;28;0.83
8;142;658;659;1;28;0.83
8;143;659;663;4;28;0.83
8;144;663;665;2;28;0.83
8;145;665;668;3;28;0.83
8;146;668;669;1;28;0.83
8;147;669;677;8;28;0.83
8;148;677;678;1;28;0.83
8;149;678;679;1;28;0.83
8;150;679;683;4;28;0.83
8;151;683;685;2;28;0.83
8;152;685;688;3;28;0.83
8;153;688;689;1;28;0.83
8;154;689;692;3;28;0.83
8;155;692;697;5;28;0.83
8;156;697;698;1;28;0.83
8;157;698;699;1;28;0.83
8;158;699;703;4;28;0.83
8;159;703;705;2;28;0.83
8;160;705;708;3;28;0.83
8;161;708;712;4;28;0.83
8;162;712;715;3;28;0.83
8;163;715;717;2;28;0.83
8;164;717;718;1;28;0.83
8;165;718;719;1;28;0.83
8;166;719;723;4;28;0.83
8;167;723;725;2;28;0.83
8;168;725;728;3;28;0.83
8;169;728;729;1;28;0.83
8;170;729;737;8;28;0.83
8;171;737;738;1;28;0.83
8;172;738;739;1;28;0.83
8;173;739;743;4;28;0.83
8;174;743;745;2;28;0.83
8;175;745;748;3;28;0.83
8;176;748;749;1;28;0.83
8;177;749;752;3;28;0.83
8;178;752;757;5;28;0.83
8;179;757;758;1;28;0.83
8;180;758;759;1;28;0.83
8;181;759;763;4;28;0.83
8;182;763;765;2;28;0.83
8;183;765;768;3;28;0.83
8;184;768;772;4;28;0.83
8;185;772;775;3;28;0.83
8;186;775;777;2;28;0.83
8;187;777;778;1;28;0.83
8;188;778;779;1;28;0.83
8;189;779;783;4;28;0.83
8;190;783;785;2;28;0.83
8;191;785;788;3;28;0.83
8;192;788;789;1;28;0.83
8;193;789;795;6;28;0.83
8;194;795;797;2;28;0.83
8;195;797;798;1;28;0.83
8;196;798;799;1;28;0.83
8;197;799;803;4;28;0.83
8;198;803;805;2;28;0.83
8;199;805;808;3;28;0.83
8;200;808;812;4;28;0.83
8;201;812;815;3;28;0.83
8;202;815;817;2;28;0.83
8;203;817;818;1;28;0.83
8;204;818;819;1;28;0.83
8;205;819;823;4;28;0.83
8;206;823;825;2;28;0.83
8;207;825;828;3;28;0.83
8;208;828;829;1;28;0.83
8;209;829;832;3;28;0.83
8;210;832;835;3;28;0.83
8;211;835;837;2;28;0.83
8;212;837;838;1;28;0.83
8;213;838;839;1;28;0.83
8;214;839;843;4;28;0.83
8;215;843;845;2;28;0.83
8;216;845;847;2;28;0.83
8;217;847;848;1;28;0.83
8;218;848;849;1;28;0.83
8;219;849;855;6;28;0.83
8;220;855;857;2;28;0.83
8;221;857;858;1;28;0.83
8;222;858;859;1;28;0.83
8;223;859;863;4;28;0.83
8;224;863;865;2;28;0.83
8;225;865;868;3;28;0.83
8;226;868;869;1;28;0.83
8;227;869;872;3;28;0.83
8;228;872;873;1;28;0.83
8;229;873;875;2;28;0.83
8;230;875;877;2;28;0.83
8;231;877;878;1;28;0.83
8;232;878;879;1;28;0.83
8;233;879;883;4;28;0.83
8;234;883;885;2;28;0.83
8;235;885;887;2;28;0.83
8;236;887;888;1;28;0.83
8;237;888;889;1;28;0.83
8;238;889;892;3;28;0.83
8;239;892;893;1;28;0.83
8;240;893;895;2;28;0.83
8;241;895;897;2;28;0.83
8;242;897;898;1;28;0.83
8;243;898;899;1;28;0.83
8;244;899;903;4;28;0.83
8;245;903;905;2;28;0.83
8;246;905;907;2;28;0.83
8;247;907;908;1;28;0.83
8;248;908;909;1;28;0.83
8;249;909;912;3;28;0.83
8;250;912;913;1;28;0.83
8;251;913;915;2;28;0.83
8;252;915;917;2;28;0.83
8;253;917;918;1;28;0.83
8;254;918;919;1;28;0.83
8;255;919;923;4;28;0.83
8;256;923;925;2;28;0.83
8;257;925;928;3;28;0.83
8;258;928;929;1;28;0.83
8;259;929;932;3;28;0.83
8;260;932;933;1;28;0.83
8;261;933;935;2;28;0.83
8;262;935;937;2;28;0.83
8;263;937;938;1;28;0.83
8;264;938;939;1;28;0.83
8;265;939;943;4;28;0.83
8;266;943;945;2;28;0.83
8;267;945;947;2;28;0.83
8;268;947;948;1;28;0.83
8;269;948;949;1;28;0.83
8;270;949;952;3;28;0.83
8;271;952;953;1;28;0.83
8;272;953;955;2;28;0.83
8;273;955;957;2;28;0.83
8;274;957;958;1;28;0.83
8;275;958;959;1;28;0.83
8;276;959;963;4;28;0.83
8;277;963;965;2;28;0.83
8;278;965;967;2;28;0.83
8;279;967;968;1;28;0.83
8;280;968;969;1;28;0.83
8;281;969;972;3;28;0.83
8;282;972;973;1;28;0.83
8;283;973;975;2;28;0.83
8;284;975;977;2;28;0.83
8;285;977;978;1;28;0.83
8;286;978;979;1;28;0.83
8;287;979;983;4;28;0.83
8;288;983;985;2;28;0.83
8;289;985;988;3;28;0.83
8;290;988;989;1;28;0.83
8;291;989;993;4;28;0.83
8;292;993;995;2;28;0.83
8;293;995;997;2;28;0.83
8;294;997;998;1;28;0.83
8;295;998;999;1;28;0.83
8;296;999;1003;4;28;0.83
8;297;1003;1005;2;28;0.83
8;298;1005;1007;2;28;0.83
8;299;1007;1008;1;28;0.83
8;300;1008;1009;1;28;0.83
8;301;1009;1015;6;28;0.83
8;302;1015;1017;2;28;0.83
8;303;1017;1018;1;28;0.83
8;304;1018;1019;1;28;0.83
8;305;1019;1023;4;28;0.83
8;306;1023;1027;4;28;0.83
8;307;1027;1028;1;28;0.83
8;308;1028;1029;1;28;0.83
8;309;1029;1030;1;28;0.83
8;310;1030;1033;3;28;0.83
8;311;1033;1037;4;28;0.83
8;312;1037;1038;1;28;0.83
8;313;1038;1039;1;28;0.83
8;314;1039;1045;6;28;0.83
8;315;1045;1047;2;28;0.83
8;316;1047;1048;1;28;0.83
8;317;1048;1049;1;28;0.83
8;318;1049;1053;4;28;0.83
8;319;1053;1057;4;28;0.83
8;320;1057;1059;2;28;0.83
8;321;1059;1060;1;28;0.83
8;322;1060;1063;3;28;0.83
8;323;1063;1067;4;28;0.83
8;324;1067;1068;1;28;0.83
8;325;1068;1069;1;28;0.83
8;326;1069;1071;2;28;0.83
8;327;1071;1075;4;28;0.83
8;328;1075;1077;2;28;0.83
8;329;1077;1078;1;28;0.83
8;330;1078;1079;1;28;0.83
8;331;1079;1083;4;28;0.83
8;332;1083;1088;5;28;0.83
8;333;1088;1089;1;28;0.83
8;334;1089;1090;1;28;0.83
8;335;1090;1093;3;28;0.83
8;336;1093;1097;4;28;0.83
8;337;1097;1098;1;28;0.83
8;338;1098;1105;7;28;0.83
8;339;1105;1107;2;28;0.83
8;340;1107;1108;1;28;0.83
8;341;1108;1109;1;28;0.83
8;342;1109;1110;1;28;0.83
8;343;1110;1112;2;28;0.83
8;344;1112;1113;1;28;0.83
8;345;1113;1117;4;28;0.83
8;346;1117;1120;3;28;0.83
8;347;1120;1125;5;28;0.83
8;348;1125;1128;3;28;0.83
8;349;1128;1132;4;28;0.83
8;350;1132;1137;5;28;0.83
8;351;1137;1139;2;28;0.83
8;352;1139;1140;1;28;0.83
8;353;1140;1145;5;28;0.83
8;354;1145;1147;2;28;0.83
8;355;1147;1152;5;28;0.83
8;356;1152;1153;1;28;0.83
8;357;1153;1155;2;28;0.83
8;358;1155;1157;2;28;0.83
8;359;1157;1160;3;28;0.83
8;360;1160;1162;2;28;0.83
8;361;1162;1170;8;28;0.83
8;362;1170;1175;5;28;0.83
8;363;1175;1177;2;28;0.83
8;364;1177;1178;1;28;0.83
8;365;1178;1180;2;28;0.83
8;366;1180;1182;2;28;0.83
8;367;1182;1188;6;28;0.83
8;368;1188;1195;7;28;0.83
8;369;1195;1197;2;28;0.83
8;370;1197;1200;3;28;0.83
8;371;1200;1202;2;28;0.83
8;372;1202;1209;7;28;0.83
8;373;1209;1215;6;28;0.83
8;374;1215;1222;7;28;0.83
8;375;1222;1225;3;28;0.83
8;376;1225;1227;2;28;0.83
8;377;1227;1228;1;28;0.83
8;378;1228;1230;2;28;0.83
8;379;1230;1232;2;28;0.83
8;380;1232;1235;3;28;0.83
8;381;1235;1237;2;28;0.83
8;382;1237;1247;10;28;0.83
8;383;1247;1250;3;28;0.83
8;384;1250;1252;2;28;0.83
8;385;1252;1253;1;28;0.83
8;386;1253;1260;7;28;0.83
8;387;1260;1268;8;28;0.83
8;388;1268;1272;4;28;0.83
8;389;1272;1275;3;28;0.83
8;390;1275;1277;2;28;0.83
8;391;1277;1284;7;28;0.83
8;392;1284;1285;1;28;0.83
8;393;1285;1299;14;28;0.83
8;394;1299;1300;1;28;0.83
8;395;1300;1302;2;28;0.83
8;396;1302;1305;3;28;0.83
8;397;1305;1307;2;28;0.83
8;398;1307;1309;2;28;0.83
8;399;1309;1310;1;28;0.83
8;400;1310;1312;2;28;0.83
8;401;1312;1322;10;28;0.83
8;402;1322;1327;5;28;0.83
8;403;1327;1330;3;28;0.83
8;404;1330;1334;4;28;0.83
8;405;1334;1335;1;28;0.83
8;406;1335;1342;7;28;0.83
8;407;1342;1347;5;28;0.83
8;408;1347;1350;3;28;0.83
8;409;1350;1357;7;28;0.83
8;410;1357;1363;6;28;0.83
8;411;1363;1365;2;28;0.83
8;412;1365;1380;15;28;0.83
8;413;1380;1382;2;28;0.83
8;414;1382;1397;15;28;0.83
8;415;1397;1412;15;28;0.83
8;416;1412;1427;15;28;0.83
8;417;1427;1442;15;28;0.83
8;418;1442;1457;15;28;0.83
8;419;1457;1472;15;28;0.83
8;420;1472;1487;15;28;0.83
8;421;1487;1502;15;28;0.83
8;422;1502;1517;15;28;0.83
8;423;1517;1532;15;28;0.83
8;424;1532;1547;15;28;0.83
8;425;1547;1562;15;28;0.83
8;426;1562;1577;15;28;0.83
8;427;1577;1592;15;28;0.83
8;428;1592;1607;15;28;0.83
8;429;1607;1622;15;28;0.83
8;430;1622;1637;15;28;0.83
8;431;1637;1652;15;28;0.83
8;432;1652;1667;15;28;0.83
8;433;1667;1680;13;28;0.83
9;0;240;325;85;28;0.83
9;1;325;331;6;28;0.83
9;2;331;337;6;28;0.83
9;3;337;338;1;28;0.83
9;4;338;339;1;28;0.83
9;5;339;342;3;28;0.83
9;6;342;344;2;28;0.83
9;7;344;346;2;28;0.83
9;8;346;348;2;28;0.83
9;9;348;349;1;28;0.83
9;10;349;352;3;28;0.83
9;11;352;353;1;28;0.83
9;12;353;354;1;28;0.83
9;13;354;355;1;28;0.83
9;14;355;361;6;28;0.83
9;15;361;362;1;28;0.83
9;16;362;366;4;28;0.83
9;17;366;368;2;28;0.83
9;18;368;369;1;28;0.83
9;19;369;375;6;28;0.83
9;20;375;377;2;28;0.83
9;21;377;378;1;28;0.83
9;22;378;379;1;28;0.83
9;23;379;382;3;28;0.83
9;24;382;383;1;28;0.83
9;25;383;385;2;28;0.83
9;26;385;388;3;28;0.83
9;27;388;392;4;28;0.83
9;28;392;393;1;28;0.83
9;29;393;394;1;28;0.83
9;30;394;395;1;28;0.83
9;31;395;398;3;28;0.83
9;32;398;399;1;28;0.83
9;33;399;403;4;28;0.83
9;34;403;405;2;28;0.83
9;35;405;408;3;28;0.83
9;36;408;409;1;28;0.83
9;37;409;412;3;28;0.83
9;38;412;413;1;28;0.83
9;39;413;415;2;28;0.83
9;40;415;418;3;28;0.83
9;41;418;419;1;28;0.83
9;42;419;422;3;28;0.83
9;43;422;423;1;28;0.83
9;44;423;425;2;28;0.83
9;45;425;428;3;28;0.83
9;46;428;429;1;28;0.83
9;47;429;433;4;28;0.83
9;48;433;435;2;28;0.83
9;49;435;438;3;28;0.83
9;50;438;439;1;28;0.83
9;51;439;442;3;28;0.83
9;52;442;443;1;28;0.83
9;53;443;445;2;28;0.83
9;54;445;448;3;28;0.83
9;55;448;452;4;28;0.83
9;56;452;453;1;28;0.83
9;57;453;454;1;28;0.83
9;58;454;455;1;28;0.83
9;59;455;457;2;28;0.83
9;60;457;458;1;28;0.83
9;61;458;459;1;28;0.83
9;62;459;463;4;28;0.83
9;63;463;465;2;28;0.83
9;64;465;468;3;28;0.83
9;65;468;469;1;28;0.83
9;66;469;472;3;28;0.83
9;67;472;473;1;28;0.83
9;68;473;475;2;28;0.83
9;69;475;478;3;28;0.83
9;70;478;479;1;28;0.83
9;71;479;482;3;28;0.83
9;72;482;483;1;28;0.83
9;73;483;485;2;28;0.83
9;74;485;488;3;28;0.83
9;75;488;489;1;28;0.83
9;76;489;492;3;28;0.83
9;77;492;493;1;28;0.83
9;78;493;495;2;28;0.83
9;79;495;499;4;28;0.83
9;80;499;503;4;28;0.83
9;81;503;505;2;28;0.83
9;82;505;508;3;28;0.83
9;83;508;512;4;28;0.83
9;84;512;513;1;28;0.83
9;85;513;515;2;28;0.83
9;86;515;517;2;28;0.83
9;87;517;519;2;28;0.83
9;88;519;520;1;28;0.83
9;89;520;523;3;28;0.83
9;90;523;525;2;28;0.83
9;91;525;528;3;28;0.83
9;92;528;529;1;28;0.83
9;93;529;532;3;28;0.83
9;94;532;537;5;28;0.83
9;95;537;538;1;28;0.83
9;96;538;539;1;28;0.83
9;97;539;543;4;28;0.83
9;98;543;545;2;28;0.83
9;99;545;548;3;28;0.83
9;100;548;555;7;28;0.83
9;101;555;557;2;28;0.83
9;102;557;558;1;28;0.83
9;103;558;559;1;28;0.83
9;104;559;563;4;28;0.83
9;105;563;565;2;28;0.83
9;106;565;568;3;28;0.83
9;107;568;569;1;28;0.83
9;108;569;572;3;28;0.83
9;109;572;577;5;28;0.83
9;110;577;578;1;28;0.83
9;111;578;579;1;28;0.83
9;112;579;583;4;28;0.83
9;113;583;585;2;28;0.83
9;114;585;588;3;28;0.83
9;115;588;592;4;28;0.83
9;116;592;595;3;28;0.83
9;117;595;597;2;28;0.83
9;118;597;598;1;28;0.83
9;119;598;599;1;28;0.83
9;120;599;603;4;28;0.83
9;121;603;605;2;28;0.83
9;122;605;608;3;28;0.83
9;123;608;609;1;28;0.83
9;124;609;617;8;28;0.83
9;125;617;618;1;28;0.83
9;126;618;619;1;28;0.83
9;127;619;623;4;28;0.83
9;128;623;625;2;28;0.83
9;129;625;628;3;28;0.83
9;130;628;629;1;28;0.83
9;131;629;632;3;28;0.83
9;132;632;637;5;28;0.83
9;133;637;638;1;28;0.83
9;134;638;639;1;28;0.83
9;135;639;643;4;28;0.83
9;136;643;645;2;28;0.83
9;137;645;648;3;28;0.83
9;138;648;652;4;28;0.83
9;139;652;655;3;28;0.83
9;140;655;657;2;28;0.83
9;141;657;658;1;28;0.83
9;142;658;659;1;28;0.83
9;143;659;663;4;28;0.83
9;144;663;665;2;28;0.83
9;145;665;668;3;28;0.83
9;146;668;669;1;28;0.83
9;147;669;677;8;28;0.83
9;148;677;678;1;28;0.83
9;149;678;679;1;28;0.83
9;150;679;683;4;28;0.83
9;151;683;685;2;28;0.83
9;152;685;688;3;28;0.83
9;153;688;689;1;28;0.83
9;154;689;692;3;28;0.83
9;155;692;697;5;28;0.83
9;156;697;698;1;28;0.83
9;157;698;699;1;28;0.83
9;158;699;703;4;28;0.83
9;159;703;705;2;28;0.83
9;160;705;708;3;28;0.83
9;161;708;712;4;28;0.83
9;162;712;715;3;28;0.83
9;163;715;717;2;28;0.83
9;164;717;718;1;28;0.83
9;165;718;719;1;28;0.83
9;166;719;723;4;28;0.83
9;167;723;725;2;28;0.83
9;168;725;728;3;28;0.83
9;169;728;729;1;28;0.83
9;170;729;737;8;28;0.83
9;171;737;738;1;28;0.83
9;172;738;739;1;28;0.83
9;173;739;743;4;28;0.83
9;174;743;745;2;28;0.83
9;175;745;748;3;28;0.83
9;176;748;749;1;28;0.83
9;177;749;752;3;28;0.83
9;178;752;757;5;28;0.83
9;179;757;758;1;28;0.83
9;180;758;759;1;28;0.83
9;181;759;763;4;28;0.83
9;182;763;765;2;28;0.83
9;183;765;768;3;28;0.83
9;184;768;772;4;28;0.83
9;185;772;775;3;28;0.83
9;186;775;777;2;28;0.83
9;187;777;778;1;28;0.83
9;188;778;779;1;28;0.83
9;189;779;783;4;28;0.83
9;190;783;785;2;28;0.83
9;191;785;788;3;28;0.83
9;192;788;789;1;28;0.83
9;193;789;795;6;28;0.83
9;194;795;797;2;28;0.83
9;195;797;798;1;28;0.83
9;196;798;799;1;28;0.83
9;197;799;803;4;28;0.83
9;198;803;805;2;28;0.83
9;199;805;808;3;28;0.83
9;200;808;812;4;28;0.83
9;201;812;815;3;28;0.83
9;202;815;817;2;28;0.83
9;203;817;818;1;28;0.83
9;204;818;819;1;28;0.83
9;205;819;823;4;28;0.83
9;206;823;825;2;28;0.83
9;207;825;828;3;28;0.83
9;208;828;829;1;28;0.83
9;209;829;832;3;28;0.83
9;210;832;835;3;28;0.83
9;211;835;837;2;28;0.83
9;212;837;838;1;28;0.83
9;213;838;839;1;28;0.83
9;214;839;843;4;28;0.83
9;215;843;845;2;28;0.83
9;216;845;847;2;28;0.83
9;217;847;848;1;28;0.83
9;218;848;849;1;28;0.83
9;219;849;855;6;28;0.83
9;220;855;857;2;28;0.83
9;221;857;858;1;28;0.83
9;222;858;859;1;28;0.83
9;223;859;863;4;28;0.83
9;224;863;865;2;28;0.83
9;225;865;868;3;28;0.83
9;226;868;869;1;28;0.83
9;227;869;872;3;28;0.83
9;228;872;873;1;28;0.83
9;229;873;875;2;28;0.83
9;230;875;877;2;28;0.83
9;231;877;878;1;28;0.83
9;232;878;879;1;28;0.83
9;233;879;883;4;28;0.83
9;234;883;885;2;28;0.83
9;235;885;887;2;28;0.83
9;236;887;888;1;28;0.83
9;237;888;889;1;28;0.83
9;238;889;892;3;28;0.83
9;239;892;893;1;28;0.83
9;240;893;895;2;28;0.83
9;241;895;897;2;28;0.83
9;242;897;898;1;28;0.83
9;243;898;899;1;28;0.83
9;244;899;903;4;28;0.83
9;245;903;905;2;28;0.83
9;246;905;907;2;28;0.83
9;247;907;908;1;28;0.83
9;248;908;909;1;28;0.83
9;249;909;912;3;28;0.83
9;250;912;913;1;28;0.83
9;251;913;915;2;28;0.83
9;252;915;917;2;28;0.83
9;253;917;918;1;28;0.83
9;254;918;919;1;28;0.83
9;255;919;923;4;28;0.83
9;256;923;925;2;28;0.83
9;257;925;928;3;28;0.83
9;258;928;929;1;28;0.83
9;259;929;932;3;28;0.83
9;260;932;933;1;28;0.83
9;261;933;935;2;28;0.83
9;262;935;937;2;28;0.83
9;263;937;938;1;28;0.83
9;264;938;939;1;28;0.83
9;265;939;943;4;28;0.83
9;266;943;945;2;28;0.83
9;267;945;947;2;28;0.83
9;268;947;948;1;28;0.83
9;269;948;949;1;28;0.83
9;270;949;952;3;28;0.83
9;271;952;953;1;28;0.83
9;272;953;955;2;28;0.83
9;273;955;957;2;28;0.83
9;274;957;958;1;28;0.83
9;275;958;959;1;28;0.83
9;276;959;963;4;28;0.83
9;277;963;965;2;28;0.83
9;278;965;967;2;28;0.83
9;279;967;968;1;28;0.83
9;280;968;969;1;28;0.83
9;281;969;972;3;28;0.83
9;282;972;973;1;28;0.83
9;283;973;975;2;28;0.83
9;284;975;977;2;28;0.83
9;285;977;978;1;28;0.83
9;286;978;979;1;28;0.83
9;287;979;983;4;28;0.83
9;288;983;985;2;28;0.83
9;289;985;988;3;28;0.83
9;290;988;989;1;28;0.83
9;291;989;993;4;28;0.83
9;292;993;995;2;28;0.83
9;293;995;997;2;28;0.83
9;294;997;998;1;28;0.83
9;295;998;999;1;28;0.83
9;296;999;1003;4;28;0.83
9;297;1003;1005;2;28;0.83
9;298;1005;1007;2;28;0.83
9;299;1007;1008;1;28;0.83
9;300;1008;1009;1;28;0.83
9;301;1009;1015;6;28;0.83
9;302;1015;1017;2;28;0.83
9;303;1017;1018;1;28;0.83
9;304;1018;1019;1;28;0.83
9;305;1019;1023;4;28;0.83
9;306;1023;1027;4;28;0.83
9;307;1027;1028;1;28;0.83
9;308;1028;1029;1;28;0.83
9;309;1029;1030;1;28;0.83
9;310;1030;1033;3;28;0.83
9;311;1033;1037;4;28;0.83
9;312;1037;1038;1;28;0.83
9;313;1038;1039;1;28;0.83
9;314;1039;1045;6;28;0.83
9;315;1045;1047;2;28;0.83
9;316;1047;1048;1;28;0.83
9;317;1048;1049;1;28;0.83
9;318;1049;1053;4;28;0.83
9;319;1053;1057;4;28;0.83
9;320;1057;1059;2;28;0.83
9;321;1059;1060;1;28;0.83
9;322;1060;1063;3;28;0.83
9;323;1063;1067;4;28;0.83
9;324;1067;1068;1;28;0.83
9;325;1068;1069;1;28;0.83
9;326;1069;1071;2;28;0.83
9;327;1071;1075;4;28;0.83
9;328;1075;1077;2;28;0.83
9;329;1077;1078;1;28;0.83
9;330;1078;1079;1;28;0.83
9;331;1079;1083;4;28;0.83
9;332;1083;1088;5;28;0.83
9;333;1088;1089;1;28;0.83
9;334;1089;1090;1;28;0.83
9;335;1090;1093;3;28;0.83
9;336;1093;1097;4;28;0.83
9;337;1097;1098;1;28;0.83
9;338;1098;1105;7;28;0.83
9;339;1105;1107;2;28;0.83
9;340;1107;1108;1;28;0.83
9;341;1108;1109;1;28;0.83
9;342;1109;1110;1;28;0.83
9;343;1110;1112;2;28;0.83
9;344;1112;1113;1;28;0.83
9;345;1113;1117;4;28;0.83
9;346;1117;1120;3;28;0.83
9;347;1120;1125;5;28;0.83
9;348;1125;1128;3;28;0.83
9;349;1128;1132;4;28;0.83
9;350;1132;1137;5;28;0.83
9;351;1137;1139;2;28;0.83
9;352;1139;1140;1;28;0.83
9;353;1140;1145;5;28;0.83
9;354;1145;1147;2;28;0.83
9;355;1147;1152;5;28;0.83
9;356;1152;1153;1;28;0.83
9;357;1153;1155;2;28;0.83
9;358;1155;1157;2;28;0.83
9;359;1157;1160;3;28;0.83
9;360;1160;1162;2;28;0.83
9;361;1162;1170;8;28;0.83
9;362;1170;1175;5;28;0.83
9;363;1175;1177;2;28;0.83
9;364;1177;1178;1;28;0.83
9;365;1178;1180;2;28;0.83
9;366;1180;1182;2;28;0.83
9;367;1182;1188;6;28;0.83
9;368;1188;1195;7;28;0.83
9;369;1195;1197;2;28;0.83
9;370;1197;1200;3;28;0.83
9;371;1200;1202;2;28;0.83
9;372;1202;1209;7;28;0.83
9;373;1209;1215;6;28;0.83
9;374;1215;1222;7;28;0.83
9;375;1222;1225;3;28;0.83
9;376;1225;1227;2;28;0.83
9;377;1227;1228;1;28;0.83
9;378;1228;1230;2;28;0.83
9;379;1230;1232;2;28;0.83
9;380;1232;1235;3;28;0.83
9;381;1235;1237;2;28;0.83
9;382;1237;1247;10;28;0.83
9;383;1247;1250;3;28;0.83
9;384;1250;1252;2;28;0.83
9;385;1252;1253;1;28;0.83
9;386;1253;1260;7;28;0.83
9;387;1260;1268;8;28;0.83
9;388;1268;1272;4;28;0.83
9;389;1272;1275;3;28;0.83
9;390;1275;1277;2;28;0.83
9;391;1277;1284;7;28;0.83
9;392;1284;1285;1;28;0.83
9;393;1285;1299;14;28;0.83
9;394;1299;1300;1;28;0.83
9;395;1300;1302;2;28;0.83
9;396;1302;1305;3;28;0.83
9;397;1305;1307;2;28;0.83
9;398;1307;1309;2;28;0.83
9;399;1309;1310;1;28;0.83
9;400;1310;1312;2;28;0.83
9;401;1312;1322;10;28;0.83
9;402;1322;1327;5;28;0.83
9;403;1327;1330;3;28;0.83
9;404;1330;1334;4;28;0.83
9;405;1334;1335;1;28;0.83
9;406;1335;1342;7;28;0.83
9;407;1342;1347;5;28;0.83
9;408;1347;1350;3;28;0.83
9;409;1350;1357;7;28;0.83
9;410;1357;1363;6;28;0.83
9;411;1363;1365;2;28;0.83
9;412;1365;1380;15;28;0.83
9;413;1380;1382;2;28;0.83
9;414;1382;1397;15;28;0.83
9;415;1397;1412;15;28;0.83
9;416;1412;1427;15;28;0.83
9;417;1427;1442;15;28;0.83
9;418;1442;1457;15;28;0.83
9;419;1457;1472;15;28;0.83
9;420;1472;1487;15;28;0.83
9;421;1487;1502;15;28;0.83
9;422;1502;1517;15;28;0.83
9;423;1517;1532;15;28;0.83
9;424;1532;1547;15;28;0.83
9;425;1547;1562;15;28;0.83
9;426;1562;1577;15;28;0.83
9;427;1577;1592;15;28;0.83
9;428;1592;1607;15;28;0.83
9;429;1607;1622;15;28;0.83
9;430;1622;1637;15;28;0.83
9;431;1637;1652;15;28;0.83
9;432;1652;1667;15;28;0.83
9;433;1667;1680;13;28;0.83
10;0;240;325;85;28;0.83
10;1;325;331;6;28;0.83
10;2;331;337;6;28;0.83
10;3;337;338;1;28;0.83
10;4;338;339;1;28;0.83
10;5;339;342;3;28;0.83
10;6;342;344;2;28;0.83
10;7;344;346;2;28;0.83
10;8;346;348;2;28;0.83
10;9;348;349;1;28;0.83
10;10;349;352;3;28;0.83
10;11;352;353;1;28;0.83
10;12;353;354;1;28;0.83
10;13;354;355;1;28;0.83
10;14;355;361;6;28;0.83
10;15;361;362;1;28;0.83
10;16;362;366;4;28;0.83
10;17;366;368;2;28;0.83
10;18;368;369;1;28;0.83
10;19;369;375;6;28;0.83
10;20;375;377;2;28;0.83
10;21;377;378;1;28;0.83
10;22;378;379;1;28;0.83
10;23;379;382;3;28;0.83
10;24;382;383;1;28;0.83
10;25;383;385;2;28;0.83
10;26;385;388;3;28;0.83
10;27;388;392;4;28;0.83
10;28;392;393;1;28;0.83
10;29;393;394;1;28;0.83
10;30;394;395;1;28;0.83
10;31;395;398;3;28;0.83
10;32;398;399;1;28;0.83
10;33;399;403;4;28;0.83
10;34;403;405;2;28;0.83
10;35;405;408;3;28;0.83
10;36;408;409;1;28;0.83
10;37;409;412;3;28;0.83
10;38;412;413;1;28;0.83
10;39;413;415;2;28;0.83
10;40;415;418;3;28;0.83
10;41;418;419;1;28;0.83
10;42;419;422;3;28;0.83
10;43;422;423;1;28;0.83
10;44;423;425;2;28;0.83
10;45;425;428;3;28;0.83
10;46;428;429;1;28;0.83
10;47;429;433;4;28;0.83
10;48;433;435;2;28;0.83
10;49;435;438;3;28;0.83
10;50;438;439;1;28;0.83
10;51;439;442;3;28;0.83
10;52;442;443;1;28;0.83
10;53;443;445;2;28;0.83
10;54;445;448;3;28;0.83
10;55;448;452;4;28;0.83
10;56;452;453;1;28;0.83
10;57;453;454;1;28;0.83
10;58;454;455;1;28;0.83
10;59;455;457;2;28;0.83
10;60;457;458;1;28;0.83
10;61;458;459;1;28;0.83
10;62;459;463;4;28;0.83
10;63;463;465;2;28;0.83
10;64;465;468;3;28;0.83
10;65;468;469;1;28;0.83
10;66;469;472;3;28;0.83
10;67;472;473;1;28;0.83
10;68;473;475;2;28;0.83
10;69;475;478;3;28;0.83
10;70;478;479;1;28;0.83
10;71;479;482;3;28;0.83
10;72;482;483;1;28;0.83
10;73;483;485;2;28;0.83
10;74;485;488;3;28;0.83
10;75;488;489;1;28;0.83
10;76;489;492;3;28;0.83
10;77;492;493;1;28;0.83
10;78;493;495;2;28;0.83
10;79;495;499;4;28;0.83
10;80;499;503;4;28;0.83
10;81;503;505;2;28;0.83
10;82;505;508;3;28;0.83
10;83;508;512;4;28;0.83
10;84;512;513;1;28;0.83
10;85;513;515;2;28;0.83
10;86;515;517;2;28;0.83
10;87;517;519;2;28;0.83
10;88;519;520;1;28;0.83
10;89;520;523;3;28;0.83
10;90;523;525;2;28;0.83
10;91;525;528;3;28;0.83
10;92;528;529;1;28;0.83
10;93;529;532;3;28;0.83
10;94;532;537;5;28;0.83
10;95;537;538;1;28;0.83
10;96;538;539;1;28;0.83
10;97;539;543;4;28;0.83
10;98;543;545;2;28;0.83
10;99;545;548;3;28;0.83
10;100;548;555;7;28;0.83
10;101;555;557;2;28;0.83
10;102;557;558;1;28;0.83
10;103;558;559;1;28;0.83
10;104;559;563;4;28;0.83
10;105;563;565;2;28;0.83
10;106;565;568;3;28;0.83
10;107;568;569;1;28;0.83
10;108;569;572;3;28;0.83
10;109;572;577;5;28;0.83
10;110;577;578;1;28;0.83
10;111;578;579;1;28;0.83
10;112;579;583;4;28;0.83
10;113;583;585;2;28;0.83
10;114;585;588;3;28;0.83
10;115;588;592;4;28;0.83
10;116;592;595;3;28;0.83
10;117;595;597;2;28;0.83
10;118;597;598;1;28;0.83
10;119;598;599;1;28;0.83
10;120;599;603;4;28;0.83
10;121;603;605;2;28;0.83
10;122;605;608;3;28;0.83
10;123;608;609;1;28;0.83
10;124;609;617;8;28;0.83
10;125;617;618;1;28;0.83
10;126;618;619;1;28;0.83
10;127;619;623;4;28;0.83
10;128;623;625;2;28;0.83
10;129;625;628;3;28;0.83
10;130;628;629;1;28;0.83
10;131;629;632;3;28;0.83
10;132;632;637;5;28;0.83
10;133;637;638;1;28;0.83
10;134;638;639;1;28;0.83
10;135;639;643;4;28;0.83
10;136;643;645;2;28;0.83
10;137;645;648;3;28;0.83
10;138;648;652;4;28;0.83
10;139;652;655;3;28;0.83
10;140;655;657;2;28;0.83
10;141;657;658;1;28;0.83
10;142;658;659;1;28;0.83
10;143;659;663;4;28;0.83
10;144;663;665;2;28;0.83
10;145;665;668;3;28;0.83
10;146;668;669;1;28;0.83
10;147;669;677;8;28;0.83
10;148;677;678;1;28;0.83
10;149;678;679;1;28;0.83
10;150;679;683;4;28;0.83
10;151;683;685;2;28;0.83
10;152;685;688;3;28;0.83
10;153;688;689;1;28;0.83
10;154;689;692;3;28;0.83
10;155;692;697;5;28;0.83
10;156;697;698;1;28;0.83
10;157;698;699;1;28;0.83
10;158;699;703;4;28;0.83
10;159;703;705;2;28;0.83
10;160;705;708;3;28;0.83
10;161;708;712;4;28;0.83
10;162;712;715;3;28;0.83
10;163;715;717;2;28;0.83
10;164;717;718;1;28;0.83
10;165;718;719;1;28;0.83
10;166;719;723;4;28;0.83
10;167;723;725;2;28;0.83
10;168;725;728;3;28;0.83
10;169;728;729;1;28;0.83
10;170;729;737;8;28;0.83
10;171;737;738;1;28;0.83
10;172;738;739;1;28;0.83
10;173;739;743;4;28;0.83
10;174;743;745;2;28;0.83
10;175;745;748;3;28;0.83
10;176;748;749;1;28;0.83
10;177;749;752;3;28;0.83
10;178;752;757;5;28;0.83
10;179;757;758;1;28;0.83
10;180;758;759;1;28;0.83
10;181;759;763;4;28;0.83
10;182;763;765;2;28;0.83
10;183;765;768;3;28;0.83
10;184;768;772;4;28;0.83
10;185;772;775;3;28;0.83
10;186;775;777;2;28;0.83
10;187;777;778;1;28;0.83
10;188;778;779;1;28;0.83
10;189;779;783;4;28;0.83
10;190;783;785;2;28;0.83
10;191;785;788;3;28;0.83
10;192;788;789;1;28;0.83
10;193;789;795;6;28;0.83
10;194;795;797;2;28;0.83
10;195;797;798;1;28;0.83
10;196;798;799;1;28;0.83
10;197;799;803;4;28;0.83
10;198;803;805;2;28;0.83
10;199;805;808;3;28;0.83
10;200;808;812;4;28;0.83
10;201;812;815;3;28;0.83
10;202;815;817;2;28;0.83
10;203;817;818;1;28;0.83
10;204;818;819;1;28;0.83
10;205;819;823;4;28;0.83
10;206;823;825;2;28;0.83
10;207;825;828;3;28;0.83
10;208;828;829;1;28;0.83
10;209;829;832;3;28;0.83
10;210;832;835;3;28;0.83
10;211;835;837;2;28;0.83
10;212;837;838;1;28;0.83
10;213;838;839;1;28;0.83
10;214;839;843;4;28;0.83
10;215;843;845;2;28;0.83
10;216;845;847;2;28;0.83
10;217;847;848;1;28;0.83
10;218;848;849;1;28;0.83
10;219;849;855;6;28;0.83
10;220;855;857;2;28;0.83
10;221;857;858;1;28;0.83
10;222;858;859;1;28;0.83
10;223;859;863;4;28;0.83
10;224;863;865;2;28;0.83
10;225;865;868;3;28;0.83
10;226;868;869;1;28;0.83
10;227;869;872;3;28;0.83
10;228;872;873;1;28;0.83
10;229;873;875;2;28;0.83
10;230;875;877;2;28;0.83
10;231;877;878;1;28;0.83
10;232;878;879;1;28;0.83
10;233;879;883;4;28;0.83
10;234;883;885;2;28;0.83
10;235;885;887;2;28;0.83
10;236;887;888;1;28;0.83
10;237;888;889;1;28;0.83
10;238;889;892;3;28;0.83
10;239;892;893;1;28;0.83
10;240;893;895;2;28;0.83
10;241;895;897;2;28;0.83
10;242;897;898;1;28;0.83
10;243;898;899;1;28;0.83
10;244;899;903;4;28;0.83
10;245;903;905;2;28;0.83
10;246;905;907;2;28;0.83
10;247;907;908;1;28;0.83
10;248;908;909;1;28;0.83
10;249;909;912;3;28;0.83
10;250;912;913;1;28;0.83
10;251;913;915;2;28;0.83
10;252;915;917;2;28;0.83
10;253;917;918;1;28;0.83
10;254;918;919;1;28;0.83
10;255;919;923;4;28;0.83
10;256;923;925;2;28;0.83
10;257;925;928;3;28;0.83
10;258;928;929;1;28;0.83
10;259;929;932;3;28;0.83
10;260;932;933;1;28;0.83
10;261;933;935;2;28;0.83
10;262;935;937;2;28;0.83
10;263;937;938;1;28;0.83
10;264;938;939;1;28;0.83
10;265;939;943;4;28;0.83
10;266;943;945;2;28;0.83
10;267;945;947;2;28;0.83
10;268;947;948;1;28;0.83
10;269;948;949;1;28;0.83
10;270;949;952;3;28;0.83
10;271;952;953;1;28;0.83
10;272;953;955;2;28;0.83
10;273;955;957;2;28;0.83
10;274;957;958;1;28;0.83
10;275;958;959;1;28;0.83
10;276;959;963;4;28;0.83
10;277;963;965;2;28;0.83
10;278;965;967;2;28;0.83
10;279;967;968;1;28;0.83
10;280;968;969;1;28;0.83
10;281;969;972;3;28;0.83
10;282;972;973;1;28;0.83
10;283;973;975;2;28;0.83
10;284;975;977;2;28;0.83
10;285;977;978;1;28;0.83
10;286;978;979;1;28;0.83
10;287;979;983;4;28;0.83
10;288;983;985;2;28;0.83
10;289;985;988;3;28;0.83
10;290;988;989;1;28;0.83
10;291;989;993;4;28;0.83
10;292;993;995;2;28;0.83
10;293;995;997;2;28;0.83
10;294;997;998;1;28;0.83
10;295;998;999;1;28;0.83
10;296;999;1003;4;28;0.83
10;297;1003;1005;2;28;0.83
10;298;1005;1007;2;28;0.83
10;299;1007;1008;1;28;0.83
10;300;1008;1009;1;28;0.83
10;301;1009;1015;6;28;0.83
10;302;1015;1017;2;28;0.83
10;303;1017;1018;1;28;0.83
10;304;1018;1019;1;28;0.83
10;305;1019;1023;4;28;0.83
10;306;1023;1027;4;28;0.83
10;307;1027;1028;1;28;0.83
10;308;1028;1029;1;28;0.83
10;309;1029;1030;1;28;0.83
10;310;1030;1033;3;28;0.83
10;311;1033;1037;4;28;0.83
10;312;1037;1038;1;28;0.83
10;313;1038;1039;1;28;0.83
10;314;1039;1045;6;28;0.83
10;315;1045;1047;2;28;0.83
10;316;1047;1048;1;28;0.83
10;317;1048;1049;1;28;0.83
10;318;1049;1053;4;28;0.83
10;319;1053;1057;4;28;0.83
10;320;1057;1059;2;28;0.83
10;321;1059;1060;1;28;0.83
10;322;1060;1063;3;28;0.83
10;323;1063;1067;4;28;0.83
10;324;1067;1068;1;28;0.83
10;325;1068;1069;1;28;0.83
10;326;1069;1071;2;28;0.83
10;327;1071;1075;4;28;0.83
10;328;1075;1077;2;28;0.83
10;329;1077;1078;1;28;0.83
10;330;1078;1079;1;28;0.83
10;331;1079;1083;4;28;0.83
10;332;1083;1088;5;28;0.83
10;333;1088;1089;1;28;0.83
10;334;1089;1090;1;28;0.83
10;335;1090;1093;3;28;0.83
10;336;1093;1097;4;28;0.83
10;337;1097;1098;1;28;0.83
10;338;1098;1105;7;28;0.83
10;339;1105;1107;2;28;0.83
10;340;1107;1108;1;28;0.83
10;341;1108;1109;1;28;0.83
10;342;1109;1110;1;28;0.83
10;343;1110;1112;2;28;0.83
10;344;1112;1113;1;28;0.83
10;345;1113;1117;4;28;0.83
10;346;1117;1120;3;28;0.83
10;347;1120;1125;5;28;0.83
10;348;1125;1128;3;28;0.83
10;349;1128;1132;4;28;0.83
10;350;1132;1137;5;28;0.83
10;351;1137;1139;2;28;0.83
10;352;1139;1140;1;28;0.83
10;353;1140;1145;5;28;0.83
10;354;1145;1147;2;28;0.83
10;355;1147;1152;5;28;0.83
10;356;1152;1153;1;28;0.83
10;357;1153;1155;2;28;0.83
10;358;1155;1157;2;28;0.83
10;359;1157;1160;3;28;0.83
10;360;1160;1162;2;28;0.83
10;361;1162;1170;8;28;0.83
10;362;1170;1175;5;28;0.83
10;363;1175;1177;2;28;0.83
10;364;1177;1178;1;28;0.83
10;365;1178;1180;2;28;0.83
10;366;1180;1182;2;28;0.83
10;367;1182;1188;6;28;0.83
10;368;1188;1195;7;28;0.83
10;369;1195;1197;2;28;0.83
10;370;1197;1200;3;28;0.83
10;371;1200;1202;2;28;0.83
10;372;1202;1209;7;28;0.83
10;373;1209;1215;6;28;0.83
10;374;1215;1222;7;28;0.83
10;375;1222;1225;3;28;0.83
10;376;1225;1227;2;28;0.83
10;377;1227;1228;1;28;0.83
10;378;1228;1230;2;28;0.83
10;379;1230;1232;2;28;0.83
10;380;1232;1235;3;28;0.83
10;381;1235;1237;2;28;0.83
10;382;1237;1247;10;28;0.83
10;383;1247;1250;3;28;0.83
10;384;1250;1252;2;28;0.83
10;385;1252;1253;1;28;0.83
10;386;1253;1260;7;28;0.83
10;387;1260;1268;8;28;0.83
10;388;1268;1272;4;28;0.83
10;389;1272;1275;3;28;0.83
10;390;1275;1277;2;28;0.83
10;391;1277;1284;7;28;0.83
10;392;1284;1285;1;28;0.83
10;393;1285;1299;14;28;0.83
10;394;1299;1300;1;28;0.83
10;395;1300;1302;2;28;0.83
10;396;1302;1305;3;28;0.83
10;397;1305;1307;2;28;0.83
10;398;1307;1309;2;28;0.83
10;399;1309;1310;1;28;0.83
10;400;1310;1312;2;28;0.83
10;401;1312;1322;10;28;0.83
10;402;1322;1327;5;28;0.83
10;403;1327;1330;3;28;0.83
10;404;1330;1334;4;28;0.83
10;405;1334;1335;1;28;0.83
10;406;1335;1342;7;28;0.83
10;407;1342;1347;5;28;0.83
10;408;1347;1350;3;28;0.83
10;409;1350;1357;7;28;0.83
10;410;1357;1363;6;28;0.83
10;411;1363;1365;2;28;0.83
10;412;1365;1380;15;28;0.83
10;413;1380;1382;2;28;0.83
10;414;1382;1397;15;28;0.83
10;415;1397;1412;15;28;0.83
10;416;1412;1427;15;28;0.83
10;417;1427;1442;15;28;0.83
10;418;1442;1457;15;28;0.83
10;419;1457;1472;15;28;0.83
10;420;1472;1487;15;28;0.83
10;421;1487;1502;15;28;0.83
10;422;1502;1517;15;28;0.83
10;423;1517;1532;15;28;0.83
10;424;1532;1547;15;28;0.83
10;425;1547;1562;15;28;0.83
10;426;1562;1577;15;28;0.83
10;427;1577;1592;15;28;0.83
10;428;1592;1607;15;28;0.83
10;429;1607;1622;15;28;0.83
10;430;1622;1637;15;28;0.83
10;431;1637;1652;15;28;0.83
10;432;1652;1667;15;28;0.83
10;433;1667;1680;13;28;0.83
