Index Nabijacky;Index Udalosti;Cas Zaciatku;Cas Konca;CasTrvania;Miesto;Rychlost nabijania
0;0;243;330;87;25;2.0
0;1;330;331;1;25;2.0
0;2;331;333;2;25;2.0
0;3;333;334;1;25;2.0
0;4;334;342;8;25;2.0
0;5;342;343;1;25;2.0
0;6;343;345;2;25;2.0
0;7;345;347;2;25;2.0
0;8;347;354;7;25;2.0
0;9;354;357;3;25;2.0
0;10;357;358;1;25;2.0
0;11;358;360;2;25;2.0
0;12;360;362;2;25;2.0
0;13;362;366;4;25;2.0
0;14;366;369;3;25;2.0
0;15;369;380;11;25;2.0
0;16;380;382;2;25;2.0
0;17;382;387;5;25;2.0
0;18;387;389;2;25;2.0
0;19;389;390;1;25;2.0
0;20;390;393;3;25;2.0
0;21;393;395;2;25;2.0
0;22;395;401;6;25;2.0
0;23;401;402;1;25;2.0
0;24;402;404;2;25;2.0
0;25;404;405;1;25;2.0
0;26;405;406;1;25;2.0
0;27;406;415;9;25;2.0
0;28;415;416;1;25;2.0
0;29;416;417;1;25;2.0
0;30;417;420;3;25;2.0
0;31;420;422;2;25;2.0
0;32;422;424;2;25;2.0
0;33;424;427;3;25;2.0
0;34;427;432;5;25;2.0
0;35;432;433;1;25;2.0
0;36;433;435;2;25;2.0
0;37;435;439;4;25;2.0
0;38;439;446;7;25;2.0
0;39;446;447;1;25;2.0
0;40;447;448;1;25;2.0
0;41;448;449;1;25;2.0
0;42;449;450;1;25;2.0
0;43;450;459;9;25;2.0
0;44;459;460;1;25;2.0
0;45;460;462;2;25;2.0
0;46;462;463;1;25;2.0
0;47;463;465;2;25;2.0
0;48;465;466;1;25;2.0
0;49;466;467;1;25;2.0
0;50;467;470;3;25;2.0
0;51;470;477;7;25;2.0
0;52;477;478;1;25;2.0
0;53;478;479;1;25;2.0
0;54;479;480;1;25;2.0
0;55;480;482;2;25;2.0
0;56;482;491;9;25;2.0
0;57;491;494;3;25;2.0
0;58;494;495;1;25;2.0
0;59;495;501;6;25;2.0
0;60;501;502;1;25;2.0
0;61;502;510;8;25;2.0
0;62;510;511;1;25;2.0
0;63;511;517;6;25;2.0
0;64;517;524;7;25;2.0
0;65;524;530;6;25;2.0
0;66;530;534;4;25;2.0
0;67;534;540;6;25;2.0
0;68;540;546;6;25;2.0
0;69;546;547;1;25;2.0
0;70;547;551;4;25;2.0
0;71;551;579;28;25;2.0
0;72;579;582;3;25;2.0
0;73;582;586;4;25;2.0
0;74;586;587;1;25;2.0
0;75;587;590;3;25;2.0
0;76;590;622;32;25;2.0
0;77;622;627;5;25;2.0
0;78;627;629;2;25;2.0
0;79;629;631;2;25;2.0
0;80;631;652;21;25;2.0
0;81;652;655;3;25;2.0
0;82;655;657;2;25;2.0
0;83;657;670;13;25;2.0
0;84;670;671;1;25;2.0
0;85;671;692;21;25;2.0
0;86;692;699;7;25;2.0
0;87;699;715;16;25;2.0
0;88;715;716;1;25;2.0
0;89;716;720;4;25;2.0
0;90;720;722;2;25;2.0
0;91;722;727;5;25;2.0
0;92;727;745;18;25;2.0
0;93;745;747;2;25;2.0
0;94;747;759;12;25;2.0
0;95;759;761;2;25;2.0
0;96;761;765;4;25;2.0
0;97;765;767;2;25;2.0
0;98;767;772;5;25;2.0
0;99;772;775;3;25;2.0
0;100;775;781;6;25;2.0
0;101;781;787;6;25;2.0
0;102;787;794;7;25;2.0
0;103;794;797;3;25;2.0
0;104;797;802;5;25;2.0
0;105;802;803;1;25;2.0
0;106;803;805;2;25;2.0
0;107;805;811;6;25;2.0
0;108;811;817;6;25;2.0
0;109;817;819;2;25;2.0
0;110;819;820;1;25;2.0
0;111;820;829;9;25;2.0
0;112;829;830;1;25;2.0
0;113;830;835;5;25;2.0
0;114;835;837;2;25;2.0
0;115;837;840;3;25;2.0
0;116;840;844;4;25;2.0
0;117;844;847;3;25;2.0
0;118;847;850;3;25;2.0
0;119;850;852;2;25;2.0
0;120;852;860;8;25;2.0
0;121;860;862;2;25;2.0
0;122;862;864;2;25;2.0
0;123;864;868;4;25;2.0
0;124;868;870;2;25;2.0
0;125;870;879;9;25;2.0
0;126;879;882;3;25;2.0
0;127;882;885;3;25;2.0
0;128;885;887;2;25;2.0
0;129;887;892;5;25;2.0
0;130;892;899;7;25;2.0
0;131;899;900;1;25;2.0
0;132;900;902;2;25;2.0
0;133;902;905;3;25;2.0
0;134;905;909;4;25;2.0
0;135;909;914;5;25;2.0
0;136;914;917;3;25;2.0
0;137;917;922;5;25;2.0
0;138;922;924;2;25;2.0
0;139;924;930;6;25;2.0
0;140;930;935;5;25;2.0
0;141;935;937;2;25;2.0
0;142;937;939;2;25;2.0
0;143;939;945;6;25;2.0
0;144;945;952;7;25;2.0
0;145;952;954;2;25;2.0
0;146;954;955;1;25;2.0
0;147;955;957;2;25;2.0
0;148;957;963;6;25;2.0
0;149;963;965;2;25;2.0
0;150;965;967;2;25;2.0
0;151;967;972;5;25;2.0
0;152;972;974;2;25;2.0
0;153;974;975;1;25;2.0
0;154;975;977;2;25;2.0
0;155;977;978;1;25;2.0
0;156;978;990;12;25;2.0
0;157;990;994;4;25;2.0
0;158;994;997;3;25;2.0
0;159;997;1002;5;25;2.0
0;160;1002;1008;6;25;2.0
0;161;1008;1011;3;25;2.0
0;162;1011;1014;3;25;2.0
0;163;1014;1017;3;25;2.0
0;164;1017;1020;3;25;2.0
0;165;1020;1024;4;25;2.0
0;166;1024;1030;6;25;2.0
0;167;1030;1032;2;25;2.0
0;168;1032;1040;8;25;2.0
0;169;1040;1041;1;25;2.0
0;170;1041;1044;3;25;2.0
0;171;1044;1053;9;25;2.0
0;172;1053;1057;4;25;2.0
0;173;1057;1064;7;25;2.0
0;174;1064;1075;11;25;2.0
0;175;1075;1077;2;25;2.0
0;176;1077;1080;3;25;2.0
0;177;1080;1082;2;25;2.0
0;178;1082;1083;1;25;2.0
0;179;1083;1084;1;25;2.0
0;180;1084;1091;7;25;2.0
0;181;1091;1095;4;25;2.0
0;182;1095;1098;3;25;2.0
0;183;1098;1102;4;25;2.0
0;184;1102;1108;6;25;2.0
0;185;1108;1109;1;25;2.0
0;186;1109;1118;9;25;2.0
0;187;1118;1133;15;25;2.0
0;188;1133;1136;3;25;2.0
0;189;1136;1139;3;25;2.0
0;190;1139;1143;4;25;2.0
0;191;1143;1149;6;25;2.0
0;192;1149;1168;19;25;2.0
0;193;1168;1169;1;25;2.0
0;194;1169;1173;4;25;2.0
0;195;1173;1178;5;25;2.0
0;196;1178;1198;20;25;2.0
0;197;1198;1203;5;25;2.0
0;198;1203;1204;1;25;2.0
0;199;1204;1208;4;25;2.0
0;200;1208;1218;10;25;2.0
0;201;1218;1229;11;25;2.0
0;202;1229;1253;24;25;2.0
0;203;1253;1261;8;25;2.0
0;204;1261;1262;1;25;2.0
0;205;1262;1263;1;25;2.0
0;206;1263;1268;5;25;2.0
0;207;1268;1278;10;25;2.0
0;208;1278;1289;11;25;2.0
0;209;1289;1293;4;25;2.0
0;210;1293;1313;20;25;2.0
0;211;1313;1321;8;25;2.0
0;212;1321;1322;1;25;2.0
0;213;1322;1336;14;25;2.0
0;214;1336;1339;3;25;2.0
0;215;1339;1355;16;25;2.0
0;216;1355;1357;2;25;2.0
0;217;1357;1359;2;25;2.0
0;218;1359;1360;1;25;2.0
0;219;1360;1363;3;25;2.0
0;220;1363;1364;1;25;2.0
0;221;1364;1373;9;25;2.0
0;222;1373;1377;4;25;2.0
0;223;1377;1378;1;25;2.0
0;224;1378;1383;5;25;2.0
0;225;1383;1398;15;25;2.0
0;226;1398;1413;15;25;2.0
0;227;1413;1428;15;25;2.0
0;228;1428;1443;15;25;2.0
0;229;1443;1458;15;25;2.0
0;230;1458;1473;15;25;2.0
0;231;1473;1488;15;25;2.0
0;232;1488;1503;15;25;2.0
0;233;1503;1518;15;25;2.0
0;234;1518;1533;15;25;2.0
0;235;1533;1548;15;25;2.0
0;236;1548;1563;15;25;2.0
0;237;1563;1578;15;25;2.0
0;238;1578;1593;15;25;2.0
0;239;1593;1608;15;25;2.0
0;240;1608;1623;15;25;2.0
0;241;1623;1638;15;25;2.0
0;242;1638;1653;15;25;2.0
0;243;1653;1668;15;25;2.0
0;244;1668;1680;12;25;2.0
1;0;242;330;88;42;2.0
1;1;330;332;2;42;2.0
1;2;332;333;1;42;2.0
1;3;333;334;1;42;2.0
1;4;334;343;9;42;2.0
1;5;343;345;2;42;2.0
1;6;345;347;2;42;2.0
1;7;347;354;7;42;2.0
1;8;354;357;3;42;2.0
1;9;357;358;1;42;2.0
1;10;358;360;2;42;2.0
1;11;360;363;3;42;2.0
1;12;363;366;3;42;2.0
1;13;366;369;3;42;2.0
1;14;369;380;11;42;2.0
1;15;380;383;3;42;2.0
1;16;383;387;4;42;2.0
1;17;387;389;2;42;2.0
1;18;389;390;1;42;2.0
1;19;390;394;4;42;2.0
1;20;394;395;1;42;2.0
1;21;395;402;7;42;2.0
1;22;402;404;2;42;2.0
1;23;404;405;1;42;2.0
1;24;405;406;1;42;2.0
1;25;406;415;9;42;2.0
1;26;415;416;1;42;2.0
1;27;416;417;1;42;2.0
1;28;417;420;3;42;2.0
1;29;420;423;3;42;2.0
1;30;423;424;1;42;2.0
1;31;424;427;3;42;2.0
1;32;427;433;6;42;2.0
1;33;433;435;2;42;2.0
1;34;435;439;4;42;2.0
1;35;439;446;7;42;2.0
1;36;446;448;2;42;2.0
1;37;448;449;1;42;2.0
1;38;449;450;1;42;2.0
1;39;450;451;1;42;2.0
1;40;451;459;8;42;2.0
1;41;459;461;2;42;2.0
1;42;461;463;2;42;2.0
1;43;463;465;2;42;2.0
1;44;465;467;2;42;2.0
1;45;467;471;4;42;2.0
1;46;471;477;6;42;2.0
1;47;477;478;1;42;2.0
1;48;478;480;2;42;2.0
1;49;480;482;2;42;2.0
1;50;482;492;10;42;2.0
1;51;492;494;2;42;2.0
1;52;494;495;1;42;2.0
1;53;495;502;7;42;2.0
1;54;502;503;1;42;2.0
1;55;503;511;8;42;2.0
1;56;511;512;1;42;2.0
1;57;512;517;5;42;2.0
1;58;517;523;6;42;2.0
1;59;523;524;1;42;2.0
1;60;524;530;6;42;2.0
1;61;530;535;5;42;2.0
1;62;535;541;6;42;2.0
1;63;541;547;6;42;2.0
1;64;547;548;1;42;2.0
1;65;548;552;4;42;2.0
1;66;552;579;27;42;2.0
1;67;579;583;4;42;2.0
1;68;583;587;4;42;2.0
1;69;587;590;3;42;2.0
1;70;590;591;1;42;2.0
1;71;591;622;31;42;2.0
1;72;622;623;1;42;2.0
1;73;623;628;5;42;2.0
1;74;628;629;1;42;2.0
1;75;629;632;3;42;2.0
1;76;632;653;21;42;2.0
1;77;653;655;2;42;2.0
1;78;655;657;2;42;2.0
1;79;657;670;13;42;2.0
1;80;670;672;2;42;2.0
1;81;672;692;20;42;2.0
1;82;692;693;1;42;2.0
1;83;693;699;6;42;2.0
1;84;699;716;17;42;2.0
1;85;716;717;1;42;2.0
1;86;717;720;3;42;2.0
1;87;720;723;3;42;2.0
1;88;723;727;4;42;2.0
1;89;727;745;18;42;2.0
1;90;745;746;1;42;2.0
1;91;746;759;13;42;2.0
1;92;759;762;3;42;2.0
1;93;762;765;3;42;2.0
1;94;765;767;2;42;2.0
1;95;767;773;6;42;2.0
1;96;773;776;3;42;2.0
1;97;776;782;6;42;2.0
1;98;782;787;5;42;2.0
1;99;787;794;7;42;2.0
1;100;794;796;2;42;2.0
1;101;796;803;7;42;2.0
1;102;803;805;2;42;2.0
1;103;805;812;7;42;2.0
1;104;812;816;4;42;2.0
1;105;816;817;1;42;2.0
1;106;817;819;2;42;2.0
1;107;819;820;1;42;2.0
1;108;820;830;10;42;2.0
1;109;830;831;1;42;2.0
1;110;831;835;4;42;2.0
1;111;835;837;2;42;2.0
1;112;837;840;3;42;2.0
1;113;840;844;4;42;2.0
1;114;844;847;3;42;2.0
1;115;847;850;3;42;2.0
1;116;850;853;3;42;2.0
1;117;853;860;7;42;2.0
1;118;860;862;2;42;2.0
1;119;862;864;2;42;2.0
1;120;864;868;4;42;2.0
1;121;868;870;2;42;2.0
1;122;870;879;9;42;2.0
1;123;879;882;3;42;2.0
1;124;882;883;1;42;2.0
1;125;883;885;2;42;2.0
1;126;885;886;1;42;2.0
1;127;886;887;1;42;2.0
1;128;887;893;6;42;2.0
1;129;893;899;6;42;2.0
1;130;899;901;2;42;2.0
1;131;901;902;1;42;2.0
1;132;902;905;3;42;2.0
1;133;905;910;5;42;2.0
1;134;910;914;4;42;2.0
1;135;914;917;3;42;2.0
1;136;917;923;6;42;2.0
1;137;923;930;7;42;2.0
1;138;930;936;6;42;2.0
1;139;936;937;1;42;2.0
1;140;937;938;1;42;2.0
1;141;938;939;1;42;2.0
1;142;939;945;6;42;2.0
1;143;945;953;8;42;2.0
1;144;953;954;1;42;2.0
1;145;954;956;2;42;2.0
1;146;956;957;1;42;2.0
1;147;957;964;7;42;2.0
1;148;964;965;1;42;2.0
1;149;965;967;2;42;2.0
1;150;967;973;6;42;2.0
1;151;973;974;1;42;2.0
1;152;974;976;2;42;2.0
1;153;976;977;1;42;2.0
1;154;977;979;2;42;2.0
1;155;979;990;11;42;2.0
1;156;990;991;1;42;2.0
1;157;991;994;3;42;2.0
1;158;994;997;3;42;2.0
1;159;997;998;1;42;2.0
1;160;998;1002;4;42;2.0
1;161;1002;1009;7;42;2.0
1;162;1009;1012;3;42;2.0
1;163;1012;1013;1;42;2.0
1;164;1013;1017;4;42;2.0
1;165;1017;1020;3;42;2.0
1;166;1020;1021;1;42;2.0
1;167;1021;1024;3;42;2.0
1;168;1024;1030;6;42;2.0
1;169;1030;1032;2;42;2.0
1;170;1032;1041;9;42;2.0
1;171;1041;1042;1;42;2.0
1;172;1042;1043;1;42;2.0
1;173;1043;1044;1;42;2.0
1;174;1044;1054;10;42;2.0
1;175;1054;1057;3;42;2.0
1;176;1057;1064;7;42;2.0
1;177;1064;1074;10;42;2.0
1;178;1074;1075;1;42;2.0
1;179;1075;1077;2;42;2.0
1;180;1077;1081;4;42;2.0
1;181;1081;1082;1;42;2.0
1;182;1082;1084;2;42;2.0
1;183;1084;1092;8;42;2.0
1;184;1092;1096;4;42;2.0
1;185;1096;1099;3;42;2.0
1;186;1099;1101;2;42;2.0
1;187;1101;1109;8;42;2.0
1;188;1109;1110;1;42;2.0
1;189;1110;1119;9;42;2.0
1;190;1119;1133;14;42;2.0
1;191;1133;1136;3;42;2.0
1;192;1136;1140;4;42;2.0
1;193;1140;1143;3;42;2.0
1;194;1143;1150;7;42;2.0
1;195;1150;1169;19;42;2.0
1;196;1169;1170;1;42;2.0
1;197;1170;1173;3;42;2.0
1;198;1173;1179;6;42;2.0
1;199;1179;1199;20;42;2.0
1;200;1199;1203;4;42;2.0
1;201;1203;1208;5;42;2.0
1;202;1208;1219;11;42;2.0
1;203;1219;1230;11;42;2.0
1;204;1230;1254;24;42;2.0
1;205;1254;1261;7;42;2.0
1;206;1261;1263;2;42;2.0
1;207;1263;1268;5;42;2.0
1;208;1268;1279;11;42;2.0
1;209;1279;1290;11;42;2.0
1;210;1290;1294;4;42;2.0
1;211;1294;1313;19;42;2.0
1;212;1313;1321;8;42;2.0
1;213;1321;1322;1;42;2.0
1;214;1322;1336;14;42;2.0
1;215;1336;1339;3;42;2.0
1;216;1339;1356;17;42;2.0
1;217;1356;1358;2;42;2.0
1;218;1358;1360;2;42;2.0
1;219;1360;1361;1;42;2.0
1;220;1361;1363;2;42;2.0
1;221;1363;1364;1;42;2.0
1;222;1364;1373;9;42;2.0
1;223;1373;1377;4;42;2.0
1;224;1377;1384;7;42;2.0
1;225;1384;1399;15;42;2.0
1;226;1399;1414;15;42;2.0
1;227;1414;1429;15;42;2.0
1;228;1429;1444;15;42;2.0
1;229;1444;1459;15;42;2.0
1;230;1459;1474;15;42;2.0
1;231;1474;1489;15;42;2.0
1;232;1489;1504;15;42;2.0
1;233;1504;1519;15;42;2.0
1;234;1519;1534;15;42;2.0
1;235;1534;1549;15;42;2.0
1;236;1549;1564;15;42;2.0
1;237;1564;1579;15;42;2.0
1;238;1579;1594;15;42;2.0
1;239;1594;1609;15;42;2.0
1;240;1609;1624;15;42;2.0
1;241;1624;1639;15;42;2.0
1;242;1639;1654;15;42;2.0
1;243;1654;1669;15;42;2.0
1;244;1669;1680;11;42;2.0
2;0;246;325;79;49;2.0
2;1;325;329;4;49;2.0
2;2;329;334;5;49;2.0
2;3;334;335;1;49;2.0
2;4;335;337;2;49;2.0
2;5;337;340;3;49;2.0
2;6;340;344;4;49;2.0
2;7;344;346;2;49;2.0
2;8;346;348;2;49;2.0
2;9;348;355;7;49;2.0
2;10;355;357;2;49;2.0
2;11;357;358;1;49;2.0
2;12;358;359;1;49;2.0
2;13;359;361;2;49;2.0
2;14;361;366;5;49;2.0
2;15;366;367;1;49;2.0
2;16;367;372;5;49;2.0
2;17;372;375;3;49;2.0
2;18;375;386;11;49;2.0
2;19;386;388;2;49;2.0
2;20;388;389;1;49;2.0
2;21;389;390;1;49;2.0
2;22;390;392;2;49;2.0
2;23;392;397;5;49;2.0
2;24;397;403;6;49;2.0
2;25;403;404;1;49;2.0
2;26;404;405;1;49;2.0
2;27;405;407;2;49;2.0
2;28;407;409;2;49;2.0
2;29;409;410;1;49;2.0
2;30;410;418;8;49;2.0
2;31;418;419;1;49;2.0
2;32;419;426;7;49;2.0
2;33;426;427;1;49;2.0
2;34;427;428;1;49;2.0
2;35;428;434;6;49;2.0
2;36;434;436;2;49;2.0
2;37;436;442;6;49;2.0
2;38;442;445;3;49;2.0
2;39;445;447;2;49;2.0
2;40;447;449;2;49;2.0
2;41;449;451;2;49;2.0
2;42;451;452;1;49;2.0
2;43;452;454;2;49;2.0
2;44;454;462;8;49;2.0
2;45;462;464;2;49;2.0
2;46;464;466;2;49;2.0
2;47;466;468;2;49;2.0
2;48;468;470;2;49;2.0
2;49;470;474;4;49;2.0
2;50;474;478;4;49;2.0
2;51;478;479;1;49;2.0
2;52;479;481;2;49;2.0
2;53;481;483;2;49;2.0
2;54;483;494;11;49;2.0
2;55;494;495;1;49;2.0
2;56;495;497;2;49;2.0
2;57;497;505;8;49;2.0
2;58;505;506;1;49;2.0
2;59;506;514;8;49;2.0
2;60;514;518;4;49;2.0
2;61;518;525;7;49;2.0
2;62;525;527;2;49;2.0
2;63;527;528;1;49;2.0
2;64;528;538;10;49;2.0
2;65;538;544;6;49;2.0
2;66;544;546;2;49;2.0
2;67;546;550;4;49;2.0
2;68;550;551;1;49;2.0
2;69;551;554;3;49;2.0
2;70;554;582;28;49;2.0
2;71;582;586;4;49;2.0
2;72;586;588;2;49;2.0
2;73;588;589;1;49;2.0
2;74;589;594;5;49;2.0
2;75;594;623;29;49;2.0
2;76;623;626;3;49;2.0
2;77;626;632;6;49;2.0
2;78;632;634;2;49;2.0
2;79;634;650;16;49;2.0
2;80;650;656;6;49;2.0
2;81;656;658;2;49;2.0
2;82;658;669;11;49;2.0
2;83;669;674;5;49;2.0
2;84;674;693;19;49;2.0
2;85;693;696;3;49;2.0
2;86;696;702;6;49;2.0
2;87;702;719;17;49;2.0
2;88;719;726;7;49;2.0
2;89;726;728;2;49;2.0
2;90;728;740;12;49;2.0
2;91;740;751;11;49;2.0
2;92;751;762;11;49;2.0
2;93;762;764;2;49;2.0
2;94;764;768;4;49;2.0
2;95;768;776;8;49;2.0
2;96;776;779;3;49;2.0
2;97;779;785;6;49;2.0
2;98;785;788;3;49;2.0
2;99;788;797;9;49;2.0
2;100;797;801;4;49;2.0
2;101;801;804;3;49;2.0
2;102;804;806;2;49;2.0
2;103;806;815;9;49;2.0
2;104;815;818;3;49;2.0
2;105;818;821;3;49;2.0
2;106;821;822;1;49;2.0
2;107;822;833;11;49;2.0
2;108;833;834;1;49;2.0
2;109;834;838;4;49;2.0
2;110;838;839;1;49;2.0
2;111;839;847;8;49;2.0
2;112;847;848;1;49;2.0
2;113;848;853;5;49;2.0
2;114;853;856;3;49;2.0
2;115;856;859;3;49;2.0
2;116;859;863;4;49;2.0
2;117;863;865;2;49;2.0
2;118;865;867;2;49;2.0
2;119;867;869;2;49;2.0
2;120;869;871;2;49;2.0
2;121;871;873;2;49;2.0
2;122;873;881;8;49;2.0
2;123;881;882;1;49;2.0
2;124;882;886;4;49;2.0
2;125;886;888;2;49;2.0
2;126;888;889;1;49;2.0
2;127;889;896;7;49;2.0
2;128;896;901;5;49;2.0
2;129;901;902;1;49;2.0
2;130;902;903;1;49;2.0
2;131;903;904;1;49;2.0
2;132;904;908;4;49;2.0
2;133;908;913;5;49;2.0
2;134;913;916;3;49;2.0
2;135;916;917;1;49;2.0
2;136;917;918;1;49;2.0
2;137;918;925;7;49;2.0
2;138;925;926;1;49;2.0
2;139;926;928;2;49;2.0
2;140;928;933;5;49;2.0
2;141;933;936;3;49;2.0
2;142;936;938;2;49;2.0
2;143;938;939;1;49;2.0
2;144;939;941;2;49;2.0
2;145;941;942;1;49;2.0
2;146;942;948;6;49;2.0
2;147;948;956;8;49;2.0
2;148;956;957;1;49;2.0
2;149;957;958;1;49;2.0
2;150;958;959;1;49;2.0
2;151;959;966;7;49;2.0
2;152;966;967;1;49;2.0
2;153;967;968;1;49;2.0
2;154;968;976;8;49;2.0
2;155;976;977;1;49;2.0
2;156;977;978;1;49;2.0
2;157;978;979;1;49;2.0
2;158;979;982;3;49;2.0
2;159;982;993;11;49;2.0
2;160;993;994;1;49;2.0
2;161;994;997;3;49;2.0
2;162;997;998;1;49;2.0
2;163;998;1001;3;49;2.0
2;164;1001;1012;11;49;2.0
2;165;1012;1015;3;49;2.0
2;166;1015;1018;3;49;2.0
2;167;1018;1024;6;49;2.0
2;168;1024;1027;3;49;2.0
2;169;1027;1031;4;49;2.0
2;170;1031;1033;2;49;2.0
2;171;1033;1044;11;49;2.0
2;172;1044;1045;1;49;2.0
2;173;1045;1047;2;49;2.0
2;174;1047;1048;1;49;2.0
2;175;1048;1056;8;49;2.0
2;176;1056;1058;2;49;2.0
2;177;1058;1067;9;49;2.0
2;178;1067;1070;3;49;2.0
2;179;1070;1078;8;49;2.0
2;180;1078;1079;1;49;2.0
2;181;1079;1081;2;49;2.0
2;182;1081;1084;3;49;2.0
2;183;1084;1086;2;49;2.0
2;184;1086;1087;1;49;2.0
2;185;1087;1095;8;49;2.0
2;186;1095;1099;4;49;2.0
2;187;1099;1102;3;49;2.0
2;188;1102;1106;4;49;2.0
2;189;1106;1107;1;49;2.0
2;190;1107;1112;5;49;2.0
2;191;1112;1122;10;49;2.0
2;192;1122;1134;12;49;2.0
2;193;1134;1135;1;49;2.0
2;194;1135;1142;7;49;2.0
2;195;1142;1146;4;49;2.0
2;196;1146;1153;7;49;2.0
2;197;1153;1172;19;49;2.0
2;198;1172;1174;2;49;2.0
2;199;1174;1182;8;49;2.0
2;200;1182;1197;15;49;2.0
2;201;1197;1206;9;49;2.0
2;202;1206;1208;2;49;2.0
2;203;1208;1209;1;49;2.0
2;204;1209;1222;13;49;2.0
2;205;1222;1232;10;49;2.0
2;206;1232;1257;25;49;2.0
2;207;1257;1260;3;49;2.0
2;208;1260;1266;6;49;2.0
2;209;1266;1269;3;49;2.0
2;210;1269;1282;13;49;2.0
2;211;1282;1292;10;49;2.0
2;212;1292;1297;5;49;2.0
2;213;1297;1316;19;49;2.0
2;214;1316;1320;4;49;2.0
2;215;1320;1323;3;49;2.0
2;216;1323;1324;1;49;2.0
2;217;1324;1331;7;49;2.0
2;218;1331;1342;11;49;2.0
2;219;1342;1358;16;49;2.0
2;220;1358;1361;3;49;2.0
2;221;1361;1364;3;49;2.0
2;222;1364;1367;3;49;2.0
2;223;1367;1368;1;49;2.0
2;224;1368;1374;6;49;2.0
2;225;1374;1380;6;49;2.0
2;226;1380;1382;2;49;2.0
2;227;1382;1387;5;49;2.0
2;228;1387;1402;15;49;2.0
2;229;1402;1417;15;49;2.0
2;230;1417;1432;15;49;2.0
2;231;1432;1447;15;49;2.0
2;232;1447;1462;15;49;2.0
2;233;1462;1477;15;49;2.0
2;234;1477;1492;15;49;2.0
2;235;1492;1507;15;49;2.0
2;236;1507;1522;15;49;2.0
2;237;1522;1537;15;49;2.0
2;238;1537;1552;15;49;2.0
2;239;1552;1567;15;49;2.0
2;240;1567;1582;15;49;2.0
2;241;1582;1597;15;49;2.0
2;242;1597;1612;15;49;2.0
2;243;1612;1627;15;49;2.0
2;244;1627;1642;15;49;2.0
2;245;1642;1657;15;49;2.0
2;246;1657;1672;15;49;2.0
2;247;1672;1680;8;49;2.0
3;0;244;329;85;77;2.0
3;1;329;330;1;77;2.0
3;2;330;331;1;77;2.0
3;3;331;335;4;77;2.0
3;4;335;336;1;77;2.0
3;5;336;337;1;77;2.0
3;6;337;344;7;77;2.0
3;7;344;346;2;77;2.0
3;8;346;347;1;77;2.0
3;9;347;354;7;77;2.0
3;10;354;357;3;77;2.0
3;11;357;359;2;77;2.0
3;12;359;361;2;77;2.0
3;13;361;362;1;77;2.0
3;14;362;363;1;77;2.0
3;15;363;367;4;77;2.0
3;16;367;372;5;77;2.0
3;17;372;381;9;77;2.0
3;18;381;384;3;77;2.0
3;19;384;387;3;77;2.0
3;20;387;389;2;77;2.0
3;21;389;392;3;77;2.0
3;22;392;393;1;77;2.0
3;23;393;396;3;77;2.0
3;24;396;398;2;77;2.0
3;25;398;399;1;77;2.0
3;26;399;404;5;77;2.0
3;27;404;406;2;77;2.0
3;28;406;407;1;77;2.0
3;29;407;410;3;77;2.0
3;30;410;414;4;77;2.0
3;31;414;416;2;77;2.0
3;32;416;419;3;77;2.0
3;33;419;420;1;77;2.0
3;34;420;424;4;77;2.0
3;35;424;427;3;77;2.0
3;36;427;434;7;77;2.0
3;37;434;437;3;77;2.0
3;38;437;442;5;77;2.0
3;39;442;443;1;77;2.0
3;40;443;449;6;77;2.0
3;41;449;451;2;77;2.0
3;42;451;452;1;77;2.0
3;43;452;454;2;77;2.0
3;44;454;462;8;77;2.0
3;45;462;464;2;77;2.0
3;46;464;467;3;77;2.0
3;47;467;469;2;77;2.0
3;48;469;474;5;77;2.0
3;49;474;479;5;77;2.0
3;50;479;482;3;77;2.0
3;51;482;483;1;77;2.0
3;52;483;494;11;77;2.0
3;53;494;495;1;77;2.0
3;54;495;497;2;77;2.0
3;55;497;505;8;77;2.0
3;56;505;507;2;77;2.0
3;57;507;514;7;77;2.0
3;58;514;515;1;77;2.0
3;59;515;527;12;77;2.0
3;60;527;531;4;77;2.0
3;61;531;538;7;77;2.0
3;62;538;544;6;77;2.0
3;63;544;547;3;77;2.0
3;64;547;550;3;77;2.0
3;65;550;552;2;77;2.0
3;66;552;555;3;77;2.0
3;67;555;582;27;77;2.0
3;68;582;584;2;77;2.0
3;69;584;587;3;77;2.0
3;70;587;589;2;77;2.0
3;71;589;590;1;77;2.0
3;72;590;594;4;77;2.0
3;73;594;619;25;77;2.0
3;74;619;627;8;77;2.0
3;75;627;632;5;77;2.0
3;76;632;635;3;77;2.0
3;77;635;654;19;77;2.0
3;78;654;656;2;77;2.0
3;79;656;657;1;77;2.0
3;80;657;669;12;77;2.0
3;81;669;675;6;77;2.0
3;82;675;689;14;77;2.0
3;83;689;697;8;77;2.0
3;84;697;702;5;77;2.0
3;85;702;719;17;77;2.0
3;86;719;720;1;77;2.0
3;87;720;724;4;77;2.0
3;88;724;727;3;77;2.0
3;89;727;746;19;77;2.0
3;90;746;750;4;77;2.0
3;91;750;762;12;77;2.0
3;92;762;764;2;77;2.0
3;93;764;765;1;77;2.0
3;94;765;777;12;77;2.0
3;95;777;779;2;77;2.0
3;96;779;784;5;77;2.0
3;97;784;785;1;77;2.0
3;98;785;797;12;77;2.0
3;99;797;800;3;77;2.0
3;100;800;804;4;77;2.0
3;101;804;807;3;77;2.0
3;102;807;814;7;77;2.0
3;103;814;815;1;77;2.0
3;104;815;820;5;77;2.0
3;105;820;821;1;77;2.0
3;106;821;822;1;77;2.0
3;107;822;834;12;77;2.0
3;108;834;839;5;77;2.0
3;109;839;844;5;77;2.0
3;110;844;847;3;77;2.0
3;111;847;854;7;77;2.0
3;112;854;857;3;77;2.0
3;113;857;859;2;77;2.0
3;114;859;867;8;77;2.0
3;115;867;869;2;77;2.0
3;116;869;871;2;77;2.0
3;117;871;872;1;77;2.0
3;118;872;874;2;77;2.0
3;119;874;881;7;77;2.0
3;120;881;882;1;77;2.0
3;121;882;884;2;77;2.0
3;122;884;887;3;77;2.0
3;123;887;889;2;77;2.0
3;124;889;897;8;77;2.0
3;125;897;899;2;77;2.0
3;126;899;901;2;77;2.0
3;127;901;902;1;77;2.0
3;128;902;904;2;77;2.0
3;129;904;909;5;77;2.0
3;130;909;914;5;77;2.0
3;131;914;916;2;77;2.0
3;132;916;917;1;77;2.0
3;133;917;927;10;77;2.0
3;134;927;931;4;77;2.0
3;135;931;934;3;77;2.0
3;136;934;936;2;77;2.0
3;137;936;939;3;77;2.0
3;138;939;942;3;77;2.0
3;139;942;949;7;77;2.0
3;140;949;954;5;77;2.0
3;141;954;957;3;77;2.0
3;142;957;959;2;77;2.0
3;143;959;966;7;77;2.0
3;144;966;967;1;77;2.0
3;145;967;969;2;77;2.0
3;146;969;974;5;77;2.0
3;147;974;977;3;77;2.0
3;148;977;979;2;77;2.0
3;149;979;982;3;77;2.0
3;150;982;994;12;77;2.0
3;151;994;997;3;77;2.0
3;152;997;1001;4;77;2.0
3;153;1001;1002;1;77;2.0
3;154;1002;1012;10;77;2.0
3;155;1012;1014;2;77;2.0
3;156;1014;1015;1;77;2.0
3;157;1015;1017;2;77;2.0
3;158;1017;1021;4;77;2.0
3;159;1021;1025;4;77;2.0
3;160;1025;1027;2;77;2.0
3;161;1027;1031;4;77;2.0
3;162;1031;1034;3;77;2.0
3;163;1034;1044;10;77;2.0
3;164;1044;1046;2;77;2.0
3;165;1046;1047;1;77;2.0
3;166;1047;1054;7;77;2.0
3;167;1054;1056;2;77;2.0
3;168;1056;1057;1;77;2.0
3;169;1057;1067;10;77;2.0
3;170;1067;1074;7;77;2.0
3;171;1074;1076;2;77;2.0
3;172;1076;1078;2;77;2.0
3;173;1078;1081;3;77;2.0
3;174;1081;1084;3;77;2.0
3;175;1084;1087;3;77;2.0
3;176;1087;1096;9;77;2.0
3;177;1096;1099;3;77;2.0
3;178;1099;1102;3;77;2.0
3;179;1102;1105;3;77;2.0
3;180;1105;1108;3;77;2.0
3;181;1108;1113;5;77;2.0
3;182;1113;1123;10;77;2.0
3;183;1123;1130;7;77;2.0
3;184;1130;1135;5;77;2.0
3;185;1135;1143;8;77;2.0
3;186;1143;1146;3;77;2.0
3;187;1146;1153;7;77;2.0
3;188;1153;1170;17;77;2.0
3;189;1170;1172;2;77;2.0
3;190;1172;1173;1;77;2.0
3;191;1173;1183;10;77;2.0
3;192;1183;1198;15;77;2.0
3;193;1198;1205;7;77;2.0
3;194;1205;1206;1;77;2.0
3;195;1206;1207;1;77;2.0
3;196;1207;1222;15;77;2.0
3;197;1222;1233;11;77;2.0
3;198;1233;1258;25;77;2.0
3;199;1258;1260;2;77;2.0
3;200;1260;1265;5;77;2.0
3;201;1265;1266;1;77;2.0
3;202;1266;1282;16;77;2.0
3;203;1282;1293;11;77;2.0
3;204;1293;1298;5;77;2.0
3;205;1298;1316;18;77;2.0
3;206;1316;1319;3;77;2.0
3;207;1319;1320;1;77;2.0
3;208;1320;1325;5;77;2.0
3;209;1325;1337;12;77;2.0
3;210;1337;1343;6;77;2.0
3;211;1343;1359;16;77;2.0
3;212;1359;1362;3;77;2.0
3;213;1362;1364;2;77;2.0
3;214;1364;1367;3;77;2.0
3;215;1367;1370;3;77;2.0
3;216;1370;1380;10;77;2.0
3;217;1380;1381;1;77;2.0
3;218;1381;1387;6;77;2.0
3;219;1387;1402;15;77;2.0
3;220;1402;1417;15;77;2.0
3;221;1417;1432;15;77;2.0
3;222;1432;1447;15;77;2.0
3;223;1447;1462;15;77;2.0
3;224;1462;1477;15;77;2.0
3;225;1477;1492;15;77;2.0
3;226;1492;1507;15;77;2.0
3;227;1507;1522;15;77;2.0
3;228;1522;1537;15;77;2.0
3;229;1537;1552;15;77;2.0
3;230;1552;1567;15;77;2.0
3;231;1567;1582;15;77;2.0
3;232;1582;1597;15;77;2.0
3;233;1597;1612;15;77;2.0
3;234;1612;1627;15;77;2.0
3;235;1627;1642;15;77;2.0
3;236;1642;1657;15;77;2.0
3;237;1657;1672;15;77;2.0
3;238;1672;1680;8;77;2.0
4;0;243;331;88;93;2.0
4;1;331;332;1;93;2.0
4;2;332;334;2;93;2.0
4;3;334;335;1;93;2.0
4;4;335;336;1;93;2.0
4;5;336;346;10;93;2.0
4;6;346;347;1;93;2.0
4;7;347;348;1;93;2.0
4;8;348;355;7;93;2.0
4;9;355;358;3;93;2.0
4;10;358;361;3;93;2.0
4;11;361;362;1;93;2.0
4;12;362;367;5;93;2.0
4;13;367;370;3;93;2.0
4;14;370;382;12;93;2.0
4;15;382;387;5;93;2.0
4;16;387;388;1;93;2.0
4;17;388;390;2;93;2.0
4;18;390;391;1;93;2.0
4;19;391;393;2;93;2.0
4;20;393;397;4;93;2.0
4;21;397;398;1;93;2.0
4;22;398;403;5;93;2.0
4;23;403;405;2;93;2.0
4;24;405;406;1;93;2.0
4;25;406;410;4;93;2.0
4;26;410;417;7;93;2.0
4;27;417;418;1;93;2.0
4;28;418;419;1;93;2.0
4;29;419;420;1;93;2.0
4;30;420;421;1;93;2.0
4;31;421;425;4;93;2.0
4;32;425;427;2;93;2.0
4;33;427;428;1;93;2.0
4;34;428;436;8;93;2.0
4;35;436;437;1;93;2.0
4;36;437;440;3;93;2.0
4;37;440;447;7;93;2.0
4;38;447;450;3;93;2.0
4;39;450;451;1;93;2.0
4;40;451;452;1;93;2.0
4;41;452;454;2;93;2.0
4;42;454;460;6;93;2.0
4;43;460;464;4;93;2.0
4;44;464;466;2;93;2.0
4;45;466;467;1;93;2.0
4;46;467;468;1;93;2.0
4;47;468;469;1;93;2.0
4;48;469;474;5;93;2.0
4;49;474;478;4;93;2.0
4;50;478;481;3;93;2.0
4;51;481;482;1;93;2.0
4;52;482;483;1;93;2.0
4;53;483;495;12;93;2.0
4;54;495;496;1;93;2.0
4;55;496;505;9;93;2.0
4;56;505;507;2;93;2.0
4;57;507;514;7;93;2.0
4;58;514;516;2;93;2.0
4;59;516;518;2;93;2.0
4;60;518;525;7;93;2.0
4;61;525;527;2;93;2.0
4;62;527;532;5;93;2.0
4;63;532;538;6;93;2.0
4;64;538;544;6;93;2.0
4;65;544;549;5;93;2.0
4;66;549;550;1;93;2.0
4;67;550;552;2;93;2.0
4;68;552;556;4;93;2.0
4;69;556;580;24;93;2.0
4;70;580;587;7;93;2.0
4;71;587;588;1;93;2.0
4;72;588;591;3;93;2.0
4;73;591;594;3;93;2.0
4;74;594;623;29;93;2.0
4;75;623;627;4;93;2.0
4;76;627;629;2;93;2.0
4;77;629;630;1;93;2.0
4;78;630;636;6;93;2.0
4;79;636;657;21;93;2.0
4;80;657;658;1;93;2.0
4;81;658;671;13;93;2.0
4;82;671;676;5;93;2.0
4;83;676;693;17;93;2.0
4;84;693;697;4;93;2.0
4;85;697;700;3;93;2.0
4;86;700;719;19;93;2.0
4;87;719;721;2;93;2.0
4;88;721;727;6;93;2.0
4;89;727;728;1;93;2.0
4;90;728;747;19;93;2.0
4;91;747;750;3;93;2.0
4;92;750;760;10;93;2.0
4;93;760;766;6;93;2.0
4;94;766;768;2;93;2.0
4;95;768;777;9;93;2.0
4;96;777;779;2;93;2.0
4;97;779;785;6;93;2.0
4;98;785;788;3;93;2.0
4;99;788;795;7;93;2.0
4;100;795;800;5;93;2.0
4;101;800;806;6;93;2.0
4;102;806;807;1;93;2.0
4;103;807;815;8;93;2.0
4;104;815;818;3;93;2.0
4;105;818;820;2;93;2.0
4;106;820;822;2;93;2.0
4;107;822;834;12;93;2.0
4;108;834;838;4;93;2.0
4;109;838;839;1;93;2.0
4;110;839;841;2;93;2.0
4;111;841;845;4;93;2.0
4;112;845;848;3;93;2.0
4;113;848;854;6;93;2.0
4;114;854;857;3;93;2.0
4;115;857;861;4;93;2.0
4;116;861;863;2;93;2.0
4;117;863;865;2;93;2.0
4;118;865;871;6;93;2.0
4;119;871;872;1;93;2.0
4;120;872;874;2;93;2.0
4;121;874;880;6;93;2.0
4;122;880;883;3;93;2.0
4;123;883;887;4;93;2.0
4;124;887;888;1;93;2.0
4;125;888;889;1;93;2.0
4;126;889;897;8;93;2.0
4;127;897;900;3;93;2.0
4;128;900;903;3;93;2.0
4;129;903;904;1;93;2.0
4;130;904;909;5;93;2.0
4;131;909;914;5;93;2.0
4;132;914;915;1;93;2.0
4;133;915;918;3;93;2.0
4;134;918;927;9;93;2.0
4;135;927;932;5;93;2.0
4;136;932;934;2;93;2.0
4;137;934;938;4;93;2.0
4;138;938;939;1;93;2.0
4;139;939;940;1;93;2.0
4;140;940;942;2;93;2.0
4;141;942;949;7;93;2.0
4;142;949;955;6;93;2.0
4;143;955;957;2;93;2.0
4;144;957;958;1;93;2.0
4;145;958;959;1;93;2.0
4;146;959;967;8;93;2.0
4;147;967;968;1;93;2.0
4;148;968;969;1;93;2.0
4;149;969;975;6;93;2.0
4;150;975;977;2;93;2.0
4;151;977;978;1;93;2.0
4;152;978;979;1;93;2.0
4;153;979;982;3;93;2.0
4;154;982;994;12;93;2.0
4;155;994;995;1;93;2.0
4;156;995;998;3;93;2.0
4;157;998;1002;4;93;2.0
4;158;1002;1003;1;93;2.0
4;159;1003;1012;9;93;2.0
4;160;1012;1015;3;93;2.0
4;161;1015;1017;2;93;2.0
4;162;1017;1018;1;93;2.0
4;163;1018;1022;4;93;2.0
4;164;1022;1025;3;93;2.0
4;165;1025;1033;8;93;2.0
4;166;1033;1034;1;93;2.0
4;167;1034;1044;10;93;2.0
4;168;1044;1045;1;93;2.0
4;169;1045;1046;1;93;2.0
4;170;1046;1047;1;93;2.0
4;171;1047;1058;11;93;2.0
4;172;1058;1065;7;93;2.0
4;173;1065;1077;12;93;2.0
4;174;1077;1078;1;93;2.0
4;175;1078;1083;5;93;2.0
4;176;1083;1084;1;93;2.0
4;177;1084;1085;1;93;2.0
4;178;1085;1088;3;93;2.0
4;179;1088;1096;8;93;2.0
4;180;1096;1099;3;93;2.0
4;181;1099;1102;3;93;2.0
4;182;1102;1105;3;93;2.0
4;183;1105;1110;5;93;2.0
4;184;1110;1114;4;93;2.0
4;185;1114;1123;9;93;2.0
4;186;1123;1134;11;93;2.0
4;187;1134;1137;3;93;2.0
4;188;1137;1144;7;93;2.0
4;189;1144;1153;9;93;2.0
4;190;1153;1172;19;93;2.0
4;191;1172;1174;2;93;2.0
4;192;1174;1183;9;93;2.0
4;193;1183;1200;17;93;2.0
4;194;1200;1204;4;93;2.0
4;195;1204;1207;3;93;2.0
4;196;1207;1209;2;93;2.0
4;197;1209;1222;13;93;2.0
4;198;1222;1234;12;93;2.0
4;199;1234;1258;24;93;2.0
4;200;1258;1262;4;93;2.0
4;201;1262;1264;2;93;2.0
4;202;1264;1265;1;93;2.0
4;203;1265;1269;4;93;2.0
4;204;1269;1282;13;93;2.0
4;205;1282;1294;12;93;2.0
4;206;1294;1298;4;93;2.0
4;207;1298;1314;16;93;2.0
4;208;1314;1322;8;93;2.0
4;209;1322;1323;1;93;2.0
4;210;1323;1325;2;93;2.0
4;211;1325;1338;13;93;2.0
4;212;1338;1343;5;93;2.0
4;213;1343;1360;17;93;2.0
4;214;1360;1361;1;93;2.0
4;215;1361;1362;1;93;2.0
4;216;1362;1364;2;93;2.0
4;217;1364;1367;3;93;2.0
4;218;1367;1374;7;93;2.0
4;219;1374;1378;4;93;2.0
4;220;1378;1381;3;93;2.0
4;221;1381;1387;6;93;2.0
4;222;1387;1402;15;93;2.0
4;223;1402;1417;15;93;2.0
4;224;1417;1432;15;93;2.0
4;225;1432;1447;15;93;2.0
4;226;1447;1462;15;93;2.0
4;227;1462;1477;15;93;2.0
4;228;1477;1492;15;93;2.0
4;229;1492;1507;15;93;2.0
4;230;1507;1522;15;93;2.0
4;231;1522;1537;15;93;2.0
4;232;1537;1552;15;93;2.0
4;233;1552;1567;15;93;2.0
4;234;1567;1582;15;93;2.0
4;235;1582;1597;15;93;2.0
4;236;1597;1612;15;93;2.0
4;237;1612;1627;15;93;2.0
4;238;1627;1642;15;93;2.0
4;239;1642;1657;15;93;2.0
4;240;1657;1672;15;93;2.0
4;241;1672;1680;8;93;2.0
5;0;245;327;82;112;2.0
5;1;327;328;1;112;2.0
5;2;328;332;4;112;2.0
5;3;332;333;1;112;2.0
5;4;333;335;2;112;2.0
5;5;335;342;7;112;2.0
5;6;342;343;1;112;2.0
5;7;343;344;1;112;2.0
5;8;344;347;3;112;2.0
5;9;347;355;8;112;2.0
5;10;355;357;2;112;2.0
5;11;357;358;1;112;2.0
5;12;358;359;1;112;2.0
5;13;359;364;5;112;2.0
5;14;364;366;2;112;2.0
5;15;366;370;4;112;2.0
5;16;370;377;7;112;2.0
5;17;377;384;7;112;2.0
5;18;384;387;3;112;2.0
5;19;387;388;1;112;2.0
5;20;388;390;2;112;2.0
5;21;390;392;2;112;2.0
5;22;392;395;3;112;2.0
5;23;395;402;7;112;2.0
5;24;402;403;1;112;2.0
5;25;403;405;2;112;2.0
5;26;405;407;2;112;2.0
5;27;407;412;5;112;2.0
5;28;412;417;5;112;2.0
5;29;417;418;1;112;2.0
5;30;418;424;6;112;2.0
5;31;424;425;1;112;2.0
5;32;425;427;2;112;2.0
5;33;427;433;6;112;2.0
5;34;433;434;1;112;2.0
5;35;434;440;6;112;2.0
5;36;440;446;6;112;2.0
5;37;446;447;1;112;2.0
5;38;447;448;1;112;2.0
5;39;448;449;1;112;2.0
5;40;449;450;1;112;2.0
5;41;450;453;3;112;2.0
5;42;453;460;7;112;2.0
5;43;460;463;3;112;2.0
5;44;463;464;1;112;2.0
5;45;464;467;3;112;2.0
5;46;467;469;2;112;2.0
5;47;469;473;4;112;2.0
5;48;473;477;4;112;2.0
5;49;477;478;1;112;2.0
5;50;478;479;1;112;2.0
5;51;479;482;3;112;2.0
5;52;482;493;11;112;2.0
5;53;493;494;1;112;2.0
5;54;494;495;1;112;2.0
5;55;495;504;9;112;2.0
5;56;504;512;8;112;2.0
5;57;512;513;1;112;2.0
5;58;513;517;4;112;2.0
5;59;517;525;8;112;2.0
5;60;525;527;2;112;2.0
5;61;527;537;10;112;2.0
5;62;537;543;6;112;2.0
5;63;543;545;2;112;2.0
5;64;545;549;4;112;2.0
5;65;549;552;3;112;2.0
5;66;552;580;28;112;2.0
5;67;580;584;4;112;2.0
5;68;584;587;3;112;2.0
5;69;587;588;1;112;2.0
5;70;588;593;5;112;2.0
5;71;593;622;29;112;2.0
5;72;622;624;2;112;2.0
5;73;624;625;1;112;2.0
5;74;625;630;5;112;2.0
5;75;630;632;2;112;2.0
5;76;632;652;20;112;2.0
5;77;652;654;2;112;2.0
5;78;654;657;3;112;2.0
5;79;657;668;11;112;2.0
5;80;668;672;4;112;2.0
5;81;672;692;20;112;2.0
5;82;692;694;2;112;2.0
5;83;694;700;6;112;2.0
5;84;700;717;17;112;2.0
5;85;717;718;1;112;2.0
5;86;718;724;6;112;2.0
5;87;724;727;3;112;2.0
5;88;727;742;15;112;2.0
5;89;742;750;8;112;2.0
5;90;750;760;10;112;2.0
5;91;760;762;2;112;2.0
5;92;762;763;1;112;2.0
5;93;763;767;4;112;2.0
5;94;767;774;7;112;2.0
5;95;774;778;4;112;2.0
5;96;778;784;6;112;2.0
5;97;784;787;3;112;2.0
5;98;787;795;8;112;2.0
5;99;795;800;5;112;2.0
5;100;800;803;3;112;2.0
5;101;803;804;1;112;2.0
5;102;804;814;10;112;2.0
5;103;814;817;3;112;2.0
5;104;817;820;3;112;2.0
5;105;820;831;11;112;2.0
5;106;831;833;2;112;2.0
5;107;833;836;3;112;2.0
5;108;836;837;1;112;2.0
5;109;837;838;1;112;2.0
5;110;838;845;7;112;2.0
5;111;845;847;2;112;2.0
5;112;847;851;4;112;2.0
5;113;851;854;3;112;2.0
5;114;854;858;4;112;2.0
5;115;858;862;4;112;2.0
5;116;862;865;3;112;2.0
5;117;865;867;2;112;2.0
5;118;867;868;1;112;2.0
5;119;868;869;1;112;2.0
5;120;869;871;2;112;2.0
5;121;871;880;9;112;2.0
5;122;880;884;4;112;2.0
5;123;884;886;2;112;2.0
5;124;886;887;1;112;2.0
5;125;887;888;1;112;2.0
5;126;888;894;6;112;2.0
5;127;894;900;6;112;2.0
5;128;900;902;2;112;2.0
5;129;902;903;1;112;2.0
5;130;903;906;3;112;2.0
5;131;906;911;5;112;2.0
5;132;911;915;4;112;2.0
5;133;915;917;2;112;2.0
5;134;917;924;7;112;2.0
5;135;924;927;3;112;2.0
5;136;927;931;4;112;2.0
5;137;931;935;4;112;2.0
5;138;935;937;2;112;2.0
5;139;937;938;1;112;2.0
5;140;938;939;1;112;2.0
5;141;939;940;1;112;2.0
5;142;940;946;6;112;2.0
5;143;946;954;8;112;2.0
5;144;954;955;1;112;2.0
5;145;955;957;2;112;2.0
5;146;957;958;1;112;2.0
5;147;958;965;7;112;2.0
5;148;965;966;1;112;2.0
5;149;966;974;8;112;2.0
5;150;974;975;1;112;2.0
5;151;975;977;2;112;2.0
5;152;977;978;1;112;2.0
5;153;978;981;3;112;2.0
5;154;981;991;10;112;2.0
5;155;991;993;2;112;2.0
5;156;993;995;2;112;2.0
5;157;995;997;2;112;2.0
5;158;997;999;2;112;2.0
5;159;999;1000;1;112;2.0
5;160;1000;1011;11;112;2.0
5;161;1011;1014;3;112;2.0
5;162;1014;1017;3;112;2.0
5;163;1017;1022;5;112;2.0
5;164;1022;1025;3;112;2.0
5;165;1025;1030;5;112;2.0
5;166;1030;1031;1;112;2.0
5;167;1031;1043;12;112;2.0
5;168;1043;1045;2;112;2.0
5;169;1045;1047;2;112;2.0
5;170;1047;1054;7;112;2.0
5;171;1054;1055;1;112;2.0
5;172;1055;1057;2;112;2.0
5;173;1057;1065;8;112;2.0
5;174;1065;1072;7;112;2.0
5;175;1072;1077;5;112;2.0
5;176;1077;1078;1;112;2.0
5;177;1078;1080;2;112;2.0
5;178;1080;1083;3;112;2.0
5;179;1083;1084;1;112;2.0
5;180;1084;1085;1;112;2.0
5;181;1085;1093;8;112;2.0
5;182;1093;1098;5;112;2.0
5;183;1098;1101;3;112;2.0
5;184;1101;1105;4;112;2.0
5;185;1105;1106;1;112;2.0
5;186;1106;1110;4;112;2.0
5;187;1110;1120;10;112;2.0
5;188;1120;1133;13;112;2.0
5;189;1133;1134;1;112;2.0
5;190;1134;1140;6;112;2.0
5;191;1140;1144;4;112;2.0
5;192;1144;1152;8;112;2.0
5;193;1152;1170;18;112;2.0
5;194;1170;1171;1;112;2.0
5;195;1171;1173;2;112;2.0
5;196;1173;1180;7;112;2.0
5;197;1180;1196;16;112;2.0
5;198;1196;1204;8;112;2.0
5;199;1204;1207;3;112;2.0
5;200;1207;1208;1;112;2.0
5;201;1208;1221;13;112;2.0
5;202;1221;1230;9;112;2.0
5;203;1230;1255;25;112;2.0
5;204;1255;1259;4;112;2.0
5;205;1259;1264;5;112;2.0
5;206;1264;1265;1;112;2.0
5;207;1265;1268;3;112;2.0
5;208;1268;1281;13;112;2.0
5;209;1281;1290;9;112;2.0
5;210;1290;1295;5;112;2.0
5;211;1295;1314;19;112;2.0
5;212;1314;1319;5;112;2.0
5;213;1319;1322;3;112;2.0
5;214;1322;1333;11;112;2.0
5;215;1333;1340;7;112;2.0
5;216;1340;1356;16;112;2.0
5;217;1356;1357;1;112;2.0
5;218;1357;1359;2;112;2.0
5;219;1359;1363;4;112;2.0
5;220;1363;1366;3;112;2.0
5;221;1366;1367;1;112;2.0
5;222;1367;1373;6;112;2.0
5;223;1373;1378;5;112;2.0
5;224;1378;1381;3;112;2.0
5;225;1381;1386;5;112;2.0
5;226;1386;1401;15;112;2.0
5;227;1401;1416;15;112;2.0
5;228;1416;1431;15;112;2.0
5;229;1431;1446;15;112;2.0
5;230;1446;1461;15;112;2.0
5;231;1461;1476;15;112;2.0
5;232;1476;1491;15;112;2.0
5;233;1491;1506;15;112;2.0
5;234;1506;1521;15;112;2.0
5;235;1521;1536;15;112;2.0
5;236;1536;1551;15;112;2.0
5;237;1551;1566;15;112;2.0
5;238;1566;1581;15;112;2.0
5;239;1581;1596;15;112;2.0
5;240;1596;1611;15;112;2.0
5;241;1611;1626;15;112;2.0
5;242;1626;1641;15;112;2.0
5;243;1641;1656;15;112;2.0
5;244;1656;1671;15;112;2.0
5;245;1671;1680;9;112;2.0
6;0;245;327;82;112;2.0
6;1;327;328;1;112;2.0
6;2;328;332;4;112;2.0
6;3;332;333;1;112;2.0
6;4;333;335;2;112;2.0
6;5;335;342;7;112;2.0
6;6;342;343;1;112;2.0
6;7;343;344;1;112;2.0
6;8;344;347;3;112;2.0
6;9;347;355;8;112;2.0
6;10;355;357;2;112;2.0
6;11;357;358;1;112;2.0
6;12;358;359;1;112;2.0
6;13;359;364;5;112;2.0
6;14;364;366;2;112;2.0
6;15;366;370;4;112;2.0
6;16;370;377;7;112;2.0
6;17;377;384;7;112;2.0
6;18;384;387;3;112;2.0
6;19;387;388;1;112;2.0
6;20;388;390;2;112;2.0
6;21;390;392;2;112;2.0
6;22;392;395;3;112;2.0
6;23;395;402;7;112;2.0
6;24;402;403;1;112;2.0
6;25;403;405;2;112;2.0
6;26;405;407;2;112;2.0
6;27;407;412;5;112;2.0
6;28;412;417;5;112;2.0
6;29;417;418;1;112;2.0
6;30;418;424;6;112;2.0
6;31;424;425;1;112;2.0
6;32;425;427;2;112;2.0
6;33;427;433;6;112;2.0
6;34;433;434;1;112;2.0
6;35;434;440;6;112;2.0
6;36;440;446;6;112;2.0
6;37;446;447;1;112;2.0
6;38;447;448;1;112;2.0
6;39;448;449;1;112;2.0
6;40;449;450;1;112;2.0
6;41;450;453;3;112;2.0
6;42;453;460;7;112;2.0
6;43;460;463;3;112;2.0
6;44;463;464;1;112;2.0
6;45;464;467;3;112;2.0
6;46;467;469;2;112;2.0
6;47;469;473;4;112;2.0
6;48;473;477;4;112;2.0
6;49;477;478;1;112;2.0
6;50;478;479;1;112;2.0
6;51;479;482;3;112;2.0
6;52;482;493;11;112;2.0
6;53;493;494;1;112;2.0
6;54;494;495;1;112;2.0
6;55;495;504;9;112;2.0
6;56;504;512;8;112;2.0
6;57;512;513;1;112;2.0
6;58;513;517;4;112;2.0
6;59;517;525;8;112;2.0
6;60;525;527;2;112;2.0
6;61;527;537;10;112;2.0
6;62;537;543;6;112;2.0
6;63;543;545;2;112;2.0
6;64;545;549;4;112;2.0
6;65;549;552;3;112;2.0
6;66;552;580;28;112;2.0
6;67;580;584;4;112;2.0
6;68;584;587;3;112;2.0
6;69;587;588;1;112;2.0
6;70;588;593;5;112;2.0
6;71;593;622;29;112;2.0
6;72;622;624;2;112;2.0
6;73;624;625;1;112;2.0
6;74;625;630;5;112;2.0
6;75;630;632;2;112;2.0
6;76;632;652;20;112;2.0
6;77;652;654;2;112;2.0
6;78;654;657;3;112;2.0
6;79;657;668;11;112;2.0
6;80;668;672;4;112;2.0
6;81;672;692;20;112;2.0
6;82;692;694;2;112;2.0
6;83;694;700;6;112;2.0
6;84;700;717;17;112;2.0
6;85;717;718;1;112;2.0
6;86;718;724;6;112;2.0
6;87;724;727;3;112;2.0
6;88;727;742;15;112;2.0
6;89;742;750;8;112;2.0
6;90;750;760;10;112;2.0
6;91;760;762;2;112;2.0
6;92;762;763;1;112;2.0
6;93;763;767;4;112;2.0
6;94;767;774;7;112;2.0
6;95;774;778;4;112;2.0
6;96;778;784;6;112;2.0
6;97;784;787;3;112;2.0
6;98;787;795;8;112;2.0
6;99;795;800;5;112;2.0
6;100;800;803;3;112;2.0
6;101;803;804;1;112;2.0
6;102;804;814;10;112;2.0
6;103;814;817;3;112;2.0
6;104;817;820;3;112;2.0
6;105;820;831;11;112;2.0
6;106;831;833;2;112;2.0
6;107;833;836;3;112;2.0
6;108;836;837;1;112;2.0
6;109;837;838;1;112;2.0
6;110;838;845;7;112;2.0
6;111;845;847;2;112;2.0
6;112;847;851;4;112;2.0
6;113;851;854;3;112;2.0
6;114;854;858;4;112;2.0
6;115;858;862;4;112;2.0
6;116;862;865;3;112;2.0
6;117;865;867;2;112;2.0
6;118;867;868;1;112;2.0
6;119;868;869;1;112;2.0
6;120;869;871;2;112;2.0
6;121;871;880;9;112;2.0
6;122;880;884;4;112;2.0
6;123;884;886;2;112;2.0
6;124;886;887;1;112;2.0
6;125;887;888;1;112;2.0
6;126;888;894;6;112;2.0
6;127;894;900;6;112;2.0
6;128;900;902;2;112;2.0
6;129;902;903;1;112;2.0
6;130;903;906;3;112;2.0
6;131;906;911;5;112;2.0
6;132;911;915;4;112;2.0
6;133;915;917;2;112;2.0
6;134;917;924;7;112;2.0
6;135;924;927;3;112;2.0
6;136;927;931;4;112;2.0
6;137;931;935;4;112;2.0
6;138;935;937;2;112;2.0
6;139;937;938;1;112;2.0
6;140;938;939;1;112;2.0
6;141;939;940;1;112;2.0
6;142;940;946;6;112;2.0
6;143;946;954;8;112;2.0
6;144;954;955;1;112;2.0
6;145;955;957;2;112;2.0
6;146;957;958;1;112;2.0
6;147;958;965;7;112;2.0
6;148;965;966;1;112;2.0
6;149;966;974;8;112;2.0
6;150;974;975;1;112;2.0
6;151;975;977;2;112;2.0
6;152;977;978;1;112;2.0
6;153;978;981;3;112;2.0
6;154;981;991;10;112;2.0
6;155;991;993;2;112;2.0
6;156;993;995;2;112;2.0
6;157;995;997;2;112;2.0
6;158;997;999;2;112;2.0
6;159;999;1000;1;112;2.0
6;160;1000;1011;11;112;2.0
6;161;1011;1014;3;112;2.0
6;162;1014;1017;3;112;2.0
6;163;1017;1022;5;112;2.0
6;164;1022;1025;3;112;2.0
6;165;1025;1030;5;112;2.0
6;166;1030;1031;1;112;2.0
6;167;1031;1043;12;112;2.0
6;168;1043;1045;2;112;2.0
6;169;1045;1047;2;112;2.0
6;170;1047;1054;7;112;2.0
6;171;1054;1055;1;112;2.0
6;172;1055;1057;2;112;2.0
6;173;1057;1065;8;112;2.0
6;174;1065;1072;7;112;2.0
6;175;1072;1077;5;112;2.0
6;176;1077;1078;1;112;2.0
6;177;1078;1080;2;112;2.0
6;178;1080;1083;3;112;2.0
6;179;1083;1084;1;112;2.0
6;180;1084;1085;1;112;2.0
6;181;1085;1093;8;112;2.0
6;182;1093;1098;5;112;2.0
6;183;1098;1101;3;112;2.0
6;184;1101;1105;4;112;2.0
6;185;1105;1106;1;112;2.0
6;186;1106;1110;4;112;2.0
6;187;1110;1120;10;112;2.0
6;188;1120;1133;13;112;2.0
6;189;1133;1134;1;112;2.0
6;190;1134;1140;6;112;2.0
6;191;1140;1144;4;112;2.0
6;192;1144;1152;8;112;2.0
6;193;1152;1170;18;112;2.0
6;194;1170;1171;1;112;2.0
6;195;1171;1173;2;112;2.0
6;196;1173;1180;7;112;2.0
6;197;1180;1196;16;112;2.0
6;198;1196;1204;8;112;2.0
6;199;1204;1207;3;112;2.0
6;200;1207;1208;1;112;2.0
6;201;1208;1221;13;112;2.0
6;202;1221;1230;9;112;2.0
6;203;1230;1255;25;112;2.0
6;204;1255;1259;4;112;2.0
6;205;1259;1264;5;112;2.0
6;206;1264;1265;1;112;2.0
6;207;1265;1268;3;112;2.0
6;208;1268;1281;13;112;2.0
6;209;1281;1290;9;112;2.0
6;210;1290;1295;5;112;2.0
6;211;1295;1314;19;112;2.0
6;212;1314;1319;5;112;2.0
6;213;1319;1322;3;112;2.0
6;214;1322;1333;11;112;2.0
6;215;1333;1340;7;112;2.0
6;216;1340;1356;16;112;2.0
6;217;1356;1357;1;112;2.0
6;218;1357;1359;2;112;2.0
6;219;1359;1363;4;112;2.0
6;220;1363;1366;3;112;2.0
6;221;1366;1367;1;112;2.0
6;222;1367;1373;6;112;2.0
6;223;1373;1378;5;112;2.0
6;224;1378;1381;3;112;2.0
6;225;1381;1386;5;112;2.0
6;226;1386;1401;15;112;2.0
6;227;1401;1416;15;112;2.0
6;228;1416;1431;15;112;2.0
6;229;1431;1446;15;112;2.0
6;230;1446;1461;15;112;2.0
6;231;1461;1476;15;112;2.0
6;232;1476;1491;15;112;2.0
6;233;1491;1506;15;112;2.0
6;234;1506;1521;15;112;2.0
6;235;1521;1536;15;112;2.0
6;236;1536;1551;15;112;2.0
6;237;1551;1566;15;112;2.0
6;238;1566;1581;15;112;2.0
6;239;1581;1596;15;112;2.0
6;240;1596;1611;15;112;2.0
6;241;1611;1626;15;112;2.0
6;242;1626;1641;15;112;2.0
6;243;1641;1656;15;112;2.0
6;244;1656;1671;15;112;2.0
6;245;1671;1680;9;112;2.0
7;0;240;331;91;28;0.83
7;1;331;333;2;28;0.83
7;2;333;334;1;28;0.83
7;3;334;345;11;28;0.83
7;4;345;346;1;28;0.83
7;5;346;348;2;28;0.83
7;6;348;353;5;28;0.83
7;7;353;358;5;28;0.83
7;8;358;360;2;28;0.83
7;9;360;361;1;28;0.83
7;10;361;365;4;28;0.83
7;11;365;367;2;28;0.83
7;12;367;368;1;28;0.83
7;13;368;381;13;28;0.83
7;14;381;385;4;28;0.83
7;15;385;388;3;28;0.83
7;16;388;391;3;28;0.83
7;17;391;396;5;28;0.83
7;18;396;403;7;28;0.83
7;19;403;404;1;28;0.83
7;20;404;406;2;28;0.83
7;21;406;408;2;28;0.83
7;22;408;416;8;28;0.83
7;23;416;418;2;28;0.83
7;24;418;421;3;28;0.83
7;25;421;423;2;28;0.83
7;26;423;425;2;28;0.83
7;27;425;428;3;28;0.83
7;28;428;435;7;28;0.83
7;29;435;436;1;28;0.83
7;30;436;438;2;28;0.83
7;31;438;447;9;28;0.83
7;32;447;448;1;28;0.83
7;33;448;450;2;28;0.83
7;34;450;451;1;28;0.83
7;35;451;453;2;28;0.83
7;36;453;458;5;28;0.83
7;37;458;463;5;28;0.83
7;38;463;465;2;28;0.83
7;39;465;466;1;28;0.83
7;40;466;467;1;28;0.83
7;41;467;468;1;28;0.83
7;42;468;473;5;28;0.83
7;43;473;478;5;28;0.83
7;44;478;480;2;28;0.83
7;45;480;481;1;28;0.83
7;46;481;482;1;28;0.83
7;47;482;483;1;28;0.83
7;48;483;493;10;28;0.83
7;49;493;494;1;28;0.83
7;50;494;496;2;28;0.83
7;51;496;504;8;28;0.83
7;52;504;505;1;28;0.83
7;53;505;513;8;28;0.83
7;54;513;518;5;28;0.83
7;55;518;523;5;28;0.83
7;56;523;525;2;28;0.83
7;57;525;531;6;28;0.83
7;58;531;537;6;28;0.83
7;59;537;543;6;28;0.83
7;60;543;548;5;28;0.83
7;61;548;549;1;28;0.83
7;62;549;550;1;28;0.83
7;63;550;553;3;28;0.83
7;64;553;578;25;28;0.83
7;65;578;585;7;28;0.83
7;66;585;588;3;28;0.83
7;67;588;591;3;28;0.83
7;68;591;593;2;28;0.83
7;69;593;623;30;28;0.83
7;70;623;625;2;28;0.83
7;71;625;628;3;28;0.83
7;72;628;633;5;28;0.83
7;73;633;655;22;28;0.83
7;74;655;656;1;28;0.83
7;75;656;658;2;28;0.83
7;76;658;671;13;28;0.83
7;77;671;673;2;28;0.83
7;78;673;693;20;28;0.83
7;79;693;695;2;28;0.83
7;80;695;698;3;28;0.83
7;81;698;718;20;28;0.83
7;82;718;721;3;28;0.83
7;83;721;725;4;28;0.83
7;84;725;728;3;28;0.83
7;85;728;746;18;28;0.83
7;86;746;748;2;28;0.83
7;87;748;758;10;28;0.83
7;88;758;763;5;28;0.83
7;89;763;766;3;28;0.83
7;90;766;768;2;28;0.83
7;91;768;775;7;28;0.83
7;92;775;778;3;28;0.83
7;93;778;784;6;28;0.83
7;94;784;788;4;28;0.83
7;95;788;793;5;28;0.83
7;96;793;798;5;28;0.83
7;97;798;805;7;28;0.83
7;98;805;806;1;28;0.83
7;99;806;814;8;28;0.83
7;100;814;818;4;28;0.83
7;101;818;821;3;28;0.83
7;102;821;832;11;28;0.83
7;103;832;833;1;28;0.83
7;104;833;837;4;28;0.83
7;105;837;838;1;28;0.83
7;106;838;841;3;28;0.83
7;107;841;843;2;28;0.83
7;108;843;848;5;28;0.83
7;109;848;852;4;28;0.83
7;110;852;855;3;28;0.83
7;111;855;861;6;28;0.83
7;112;861;863;2;28;0.83
7;113;863;870;7;28;0.83
7;114;870;871;1;28;0.83
7;115;871;872;1;28;0.83
7;116;872;878;6;28;0.83
7;117;878;883;5;28;0.83
7;118;883;885;2;28;0.83
7;119;885;887;2;28;0.83
7;120;887;888;1;28;0.83
7;121;888;895;7;28;0.83
7;122;895;898;3;28;0.83
7;123;898;903;5;28;0.83
7;124;903;907;4;28;0.83
7;125;907;912;5;28;0.83
7;126;912;913;1;28;0.83
7;127;913;918;5;28;0.83
7;128;918;925;7;28;0.83
7;129;925;931;6;28;0.83
7;130;931;932;1;28;0.83
7;131;932;938;6;28;0.83
7;132;938;940;2;28;0.83
7;133;940;947;7;28;0.83
7;134;947;953;6;28;0.83
7;135;953;955;2;28;0.83
7;136;955;958;3;28;0.83
7;137;958;966;8;28;0.83
7;138;966;967;1;28;0.83
7;139;967;968;1;28;0.83
7;140;968;973;5;28;0.83
7;141;973;975;2;28;0.83
7;142;975;978;3;28;0.83
7;143;978;981;3;28;0.83
7;144;981;992;11;28;0.83
7;145;992;993;1;28;0.83
7;146;993;998;5;28;0.83
7;147;998;1000;2;28;0.83
7;148;1000;1003;3;28;0.83
7;149;1003;1011;8;28;0.83
7;150;1011;1014;3;28;0.83
7;151;1014;1015;1;28;0.83
7;152;1015;1018;3;28;0.83
7;153;1018;1021;3;28;0.83
7;154;1021;1023;2;28;0.83
7;155;1023;1032;9;28;0.83
7;156;1032;1033;1;28;0.83
7;157;1033;1043;10;28;0.83
7;158;1043;1044;1;28;0.83
7;159;1044;1045;1;28;0.83
7;160;1045;1055;10;28;0.83
7;161;1055;1058;3;28;0.83
7;162;1058;1063;5;28;0.83
7;163;1063;1076;13;28;0.83
7;164;1076;1078;2;28;0.83
7;165;1078;1083;5;28;0.83
7;166;1083;1085;2;28;0.83
7;167;1085;1094;9;28;0.83
7;168;1094;1098;4;28;0.83
7;169;1098;1101;3;28;0.83
7;170;1101;1103;2;28;0.83
7;171;1103;1109;6;28;0.83
7;172;1109;1111;2;28;0.83
7;173;1111;1121;10;28;0.83
7;174;1121;1134;13;28;0.83
7;175;1134;1137;3;28;0.83
7;176;1137;1141;4;28;0.83
7;177;1141;1142;1;28;0.83
7;178;1142;1152;10;28;0.83
7;179;1152;1171;19;28;0.83
7;180;1171;1174;3;28;0.83
7;181;1174;1181;7;28;0.83
7;182;1181;1199;18;28;0.83
7;183;1199;1202;3;28;0.83
7;184;1202;1205;3;28;0.83
7;185;1205;1209;4;28;0.83
7;186;1209;1221;12;28;0.83
7;187;1221;1231;10;28;0.83
7;188;1231;1256;25;28;0.83
7;189;1256;1262;6;28;0.83
7;190;1262;1263;1;28;0.83
7;191;1263;1269;6;28;0.83
7;192;1269;1281;12;28;0.83
7;193;1281;1291;10;28;0.83
7;194;1291;1296;5;28;0.83
7;195;1296;1312;16;28;0.83
7;196;1312;1322;10;28;0.83
7;197;1322;1323;1;28;0.83
7;198;1323;1337;14;28;0.83
7;199;1337;1341;4;28;0.83
7;200;1341;1357;16;28;0.83
7;201;1357;1360;3;28;0.83
7;202;1360;1363;3;28;0.83
7;203;1363;1365;2;28;0.83
7;204;1365;1366;1;28;0.83
7;205;1366;1374;8;28;0.83
7;206;1374;1376;2;28;0.83
7;207;1376;1379;3;28;0.83
7;208;1379;1386;7;28;0.83
7;209;1386;1401;15;28;0.83
7;210;1401;1416;15;28;0.83
7;211;1416;1431;15;28;0.83
7;212;1431;1446;15;28;0.83
7;213;1446;1461;15;28;0.83
7;214;1461;1476;15;28;0.83
7;215;1476;1491;15;28;0.83
7;216;1491;1506;15;28;0.83
7;217;1506;1521;15;28;0.83
7;218;1521;1536;15;28;0.83
7;219;1536;1551;15;28;0.83
7;220;1551;1566;15;28;0.83
7;221;1566;1581;15;28;0.83
7;222;1581;1596;15;28;0.83
7;223;1596;1611;15;28;0.83
7;224;1611;1626;15;28;0.83
7;225;1626;1641;15;28;0.83
7;226;1641;1656;15;28;0.83
7;227;1656;1671;15;28;0.83
7;228;1671;1680;9;28;0.83
8;0;240;331;91;28;0.83
8;1;331;333;2;28;0.83
8;2;333;334;1;28;0.83
8;3;334;345;11;28;0.83
8;4;345;346;1;28;0.83
8;5;346;348;2;28;0.83
8;6;348;353;5;28;0.83
8;7;353;358;5;28;0.83
8;8;358;360;2;28;0.83
8;9;360;361;1;28;0.83
8;10;361;365;4;28;0.83
8;11;365;367;2;28;0.83
8;12;367;368;1;28;0.83
8;13;368;381;13;28;0.83
8;14;381;385;4;28;0.83
8;15;385;388;3;28;0.83
8;16;388;391;3;28;0.83
8;17;391;396;5;28;0.83
8;18;396;403;7;28;0.83
8;19;403;404;1;28;0.83
8;20;404;406;2;28;0.83
8;21;406;408;2;28;0.83
8;22;408;416;8;28;0.83
8;23;416;418;2;28;0.83
8;24;418;421;3;28;0.83
8;25;421;423;2;28;0.83
8;26;423;425;2;28;0.83
8;27;425;428;3;28;0.83
8;28;428;435;7;28;0.83
8;29;435;436;1;28;0.83
8;30;436;438;2;28;0.83
8;31;438;447;9;28;0.83
8;32;447;448;1;28;0.83
8;33;448;450;2;28;0.83
8;34;450;451;1;28;0.83
8;35;451;453;2;28;0.83
8;36;453;458;5;28;0.83
8;37;458;463;5;28;0.83
8;38;463;465;2;28;0.83
8;39;465;466;1;28;0.83
8;40;466;467;1;28;0.83
8;41;467;468;1;28;0.83
8;42;468;473;5;28;0.83
8;43;473;478;5;28;0.83
8;44;478;480;2;28;0.83
8;45;480;481;1;28;0.83
8;46;481;482;1;28;0.83
8;47;482;483;1;28;0.83
8;48;483;493;10;28;0.83
8;49;493;494;1;28;0.83
8;50;494;496;2;28;0.83
8;51;496;504;8;28;0.83
8;52;504;505;1;28;0.83
8;53;505;513;8;28;0.83
8;54;513;518;5;28;0.83
8;55;518;523;5;28;0.83
8;56;523;525;2;28;0.83
8;57;525;531;6;28;0.83
8;58;531;537;6;28;0.83
8;59;537;543;6;28;0.83
8;60;543;548;5;28;0.83
8;61;548;549;1;28;0.83
8;62;549;550;1;28;0.83
8;63;550;553;3;28;0.83
8;64;553;578;25;28;0.83
8;65;578;585;7;28;0.83
8;66;585;588;3;28;0.83
8;67;588;591;3;28;0.83
8;68;591;593;2;28;0.83
8;69;593;623;30;28;0.83
8;70;623;625;2;28;0.83
8;71;625;628;3;28;0.83
8;72;628;633;5;28;0.83
8;73;633;655;22;28;0.83
8;74;655;656;1;28;0.83
8;75;656;658;2;28;0.83
8;76;658;671;13;28;0.83
8;77;671;673;2;28;0.83
8;78;673;693;20;28;0.83
8;79;693;695;2;28;0.83
8;80;695;698;3;28;0.83
8;81;698;718;20;28;0.83
8;82;718;721;3;28;0.83
8;83;721;725;4;28;0.83
8;84;725;728;3;28;0.83
8;85;728;746;18;28;0.83
8;86;746;748;2;28;0.83
8;87;748;758;10;28;0.83
8;88;758;763;5;28;0.83
8;89;763;766;3;28;0.83
8;90;766;768;2;28;0.83
8;91;768;775;7;28;0.83
8;92;775;778;3;28;0.83
8;93;778;784;6;28;0.83
8;94;784;788;4;28;0.83
8;95;788;793;5;28;0.83
8;96;793;798;5;28;0.83
8;97;798;805;7;28;0.83
8;98;805;806;1;28;0.83
8;99;806;814;8;28;0.83
8;100;814;818;4;28;0.83
8;101;818;821;3;28;0.83
8;102;821;832;11;28;0.83
8;103;832;833;1;28;0.83
8;104;833;837;4;28;0.83
8;105;837;838;1;28;0.83
8;106;838;841;3;28;0.83
8;107;841;843;2;28;0.83
8;108;843;848;5;28;0.83
8;109;848;852;4;28;0.83
8;110;852;855;3;28;0.83
8;111;855;861;6;28;0.83
8;112;861;863;2;28;0.83
8;113;863;870;7;28;0.83
8;114;870;871;1;28;0.83
8;115;871;872;1;28;0.83
8;116;872;878;6;28;0.83
8;117;878;883;5;28;0.83
8;118;883;885;2;28;0.83
8;119;885;887;2;28;0.83
8;120;887;888;1;28;0.83
8;121;888;895;7;28;0.83
8;122;895;898;3;28;0.83
8;123;898;903;5;28;0.83
8;124;903;907;4;28;0.83
8;125;907;912;5;28;0.83
8;126;912;913;1;28;0.83
8;127;913;918;5;28;0.83
8;128;918;925;7;28;0.83
8;129;925;931;6;28;0.83
8;130;931;932;1;28;0.83
8;131;932;938;6;28;0.83
8;132;938;940;2;28;0.83
8;133;940;947;7;28;0.83
8;134;947;953;6;28;0.83
8;135;953;955;2;28;0.83
8;136;955;958;3;28;0.83
8;137;958;966;8;28;0.83
8;138;966;967;1;28;0.83
8;139;967;968;1;28;0.83
8;140;968;973;5;28;0.83
8;141;973;975;2;28;0.83
8;142;975;978;3;28;0.83
8;143;978;981;3;28;0.83
8;144;981;992;11;28;0.83
8;145;992;993;1;28;0.83
8;146;993;998;5;28;0.83
8;147;998;1000;2;28;0.83
8;148;1000;1003;3;28;0.83
8;149;1003;1011;8;28;0.83
8;150;1011;1014;3;28;0.83
8;151;1014;1015;1;28;0.83
8;152;1015;1018;3;28;0.83
8;153;1018;1021;3;28;0.83
8;154;1021;1023;2;28;0.83
8;155;1023;1032;9;28;0.83
8;156;1032;1033;1;28;0.83
8;157;1033;1043;10;28;0.83
8;158;1043;1044;1;28;0.83
8;159;1044;1045;1;28;0.83
8;160;1045;1055;10;28;0.83
8;161;1055;1058;3;28;0.83
8;162;1058;1063;5;28;0.83
8;163;1063;1076;13;28;0.83
8;164;1076;1078;2;28;0.83
8;165;1078;1083;5;28;0.83
8;166;1083;1085;2;28;0.83
8;167;1085;1094;9;28;0.83
8;168;1094;1098;4;28;0.83
8;169;1098;1101;3;28;0.83
8;170;1101;1103;2;28;0.83
8;171;1103;1109;6;28;0.83
8;172;1109;1111;2;28;0.83
8;173;1111;1121;10;28;0.83
8;174;1121;1134;13;28;0.83
8;175;1134;1137;3;28;0.83
8;176;1137;1141;4;28;0.83
8;177;1141;1142;1;28;0.83
8;178;1142;1152;10;28;0.83
8;179;1152;1171;19;28;0.83
8;180;1171;1174;3;28;0.83
8;181;1174;1181;7;28;0.83
8;182;1181;1199;18;28;0.83
8;183;1199;1202;3;28;0.83
8;184;1202;1205;3;28;0.83
8;185;1205;1209;4;28;0.83
8;186;1209;1221;12;28;0.83
8;187;1221;1231;10;28;0.83
8;188;1231;1256;25;28;0.83
8;189;1256;1262;6;28;0.83
8;190;1262;1263;1;28;0.83
8;191;1263;1269;6;28;0.83
8;192;1269;1281;12;28;0.83
8;193;1281;1291;10;28;0.83
8;194;1291;1296;5;28;0.83
8;195;1296;1312;16;28;0.83
8;196;1312;1322;10;28;0.83
8;197;1322;1323;1;28;0.83
8;198;1323;1337;14;28;0.83
8;199;1337;1341;4;28;0.83
8;200;1341;1357;16;28;0.83
8;201;1357;1360;3;28;0.83
8;202;1360;1363;3;28;0.83
8;203;1363;1365;2;28;0.83
8;204;1365;1366;1;28;0.83
8;205;1366;1374;8;28;0.83
8;206;1374;1376;2;28;0.83
8;207;1376;1379;3;28;0.83
8;208;1379;1386;7;28;0.83
8;209;1386;1401;15;28;0.83
8;210;1401;1416;15;28;0.83
8;211;1416;1431;15;28;0.83
8;212;1431;1446;15;28;0.83
8;213;1446;1461;15;28;0.83
8;214;1461;1476;15;28;0.83
8;215;1476;1491;15;28;0.83
8;216;1491;1506;15;28;0.83
8;217;1506;1521;15;28;0.83
8;218;1521;1536;15;28;0.83
8;219;1536;1551;15;28;0.83
8;220;1551;1566;15;28;0.83
8;221;1566;1581;15;28;0.83
8;222;1581;1596;15;28;0.83
8;223;1596;1611;15;28;0.83
8;224;1611;1626;15;28;0.83
8;225;1626;1641;15;28;0.83
8;226;1641;1656;15;28;0.83
8;227;1656;1671;15;28;0.83
8;228;1671;1680;9;28;0.83
9;0;240;331;91;28;0.83
9;1;331;333;2;28;0.83
9;2;333;334;1;28;0.83
9;3;334;345;11;28;0.83
9;4;345;346;1;28;0.83
9;5;346;348;2;28;0.83
9;6;348;353;5;28;0.83
9;7;353;358;5;28;0.83
9;8;358;360;2;28;0.83
9;9;360;361;1;28;0.83
9;10;361;365;4;28;0.83
9;11;365;367;2;28;0.83
9;12;367;368;1;28;0.83
9;13;368;381;13;28;0.83
9;14;381;385;4;28;0.83
9;15;385;388;3;28;0.83
9;16;388;391;3;28;0.83
9;17;391;396;5;28;0.83
9;18;396;403;7;28;0.83
9;19;403;404;1;28;0.83
9;20;404;406;2;28;0.83
9;21;406;408;2;28;0.83
9;22;408;416;8;28;0.83
9;23;416;418;2;28;0.83
9;24;418;421;3;28;0.83
9;25;421;423;2;28;0.83
9;26;423;425;2;28;0.83
9;27;425;428;3;28;0.83
9;28;428;435;7;28;0.83
9;29;435;436;1;28;0.83
9;30;436;438;2;28;0.83
9;31;438;447;9;28;0.83
9;32;447;448;1;28;0.83
9;33;448;450;2;28;0.83
9;34;450;451;1;28;0.83
9;35;451;453;2;28;0.83
9;36;453;458;5;28;0.83
9;37;458;463;5;28;0.83
9;38;463;465;2;28;0.83
9;39;465;466;1;28;0.83
9;40;466;467;1;28;0.83
9;41;467;468;1;28;0.83
9;42;468;473;5;28;0.83
9;43;473;478;5;28;0.83
9;44;478;480;2;28;0.83
9;45;480;481;1;28;0.83
9;46;481;482;1;28;0.83
9;47;482;483;1;28;0.83
9;48;483;493;10;28;0.83
9;49;493;494;1;28;0.83
9;50;494;496;2;28;0.83
9;51;496;504;8;28;0.83
9;52;504;505;1;28;0.83
9;53;505;513;8;28;0.83
9;54;513;518;5;28;0.83
9;55;518;523;5;28;0.83
9;56;523;525;2;28;0.83
9;57;525;531;6;28;0.83
9;58;531;537;6;28;0.83
9;59;537;543;6;28;0.83
9;60;543;548;5;28;0.83
9;61;548;549;1;28;0.83
9;62;549;550;1;28;0.83
9;63;550;553;3;28;0.83
9;64;553;578;25;28;0.83
9;65;578;585;7;28;0.83
9;66;585;588;3;28;0.83
9;67;588;591;3;28;0.83
9;68;591;593;2;28;0.83
9;69;593;623;30;28;0.83
9;70;623;625;2;28;0.83
9;71;625;628;3;28;0.83
9;72;628;633;5;28;0.83
9;73;633;655;22;28;0.83
9;74;655;656;1;28;0.83
9;75;656;658;2;28;0.83
9;76;658;671;13;28;0.83
9;77;671;673;2;28;0.83
9;78;673;693;20;28;0.83
9;79;693;695;2;28;0.83
9;80;695;698;3;28;0.83
9;81;698;718;20;28;0.83
9;82;718;721;3;28;0.83
9;83;721;725;4;28;0.83
9;84;725;728;3;28;0.83
9;85;728;746;18;28;0.83
9;86;746;748;2;28;0.83
9;87;748;758;10;28;0.83
9;88;758;763;5;28;0.83
9;89;763;766;3;28;0.83
9;90;766;768;2;28;0.83
9;91;768;775;7;28;0.83
9;92;775;778;3;28;0.83
9;93;778;784;6;28;0.83
9;94;784;788;4;28;0.83
9;95;788;793;5;28;0.83
9;96;793;798;5;28;0.83
9;97;798;805;7;28;0.83
9;98;805;806;1;28;0.83
9;99;806;814;8;28;0.83
9;100;814;818;4;28;0.83
9;101;818;821;3;28;0.83
9;102;821;832;11;28;0.83
9;103;832;833;1;28;0.83
9;104;833;837;4;28;0.83
9;105;837;838;1;28;0.83
9;106;838;841;3;28;0.83
9;107;841;843;2;28;0.83
9;108;843;848;5;28;0.83
9;109;848;852;4;28;0.83
9;110;852;855;3;28;0.83
9;111;855;861;6;28;0.83
9;112;861;863;2;28;0.83
9;113;863;870;7;28;0.83
9;114;870;871;1;28;0.83
9;115;871;872;1;28;0.83
9;116;872;878;6;28;0.83
9;117;878;883;5;28;0.83
9;118;883;885;2;28;0.83
9;119;885;887;2;28;0.83
9;120;887;888;1;28;0.83
9;121;888;895;7;28;0.83
9;122;895;898;3;28;0.83
9;123;898;903;5;28;0.83
9;124;903;907;4;28;0.83
9;125;907;912;5;28;0.83
9;126;912;913;1;28;0.83
9;127;913;918;5;28;0.83
9;128;918;925;7;28;0.83
9;129;925;931;6;28;0.83
9;130;931;932;1;28;0.83
9;131;932;938;6;28;0.83
9;132;938;940;2;28;0.83
9;133;940;947;7;28;0.83
9;134;947;953;6;28;0.83
9;135;953;955;2;28;0.83
9;136;955;958;3;28;0.83
9;137;958;966;8;28;0.83
9;138;966;967;1;28;0.83
9;139;967;968;1;28;0.83
9;140;968;973;5;28;0.83
9;141;973;975;2;28;0.83
9;142;975;978;3;28;0.83
9;143;978;981;3;28;0.83
9;144;981;992;11;28;0.83
9;145;992;993;1;28;0.83
9;146;993;998;5;28;0.83
9;147;998;1000;2;28;0.83
9;148;1000;1003;3;28;0.83
9;149;1003;1011;8;28;0.83
9;150;1011;1014;3;28;0.83
9;151;1014;1015;1;28;0.83
9;152;1015;1018;3;28;0.83
9;153;1018;1021;3;28;0.83
9;154;1021;1023;2;28;0.83
9;155;1023;1032;9;28;0.83
9;156;1032;1033;1;28;0.83
9;157;1033;1043;10;28;0.83
9;158;1043;1044;1;28;0.83
9;159;1044;1045;1;28;0.83
9;160;1045;1055;10;28;0.83
9;161;1055;1058;3;28;0.83
9;162;1058;1063;5;28;0.83
9;163;1063;1076;13;28;0.83
9;164;1076;1078;2;28;0.83
9;165;1078;1083;5;28;0.83
9;166;1083;1085;2;28;0.83
9;167;1085;1094;9;28;0.83
9;168;1094;1098;4;28;0.83
9;169;1098;1101;3;28;0.83
9;170;1101;1103;2;28;0.83
9;171;1103;1109;6;28;0.83
9;172;1109;1111;2;28;0.83
9;173;1111;1121;10;28;0.83
9;174;1121;1134;13;28;0.83
9;175;1134;1137;3;28;0.83
9;176;1137;1141;4;28;0.83
9;177;1141;1142;1;28;0.83
9;178;1142;1152;10;28;0.83
9;179;1152;1171;19;28;0.83
9;180;1171;1174;3;28;0.83
9;181;1174;1181;7;28;0.83
9;182;1181;1199;18;28;0.83
9;183;1199;1202;3;28;0.83
9;184;1202;1205;3;28;0.83
9;185;1205;1209;4;28;0.83
9;186;1209;1221;12;28;0.83
9;187;1221;1231;10;28;0.83
9;188;1231;1256;25;28;0.83
9;189;1256;1262;6;28;0.83
9;190;1262;1263;1;28;0.83
9;191;1263;1269;6;28;0.83
9;192;1269;1281;12;28;0.83
9;193;1281;1291;10;28;0.83
9;194;1291;1296;5;28;0.83
9;195;1296;1312;16;28;0.83
9;196;1312;1322;10;28;0.83
9;197;1322;1323;1;28;0.83
9;198;1323;1337;14;28;0.83
9;199;1337;1341;4;28;0.83
9;200;1341;1357;16;28;0.83
9;201;1357;1360;3;28;0.83
9;202;1360;1363;3;28;0.83
9;203;1363;1365;2;28;0.83
9;204;1365;1366;1;28;0.83
9;205;1366;1374;8;28;0.83
9;206;1374;1376;2;28;0.83
9;207;1376;1379;3;28;0.83
9;208;1379;1386;7;28;0.83
9;209;1386;1401;15;28;0.83
9;210;1401;1416;15;28;0.83
9;211;1416;1431;15;28;0.83
9;212;1431;1446;15;28;0.83
9;213;1446;1461;15;28;0.83
9;214;1461;1476;15;28;0.83
9;215;1476;1491;15;28;0.83
9;216;1491;1506;15;28;0.83
9;217;1506;1521;15;28;0.83
9;218;1521;1536;15;28;0.83
9;219;1536;1551;15;28;0.83
9;220;1551;1566;15;28;0.83
9;221;1566;1581;15;28;0.83
9;222;1581;1596;15;28;0.83
9;223;1596;1611;15;28;0.83
9;224;1611;1626;15;28;0.83
9;225;1626;1641;15;28;0.83
9;226;1641;1656;15;28;0.83
9;227;1656;1671;15;28;0.83
9;228;1671;1680;9;28;0.83
10;0;240;331;91;28;0.83
10;1;331;333;2;28;0.83
10;2;333;334;1;28;0.83
10;3;334;345;11;28;0.83
10;4;345;346;1;28;0.83
10;5;346;348;2;28;0.83
10;6;348;353;5;28;0.83
10;7;353;358;5;28;0.83
10;8;358;360;2;28;0.83
10;9;360;361;1;28;0.83
10;10;361;365;4;28;0.83
10;11;365;367;2;28;0.83
10;12;367;368;1;28;0.83
10;13;368;381;13;28;0.83
10;14;381;385;4;28;0.83
10;15;385;388;3;28;0.83
10;16;388;391;3;28;0.83
10;17;391;396;5;28;0.83
10;18;396;403;7;28;0.83
10;19;403;404;1;28;0.83
10;20;404;406;2;28;0.83
10;21;406;408;2;28;0.83
10;22;408;416;8;28;0.83
10;23;416;418;2;28;0.83
10;24;418;421;3;28;0.83
10;25;421;423;2;28;0.83
10;26;423;425;2;28;0.83
10;27;425;428;3;28;0.83
10;28;428;435;7;28;0.83
10;29;435;436;1;28;0.83
10;30;436;438;2;28;0.83
10;31;438;447;9;28;0.83
10;32;447;448;1;28;0.83
10;33;448;450;2;28;0.83
10;34;450;451;1;28;0.83
10;35;451;453;2;28;0.83
10;36;453;458;5;28;0.83
10;37;458;463;5;28;0.83
10;38;463;465;2;28;0.83
10;39;465;466;1;28;0.83
10;40;466;467;1;28;0.83
10;41;467;468;1;28;0.83
10;42;468;473;5;28;0.83
10;43;473;478;5;28;0.83
10;44;478;480;2;28;0.83
10;45;480;481;1;28;0.83
10;46;481;482;1;28;0.83
10;47;482;483;1;28;0.83
10;48;483;493;10;28;0.83
10;49;493;494;1;28;0.83
10;50;494;496;2;28;0.83
10;51;496;504;8;28;0.83
10;52;504;505;1;28;0.83
10;53;505;513;8;28;0.83
10;54;513;518;5;28;0.83
10;55;518;523;5;28;0.83
10;56;523;525;2;28;0.83
10;57;525;531;6;28;0.83
10;58;531;537;6;28;0.83
10;59;537;543;6;28;0.83
10;60;543;548;5;28;0.83
10;61;548;549;1;28;0.83
10;62;549;550;1;28;0.83
10;63;550;553;3;28;0.83
10;64;553;578;25;28;0.83
10;65;578;585;7;28;0.83
10;66;585;588;3;28;0.83
10;67;588;591;3;28;0.83
10;68;591;593;2;28;0.83
10;69;593;623;30;28;0.83
10;70;623;625;2;28;0.83
10;71;625;628;3;28;0.83
10;72;628;633;5;28;0.83
10;73;633;655;22;28;0.83
10;74;655;656;1;28;0.83
10;75;656;658;2;28;0.83
10;76;658;671;13;28;0.83
10;77;671;673;2;28;0.83
10;78;673;693;20;28;0.83
10;79;693;695;2;28;0.83
10;80;695;698;3;28;0.83
10;81;698;718;20;28;0.83
10;82;718;721;3;28;0.83
10;83;721;725;4;28;0.83
10;84;725;728;3;28;0.83
10;85;728;746;18;28;0.83
10;86;746;748;2;28;0.83
10;87;748;758;10;28;0.83
10;88;758;763;5;28;0.83
10;89;763;766;3;28;0.83
10;90;766;768;2;28;0.83
10;91;768;775;7;28;0.83
10;92;775;778;3;28;0.83
10;93;778;784;6;28;0.83
10;94;784;788;4;28;0.83
10;95;788;793;5;28;0.83
10;96;793;798;5;28;0.83
10;97;798;805;7;28;0.83
10;98;805;806;1;28;0.83
10;99;806;814;8;28;0.83
10;100;814;818;4;28;0.83
10;101;818;821;3;28;0.83
10;102;821;832;11;28;0.83
10;103;832;833;1;28;0.83
10;104;833;837;4;28;0.83
10;105;837;838;1;28;0.83
10;106;838;841;3;28;0.83
10;107;841;843;2;28;0.83
10;108;843;848;5;28;0.83
10;109;848;852;4;28;0.83
10;110;852;855;3;28;0.83
10;111;855;861;6;28;0.83
10;112;861;863;2;28;0.83
10;113;863;870;7;28;0.83
10;114;870;871;1;28;0.83
10;115;871;872;1;28;0.83
10;116;872;878;6;28;0.83
10;117;878;883;5;28;0.83
10;118;883;885;2;28;0.83
10;119;885;887;2;28;0.83
10;120;887;888;1;28;0.83
10;121;888;895;7;28;0.83
10;122;895;898;3;28;0.83
10;123;898;903;5;28;0.83
10;124;903;907;4;28;0.83
10;125;907;912;5;28;0.83
10;126;912;913;1;28;0.83
10;127;913;918;5;28;0.83
10;128;918;925;7;28;0.83
10;129;925;931;6;28;0.83
10;130;931;932;1;28;0.83
10;131;932;938;6;28;0.83
10;132;938;940;2;28;0.83
10;133;940;947;7;28;0.83
10;134;947;953;6;28;0.83
10;135;953;955;2;28;0.83
10;136;955;958;3;28;0.83
10;137;958;966;8;28;0.83
10;138;966;967;1;28;0.83
10;139;967;968;1;28;0.83
10;140;968;973;5;28;0.83
10;141;973;975;2;28;0.83
10;142;975;978;3;28;0.83
10;143;978;981;3;28;0.83
10;144;981;992;11;28;0.83
10;145;992;993;1;28;0.83
10;146;993;998;5;28;0.83
10;147;998;1000;2;28;0.83
10;148;1000;1003;3;28;0.83
10;149;1003;1011;8;28;0.83
10;150;1011;1014;3;28;0.83
10;151;1014;1015;1;28;0.83
10;152;1015;1018;3;28;0.83
10;153;1018;1021;3;28;0.83
10;154;1021;1023;2;28;0.83
10;155;1023;1032;9;28;0.83
10;156;1032;1033;1;28;0.83
10;157;1033;1043;10;28;0.83
10;158;1043;1044;1;28;0.83
10;159;1044;1045;1;28;0.83
10;160;1045;1055;10;28;0.83
10;161;1055;1058;3;28;0.83
10;162;1058;1063;5;28;0.83
10;163;1063;1076;13;28;0.83
10;164;1076;1078;2;28;0.83
10;165;1078;1083;5;28;0.83
10;166;1083;1085;2;28;0.83
10;167;1085;1094;9;28;0.83
10;168;1094;1098;4;28;0.83
10;169;1098;1101;3;28;0.83
10;170;1101;1103;2;28;0.83
10;171;1103;1109;6;28;0.83
10;172;1109;1111;2;28;0.83
10;173;1111;1121;10;28;0.83
10;174;1121;1134;13;28;0.83
10;175;1134;1137;3;28;0.83
10;176;1137;1141;4;28;0.83
10;177;1141;1142;1;28;0.83
10;178;1142;1152;10;28;0.83
10;179;1152;1171;19;28;0.83
10;180;1171;1174;3;28;0.83
10;181;1174;1181;7;28;0.83
10;182;1181;1199;18;28;0.83
10;183;1199;1202;3;28;0.83
10;184;1202;1205;3;28;0.83
10;185;1205;1209;4;28;0.83
10;186;1209;1221;12;28;0.83
10;187;1221;1231;10;28;0.83
10;188;1231;1256;25;28;0.83
10;189;1256;1262;6;28;0.83
10;190;1262;1263;1;28;0.83
10;191;1263;1269;6;28;0.83
10;192;1269;1281;12;28;0.83
10;193;1281;1291;10;28;0.83
10;194;1291;1296;5;28;0.83
10;195;1296;1312;16;28;0.83
10;196;1312;1322;10;28;0.83
10;197;1322;1323;1;28;0.83
10;198;1323;1337;14;28;0.83
10;199;1337;1341;4;28;0.83
10;200;1341;1357;16;28;0.83
10;201;1357;1360;3;28;0.83
10;202;1360;1363;3;28;0.83
10;203;1363;1365;2;28;0.83
10;204;1365;1366;1;28;0.83
10;205;1366;1374;8;28;0.83
10;206;1374;1376;2;28;0.83
10;207;1376;1379;3;28;0.83
10;208;1379;1386;7;28;0.83
10;209;1386;1401;15;28;0.83
10;210;1401;1416;15;28;0.83
10;211;1416;1431;15;28;0.83
10;212;1431;1446;15;28;0.83
10;213;1446;1461;15;28;0.83
10;214;1461;1476;15;28;0.83
10;215;1476;1491;15;28;0.83
10;216;1491;1506;15;28;0.83
10;217;1506;1521;15;28;0.83
10;218;1521;1536;15;28;0.83
10;219;1536;1551;15;28;0.83
10;220;1551;1566;15;28;0.83
10;221;1566;1581;15;28;0.83
10;222;1581;1596;15;28;0.83
10;223;1596;1611;15;28;0.83
10;224;1611;1626;15;28;0.83
10;225;1626;1641;15;28;0.83
10;226;1641;1656;15;28;0.83
10;227;1656;1671;15;28;0.83
10;228;1671;1680;9;28;0.83
