Index Nabijacky;Index Udalosti;Cas Zaciatku;Cas Konca;CasTrvania;Miesto;Rychlost nabijania
0;0;243;329;86;25;2.0
0;1;329;330;1;25;2.0
0;2;330;334;4;25;2.0
0;3;334;335;1;25;2.0
0;4;335;345;10;25;2.0
0;5;345;350;5;25;2.0
0;6;350;354;4;25;2.0
0;7;354;355;1;25;2.0
0;8;355;358;3;25;2.0
0;9;358;360;2;25;2.0
0;10;360;368;8;25;2.0
0;11;368;369;1;25;2.0
0;12;369;380;11;25;2.0
0;13;380;383;3;25;2.0
0;14;383;388;5;25;2.0
0;15;388;389;1;25;2.0
0;16;389;390;1;25;2.0
0;17;390;395;5;25;2.0
0;18;395;404;9;25;2.0
0;19;404;405;1;25;2.0
0;20;405;415;10;25;2.0
0;21;415;418;3;25;2.0
0;22;418;422;4;25;2.0
0;23;422;424;2;25;2.0
0;24;424;426;2;25;2.0
0;25;426;428;2;25;2.0
0;26;428;439;11;25;2.0
0;27;439;448;9;25;2.0
0;28;448;449;1;25;2.0
0;29;449;450;1;25;2.0
0;30;450;451;1;25;2.0
0;31;451;459;8;25;2.0
0;32;459;460;1;25;2.0
0;33;460;465;5;25;2.0
0;34;465;470;5;25;2.0
0;35;470;480;10;25;2.0
0;36;480;483;3;25;2.0
0;37;483;494;11;25;2.0
0;38;494;496;2;25;2.0
0;39;496;500;4;25;2.0
0;40;500;501;1;25;2.0
0;41;501;510;9;25;2.0
0;42;510;513;3;25;2.0
0;43;513;524;11;25;2.0
0;44;524;530;6;25;2.0
0;45;530;540;10;25;2.0
0;46;540;546;6;25;2.0
0;47;546;548;2;25;2.0
0;48;548;579;31;25;2.0
0;49;579;589;10;25;2.0
0;50;589;590;1;25;2.0
0;51;590;591;1;25;2.0
0;52;591;616;25;25;2.0
0;53;616;628;12;25;2.0
0;54;628;629;1;25;2.0
0;55;629;655;26;25;2.0
0;56;655;659;4;25;2.0
0;57;659;680;21;25;2.0
0;58;680;699;19;25;2.0
0;59;699;711;12;25;2.0
0;60;711;715;4;25;2.0
0;61;715;724;9;25;2.0
0;62;724;736;12;25;2.0
0;63;736;745;9;25;2.0
0;64;745;748;3;25;2.0
0;65;748;759;11;25;2.0
0;66;759;761;2;25;2.0
0;67;761;775;14;25;2.0
0;68;775;794;19;25;2.0
0;69;794;816;22;25;2.0
0;70;816;819;3;25;2.0
0;71;819;820;1;25;2.0
0;72;820;830;10;25;2.0
0;73;830;831;1;25;2.0
0;74;831;836;5;25;2.0
0;75;836;844;8;25;2.0
0;76;844;849;5;25;2.0
0;77;849;864;15;25;2.0
0;78;864;870;6;25;2.0
0;79;870;878;8;25;2.0
0;80;878;879;1;25;2.0
0;81;879;881;2;25;2.0
0;82;881;885;4;25;2.0
0;83;885;886;1;25;2.0
0;84;886;898;12;25;2.0
0;85;898;899;1;25;2.0
0;86;899;900;1;25;2.0
0;87;900;909;9;25;2.0
0;88;909;911;2;25;2.0
0;89;911;914;3;25;2.0
0;90;914;921;7;25;2.0
0;91;921;928;7;25;2.0
0;92;928;930;2;25;2.0
0;93;930;935;5;25;2.0
0;94;935;939;4;25;2.0
0;95;939;941;2;25;2.0
0;96;941;944;3;25;2.0
0;97;944;954;10;25;2.0
0;98;954;955;1;25;2.0
0;99;955;958;3;25;2.0
0;100;958;969;11;25;2.0
0;101;969;971;2;25;2.0
0;102;971;974;3;25;2.0
0;103;974;975;1;25;2.0
0;104;975;979;4;25;2.0
0;105;979;990;11;25;2.0
0;106;990;994;4;25;2.0
0;107;994;1001;7;25;2.0
0;108;1001;1018;17;25;2.0
0;109;1018;1020;2;25;2.0
0;110;1020;1024;4;25;2.0
0;111;1024;1029;5;25;2.0
0;112;1029;1031;2;25;2.0
0;113;1031;1040;9;25;2.0
0;114;1040;1044;4;25;2.0
0;115;1044;1061;17;25;2.0
0;116;1061;1064;3;25;2.0
0;117;1064;1075;11;25;2.0
0;118;1075;1080;5;25;2.0
0;119;1080;1084;4;25;2.0
0;120;1084;1086;2;25;2.0
0;121;1086;1092;6;25;2.0
0;122;1092;1095;3;25;2.0
0;123;1095;1098;3;25;2.0
0;124;1098;1099;1;25;2.0
0;125;1099;1121;22;25;2.0
0;126;1121;1143;22;25;2.0
0;127;1143;1145;2;25;2.0
0;128;1145;1168;23;25;2.0
0;129;1168;1175;7;25;2.0
0;130;1175;1203;28;25;2.0
0;131;1203;1216;13;25;2.0
0;132;1216;1218;2;25;2.0
0;133;1218;1222;4;25;2.0
0;134;1222;1263;41;25;2.0
0;135;1263;1265;2;25;2.0
0;136;1265;1278;13;25;2.0
0;137;1278;1280;2;25;2.0
0;138;1280;1313;33;25;2.0
0;139;1313;1320;7;25;2.0
0;140;1320;1336;16;25;2.0
0;141;1336;1343;7;25;2.0
0;142;1343;1377;34;25;2.0
0;143;1377;1383;6;25;2.0
0;144;1383;1385;2;25;2.0
0;145;1385;1393;8;25;2.0
0;146;1393;1408;15;25;2.0
0;147;1408;1423;15;25;2.0
0;148;1423;1438;15;25;2.0
0;149;1438;1453;15;25;2.0
0;150;1453;1468;15;25;2.0
0;151;1468;1483;15;25;2.0
0;152;1483;1498;15;25;2.0
0;153;1498;1513;15;25;2.0
0;154;1513;1528;15;25;2.0
0;155;1528;1543;15;25;2.0
0;156;1543;1558;15;25;2.0
0;157;1558;1573;15;25;2.0
0;158;1573;1588;15;25;2.0
0;159;1588;1603;15;25;2.0
0;160;1603;1618;15;25;2.0
0;161;1618;1633;15;25;2.0
0;162;1633;1648;15;25;2.0
0;163;1648;1663;15;25;2.0
0;164;1663;1680;17;25;2.0
1;0;242;330;88;42;2.0
1;1;330;334;4;42;2.0
1;2;334;336;2;42;2.0
1;3;336;345;9;42;2.0
1;4;345;351;6;42;2.0
1;5;351;354;3;42;2.0
1;6;354;356;2;42;2.0
1;7;356;358;2;42;2.0
1;8;358;360;2;42;2.0
1;9;360;368;8;42;2.0
1;10;368;369;1;42;2.0
1;11;369;380;11;42;2.0
1;12;380;382;2;42;2.0
1;13;382;388;6;42;2.0
1;14;388;389;1;42;2.0
1;15;389;391;2;42;2.0
1;16;391;395;4;42;2.0
1;17;395;404;9;42;2.0
1;18;404;406;2;42;2.0
1;19;406;415;9;42;2.0
1;20;415;416;1;42;2.0
1;21;416;418;2;42;2.0
1;22;418;423;5;42;2.0
1;23;423;424;1;42;2.0
1;24;424;426;2;42;2.0
1;25;426;428;2;42;2.0
1;26;428;439;11;42;2.0
1;27;439;448;9;42;2.0
1;28;448;449;1;42;2.0
1;29;449;450;1;42;2.0
1;30;450;451;1;42;2.0
1;31;451;452;1;42;2.0
1;32;452;459;7;42;2.0
1;33;459;460;1;42;2.0
1;34;460;461;1;42;2.0
1;35;461;466;5;42;2.0
1;36;466;471;5;42;2.0
1;37;471;481;10;42;2.0
1;38;481;483;2;42;2.0
1;39;483;494;11;42;2.0
1;40;494;496;2;42;2.0
1;41;496;499;3;42;2.0
1;42;499;502;3;42;2.0
1;43;502;511;9;42;2.0
1;44;511;512;1;42;2.0
1;45;512;524;12;42;2.0
1;46;524;530;6;42;2.0
1;47;530;541;11;42;2.0
1;48;541;547;6;42;2.0
1;49;547;548;1;42;2.0
1;50;548;579;31;42;2.0
1;51;579;590;11;42;2.0
1;52;590;591;1;42;2.0
1;53;591;617;26;42;2.0
1;54;617;627;10;42;2.0
1;55;627;628;1;42;2.0
1;56;628;629;1;42;2.0
1;57;629;655;26;42;2.0
1;58;655;660;5;42;2.0
1;59;660;679;19;42;2.0
1;60;679;699;20;42;2.0
1;61;699;711;12;42;2.0
1;62;711;716;5;42;2.0
1;63;716;725;9;42;2.0
1;64;725;737;12;42;2.0
1;65;737;745;8;42;2.0
1;66;745;747;2;42;2.0
1;67;747;759;12;42;2.0
1;68;759;761;2;42;2.0
1;69;761;776;15;42;2.0
1;70;776;794;18;42;2.0
1;71;794;795;1;42;2.0
1;72;795;816;21;42;2.0
1;73;816;819;3;42;2.0
1;74;819;820;1;42;2.0
1;75;820;830;10;42;2.0
1;76;830;831;1;42;2.0
1;77;831;837;6;42;2.0
1;78;837;844;7;42;2.0
1;79;844;850;6;42;2.0
1;80;850;864;14;42;2.0
1;81;864;865;1;42;2.0
1;82;865;870;5;42;2.0
1;83;870;878;8;42;2.0
1;84;878;879;1;42;2.0
1;85;879;880;1;42;2.0
1;86;880;881;1;42;2.0
1;87;881;886;5;42;2.0
1;88;886;897;11;42;2.0
1;89;897;899;2;42;2.0
1;90;899;901;2;42;2.0
1;91;901;910;9;42;2.0
1;92;910;911;1;42;2.0
1;93;911;914;3;42;2.0
1;94;914;922;8;42;2.0
1;95;922;927;5;42;2.0
1;96;927;930;3;42;2.0
1;97;930;936;6;42;2.0
1;98;936;939;3;42;2.0
1;99;939;941;2;42;2.0
1;100;941;945;4;42;2.0
1;101;945;954;9;42;2.0
1;102;954;956;2;42;2.0
1;103;956;957;1;42;2.0
1;104;957;970;13;42;2.0
1;105;970;971;1;42;2.0
1;106;971;974;3;42;2.0
1;107;974;976;2;42;2.0
1;108;976;978;2;42;2.0
1;109;978;991;13;42;2.0
1;110;991;994;3;42;2.0
1;111;994;1001;7;42;2.0
1;112;1001;1017;16;42;2.0
1;113;1017;1020;3;42;2.0
1;114;1020;1024;4;42;2.0
1;115;1024;1030;6;42;2.0
1;116;1030;1031;1;42;2.0
1;117;1031;1041;10;42;2.0
1;118;1041;1044;3;42;2.0
1;119;1044;1061;17;42;2.0
1;120;1061;1064;3;42;2.0
1;121;1064;1065;1;42;2.0
1;122;1065;1075;10;42;2.0
1;123;1075;1081;6;42;2.0
1;124;1081;1084;3;42;2.0
1;125;1084;1087;3;42;2.0
1;126;1087;1091;4;42;2.0
1;127;1091;1096;5;42;2.0
1;128;1096;1098;2;42;2.0
1;129;1098;1099;1;42;2.0
1;130;1099;1121;22;42;2.0
1;131;1121;1143;22;42;2.0
1;132;1143;1145;2;42;2.0
1;133;1145;1169;24;42;2.0
1;134;1169;1174;5;42;2.0
1;135;1174;1203;29;42;2.0
1;136;1203;1217;14;42;2.0
1;137;1217;1219;2;42;2.0
1;138;1219;1221;2;42;2.0
1;139;1221;1263;42;42;2.0
1;140;1263;1265;2;42;2.0
1;141;1265;1279;14;42;2.0
1;142;1279;1313;34;42;2.0
1;143;1313;1321;8;42;2.0
1;144;1321;1336;15;42;2.0
1;145;1336;1342;6;42;2.0
1;146;1342;1377;35;42;2.0
1;147;1377;1384;7;42;2.0
1;148;1384;1385;1;42;2.0
1;149;1385;1392;7;42;2.0
1;150;1392;1407;15;42;2.0
1;151;1407;1422;15;42;2.0
1;152;1422;1437;15;42;2.0
1;153;1437;1452;15;42;2.0
1;154;1452;1467;15;42;2.0
1;155;1467;1482;15;42;2.0
1;156;1482;1497;15;42;2.0
1;157;1497;1512;15;42;2.0
1;158;1512;1527;15;42;2.0
1;159;1527;1542;15;42;2.0
1;160;1542;1557;15;42;2.0
1;161;1557;1572;15;42;2.0
1;162;1572;1587;15;42;2.0
1;163;1587;1602;15;42;2.0
1;164;1602;1617;15;42;2.0
1;165;1617;1632;15;42;2.0
1;166;1632;1647;15;42;2.0
1;167;1647;1662;15;42;2.0
1;168;1662;1677;15;42;2.0
1;169;1677;1680;3;42;2.0
2;0;246;325;79;49;2.0
2;1;325;333;8;49;2.0
2;2;333;336;3;49;2.0
2;3;336;337;1;49;2.0
2;4;337;340;3;49;2.0
2;5;340;351;11;49;2.0
2;6;351;355;4;49;2.0
2;7;355;356;1;49;2.0
2;8;356;357;1;49;2.0
2;9;357;361;4;49;2.0
2;10;361;369;8;49;2.0
2;11;369;371;2;49;2.0
2;12;371;372;1;49;2.0
2;13;372;375;3;49;2.0
2;14;375;387;12;49;2.0
2;15;387;390;3;49;2.0
2;16;390;391;1;49;2.0
2;17;391;392;1;49;2.0
2;18;392;406;14;49;2.0
2;19;406;407;1;49;2.0
2;20;407;410;3;49;2.0
2;21;410;419;9;49;2.0
2;22;419;421;2;49;2.0
2;23;421;423;2;49;2.0
2;24;423;426;3;49;2.0
2;25;426;427;1;49;2.0
2;26;427;431;4;49;2.0
2;27;431;442;11;49;2.0
2;28;442;445;3;49;2.0
2;29;445;451;6;49;2.0
2;30;451;452;1;49;2.0
2;31;452;454;2;49;2.0
2;32;454;455;1;49;2.0
2;33;455;462;7;49;2.0
2;34;462;463;1;49;2.0
2;35;463;464;1;49;2.0
2;36;464;466;2;49;2.0
2;37;466;474;8;49;2.0
2;38;474;481;7;49;2.0
2;39;481;486;5;49;2.0
2;40;486;496;10;49;2.0
2;41;496;497;1;49;2.0
2;42;497;504;7;49;2.0
2;43;504;505;1;49;2.0
2;44;505;514;9;49;2.0
2;45;514;517;3;49;2.0
2;46;517;525;8;49;2.0
2;47;525;527;2;49;2.0
2;48;527;544;17;49;2.0
2;49;544;550;6;49;2.0
2;50;550;551;1;49;2.0
2;51;551;582;31;49;2.0
2;52;582;590;8;49;2.0
2;53;590;591;1;49;2.0
2;54;591;594;3;49;2.0
2;55;594;620;26;49;2.0
2;56;620;631;11;49;2.0
2;57;631;632;1;49;2.0
2;58;632;650;18;49;2.0
2;59;650;660;10;49;2.0
2;60;660;684;24;49;2.0
2;61;684;702;18;49;2.0
2;62;702;711;9;49;2.0
2;63;711;719;8;49;2.0
2;64;719;725;6;49;2.0
2;65;725;740;15;49;2.0
2;66;740;752;12;49;2.0
2;67;752;762;10;49;2.0
2;68;762;764;2;49;2.0
2;69;764;779;15;49;2.0
2;70;779;795;16;49;2.0
2;71;795;797;2;49;2.0
2;72;797;815;18;49;2.0
2;73;815;816;1;49;2.0
2;74;816;822;6;49;2.0
2;75;822;834;12;49;2.0
2;76;834;835;1;49;2.0
2;77;835;837;2;49;2.0
2;78;837;847;10;49;2.0
2;79;847;850;3;49;2.0
2;80;850;865;15;49;2.0
2;81;865;867;2;49;2.0
2;82;867;880;13;49;2.0
2;83;880;881;1;49;2.0
2;84;881;882;1;49;2.0
2;85;882;889;7;49;2.0
2;86;889;902;13;49;2.0
2;87;902;904;2;49;2.0
2;88;904;910;6;49;2.0
2;89;910;914;4;49;2.0
2;90;914;917;3;49;2.0
2;91;917;925;8;49;2.0
2;92;925;932;7;49;2.0
2;93;932;939;7;49;2.0
2;94;939;941;2;49;2.0
2;95;941;942;1;49;2.0
2;96;942;944;2;49;2.0
2;97;944;945;1;49;2.0
2;98;945;957;12;49;2.0
2;99;957;959;2;49;2.0
2;100;959;962;3;49;2.0
2;101;962;970;8;49;2.0
2;102;970;974;4;49;2.0
2;103;974;977;3;49;2.0
2;104;977;979;2;49;2.0
2;105;979;983;4;49;2.0
2;106;983;994;11;49;2.0
2;107;994;997;3;49;2.0
2;108;997;1001;4;49;2.0
2;109;1001;1004;3;49;2.0
2;110;1004;1015;11;49;2.0
2;111;1015;1022;7;49;2.0
2;112;1022;1027;5;49;2.0
2;113;1027;1030;3;49;2.0
2;114;1030;1034;4;49;2.0
2;115;1034;1044;10;49;2.0
2;116;1044;1047;3;49;2.0
2;117;1047;1061;14;49;2.0
2;118;1061;1064;3;49;2.0
2;119;1064;1065;1;49;2.0
2;120;1065;1067;2;49;2.0
2;121;1067;1070;3;49;2.0
2;122;1070;1084;14;49;2.0
2;123;1084;1087;3;49;2.0
2;124;1087;1090;3;49;2.0
2;125;1090;1096;6;49;2.0
2;126;1096;1099;3;49;2.0
2;127;1099;1102;3;49;2.0
2;128;1102;1103;1;49;2.0
2;129;1103;1124;21;49;2.0
2;130;1124;1145;21;49;2.0
2;131;1145;1146;1;49;2.0
2;132;1146;1172;26;49;2.0
2;133;1172;1179;7;49;2.0
2;134;1179;1206;27;49;2.0
2;135;1206;1220;14;49;2.0
2;136;1220;1222;2;49;2.0
2;137;1222;1226;4;49;2.0
2;138;1226;1265;39;49;2.0
2;139;1265;1266;1;49;2.0
2;140;1266;1282;16;49;2.0
2;141;1282;1284;2;49;2.0
2;142;1284;1316;32;49;2.0
2;143;1316;1321;5;49;2.0
2;144;1321;1331;10;49;2.0
2;145;1331;1347;16;49;2.0
2;146;1347;1380;33;49;2.0
2;147;1380;1385;5;49;2.0
2;148;1385;1387;2;49;2.0
2;149;1387;1397;10;49;2.0
2;150;1397;1412;15;49;2.0
2;151;1412;1427;15;49;2.0
2;152;1427;1442;15;49;2.0
2;153;1442;1457;15;49;2.0
2;154;1457;1472;15;49;2.0
2;155;1472;1487;15;49;2.0
2;156;1487;1502;15;49;2.0
2;157;1502;1517;15;49;2.0
2;158;1517;1532;15;49;2.0
2;159;1532;1547;15;49;2.0
2;160;1547;1562;15;49;2.0
2;161;1562;1577;15;49;2.0
2;162;1577;1592;15;49;2.0
2;163;1592;1607;15;49;2.0
2;164;1607;1622;15;49;2.0
2;165;1622;1637;15;49;2.0
2;166;1637;1652;15;49;2.0
2;167;1652;1667;15;49;2.0
2;168;1667;1680;13;49;2.0
3;0;244;331;87;77;2.0
3;1;331;334;3;77;2.0
3;2;334;337;3;77;2.0
3;3;337;346;9;77;2.0
3;4;346;349;3;77;2.0
3;5;349;354;5;77;2.0
3;6;354;356;2;77;2.0
3;7;356;357;1;77;2.0
3;8;357;361;4;77;2.0
3;9;361;366;5;77;2.0
3;10;366;372;6;77;2.0
3;11;372;381;9;77;2.0
3;12;381;386;5;77;2.0
3;13;386;389;3;77;2.0
3;14;389;392;3;77;2.0
3;15;392;396;4;77;2.0
3;16;396;404;8;77;2.0
3;17;404;407;3;77;2.0
3;18;407;416;9;77;2.0
3;19;416;419;3;77;2.0
3;20;419;421;2;77;2.0
3;21;421;426;5;77;2.0
3;22;426;427;1;77;2.0
3;23;427;429;2;77;2.0
3;24;429;442;13;77;2.0
3;25;442;446;4;77;2.0
3;26;446;449;3;77;2.0
3;27;449;451;2;77;2.0
3;28;451;452;1;77;2.0
3;29;452;454;2;77;2.0
3;30;454;456;2;77;2.0
3;31;456;458;2;77;2.0
3;32;458;462;4;77;2.0
3;33;462;464;2;77;2.0
3;34;464;474;10;77;2.0
3;35;474;479;5;77;2.0
3;36;479;481;2;77;2.0
3;37;481;497;16;77;2.0
3;38;497;499;2;77;2.0
3;39;499;503;4;77;2.0
3;40;503;505;2;77;2.0
3;41;505;514;9;77;2.0
3;42;514;516;2;77;2.0
3;43;516;527;11;77;2.0
3;44;527;531;4;77;2.0
3;45;531;544;13;77;2.0
3;46;544;546;2;77;2.0
3;47;546;550;4;77;2.0
3;48;550;582;32;77;2.0
3;49;582;588;6;77;2.0
3;50;588;594;6;77;2.0
3;51;594;621;27;77;2.0
3;52;621;626;5;77;2.0
3;53;626;631;5;77;2.0
3;54;631;632;1;77;2.0
3;55;632;656;24;77;2.0
3;56;656;658;2;77;2.0
3;57;658;683;25;77;2.0
3;58;683;702;19;77;2.0
3;59;702;714;12;77;2.0
3;60;714;719;5;77;2.0
3;61;719;723;4;77;2.0
3;62;723;741;18;77;2.0
3;63;741;746;5;77;2.0
3;64;746;751;5;77;2.0
3;65;751;759;8;77;2.0
3;66;759;762;3;77;2.0
3;67;762;779;17;77;2.0
3;68;779;793;14;77;2.0
3;69;793;797;4;77;2.0
3;70;797;819;22;77;2.0
3;71;819;821;2;77;2.0
3;72;821;822;1;77;2.0
3;73;822;829;7;77;2.0
3;74;829;834;5;77;2.0
3;75;834;835;1;77;2.0
3;76;835;847;12;77;2.0
3;77;847;848;1;77;2.0
3;78;848;863;15;77;2.0
3;79;863;867;4;77;2.0
3;80;867;871;4;77;2.0
3;81;871;876;5;77;2.0
3;82;876;878;2;77;2.0
3;83;878;882;4;77;2.0
3;84;882;884;2;77;2.0
3;85;884;889;5;77;2.0
3;86;889;901;12;77;2.0
3;87;901;902;1;77;2.0
3;88;902;904;2;77;2.0
3;89;904;908;4;77;2.0
3;90;908;909;1;77;2.0
3;91;909;917;8;77;2.0
3;92;917;926;9;77;2.0
3;93;926;931;5;77;2.0
3;94;931;939;8;77;2.0
3;95;939;942;3;77;2.0
3;96;942;943;1;77;2.0
3;97;943;944;1;77;2.0
3;98;944;957;13;77;2.0
3;99;957;959;2;77;2.0
3;100;959;961;2;77;2.0
3;101;961;968;7;77;2.0
3;102;968;969;1;77;2.0
3;103;969;977;8;77;2.0
3;104;977;979;2;77;2.0
3;105;979;982;3;77;2.0
3;106;982;994;12;77;2.0
3;107;994;997;3;77;2.0
3;108;997;999;2;77;2.0
3;109;999;1004;5;77;2.0
3;110;1004;1021;17;77;2.0
3;111;1021;1027;6;77;2.0
3;112;1027;1028;1;77;2.0
3;113;1028;1029;1;77;2.0
3;114;1029;1044;15;77;2.0
3;115;1044;1047;3;77;2.0
3;116;1047;1059;12;77;2.0
3;117;1059;1063;4;77;2.0
3;118;1063;1064;1;77;2.0
3;119;1064;1067;3;77;2.0
3;120;1067;1076;9;77;2.0
3;121;1076;1084;8;77;2.0
3;122;1084;1087;3;77;2.0
3;123;1087;1091;4;77;2.0
3;124;1091;1095;4;77;2.0
3;125;1095;1099;4;77;2.0
3;126;1099;1102;3;77;2.0
3;127;1102;1119;17;77;2.0
3;128;1119;1146;27;77;2.0
3;129;1146;1148;2;77;2.0
3;130;1148;1172;24;77;2.0
3;131;1172;1178;6;77;2.0
3;132;1178;1206;28;77;2.0
3;133;1206;1221;15;77;2.0
3;134;1221;1222;1;77;2.0
3;135;1222;1225;3;77;2.0
3;136;1225;1266;41;77;2.0
3;137;1266;1268;2;77;2.0
3;138;1268;1282;14;77;2.0
3;139;1282;1283;1;77;2.0
3;140;1283;1316;33;77;2.0
3;141;1316;1319;3;77;2.0
3;142;1319;1337;18;77;2.0
3;143;1337;1346;9;77;2.0
3;144;1346;1380;34;77;2.0
3;145;1380;1387;7;77;2.0
3;146;1387;1388;1;77;2.0
3;147;1388;1396;8;77;2.0
3;148;1396;1411;15;77;2.0
3;149;1411;1426;15;77;2.0
3;150;1426;1441;15;77;2.0
3;151;1441;1456;15;77;2.0
3;152;1456;1471;15;77;2.0
3;153;1471;1486;15;77;2.0
3;154;1486;1501;15;77;2.0
3;155;1501;1516;15;77;2.0
3;156;1516;1531;15;77;2.0
3;157;1531;1546;15;77;2.0
3;158;1546;1561;15;77;2.0
3;159;1561;1576;15;77;2.0
3;160;1576;1591;15;77;2.0
3;161;1591;1606;15;77;2.0
3;162;1606;1621;15;77;2.0
3;163;1621;1636;15;77;2.0
3;164;1636;1651;15;77;2.0
3;165;1651;1666;15;77;2.0
3;166;1666;1680;14;77;2.0
4;0;243;332;89;93;2.0
4;1;332;335;3;93;2.0
4;2;335;336;1;93;2.0
4;3;336;347;11;93;2.0
4;4;347;351;4;93;2.0
4;5;351;355;4;93;2.0
4;6;355;356;1;93;2.0
4;7;356;362;6;93;2.0
4;8;362;365;3;93;2.0
4;9;365;370;5;93;2.0
4;10;370;372;2;93;2.0
4;11;372;382;10;93;2.0
4;12;382;385;3;93;2.0
4;13;385;386;1;93;2.0
4;14;386;390;4;93;2.0
4;15;390;391;1;93;2.0
4;16;391;397;6;93;2.0
4;17;397;405;8;93;2.0
4;18;405;406;1;93;2.0
4;19;406;415;9;93;2.0
4;20;415;417;2;93;2.0
4;21;417;419;2;93;2.0
4;22;419;423;4;93;2.0
4;23;423;425;2;93;2.0
4;24;425;429;4;93;2.0
4;25;429;440;11;93;2.0
4;26;440;445;5;93;2.0
4;27;445;450;5;93;2.0
4;28;450;451;1;93;2.0
4;29;451;452;1;93;2.0
4;30;452;454;2;93;2.0
4;31;454;457;3;93;2.0
4;32;457;460;3;93;2.0
4;33;460;464;4;93;2.0
4;34;464;466;2;93;2.0
4;35;466;474;8;93;2.0
4;36;474;480;6;93;2.0
4;37;480;481;1;93;2.0
4;38;481;495;14;93;2.0
4;39;495;499;4;93;2.0
4;40;499;503;4;93;2.0
4;41;503;505;2;93;2.0
4;42;505;514;9;93;2.0
4;43;514;516;2;93;2.0
4;44;516;525;9;93;2.0
4;45;525;532;7;93;2.0
4;46;532;544;12;93;2.0
4;47;544;545;1;93;2.0
4;48;545;550;5;93;2.0
4;49;550;580;30;93;2.0
4;50;580;590;10;93;2.0
4;51;590;594;4;93;2.0
4;52;594;619;25;93;2.0
4;53;619;625;6;93;2.0
4;54;625;630;5;93;2.0
4;55;630;631;1;93;2.0
4;56;631;657;26;93;2.0
4;57;657;660;3;93;2.0
4;58;660;683;23;93;2.0
4;59;683;700;17;93;2.0
4;60;700;714;14;93;2.0
4;61;714;719;5;93;2.0
4;62;719;725;6;93;2.0
4;63;725;739;14;93;2.0
4;64;739;747;8;93;2.0
4;65;747;751;4;93;2.0
4;66;751;758;7;93;2.0
4;67;758;760;2;93;2.0
4;68;760;779;19;93;2.0
4;69;779;795;16;93;2.0
4;70;795;819;24;93;2.0
4;71;819;820;1;93;2.0
4;72;820;822;2;93;2.0
4;73;822;828;6;93;2.0
4;74;828;834;6;93;2.0
4;75;834;837;3;93;2.0
4;76;837;845;8;93;2.0
4;77;845;850;5;93;2.0
4;78;850;865;15;93;2.0
4;79;865;872;7;93;2.0
4;80;872;875;3;93;2.0
4;81;875;880;5;93;2.0
4;82;880;883;3;93;2.0
4;83;883;884;1;93;2.0
4;84;884;889;5;93;2.0
4;85;889;900;11;93;2.0
4;86;900;901;1;93;2.0
4;87;901;904;3;93;2.0
4;88;904;908;4;93;2.0
4;89;908;910;2;93;2.0
4;90;910;915;5;93;2.0
4;91;915;924;9;93;2.0
4;92;924;931;7;93;2.0
4;93;931;932;1;93;2.0
4;94;932;938;6;93;2.0
4;95;938;939;1;93;2.0
4;96;939;940;1;93;2.0
4;97;940;944;4;93;2.0
4;98;944;945;1;93;2.0
4;99;945;955;10;93;2.0
4;100;955;959;4;93;2.0
4;101;959;961;2;93;2.0
4;102;961;968;7;93;2.0
4;103;968;970;2;93;2.0
4;104;970;975;5;93;2.0
4;105;975;979;4;93;2.0
4;106;979;982;3;93;2.0
4;107;982;994;12;93;2.0
4;108;994;995;1;93;2.0
4;109;995;998;3;93;2.0
4;110;998;1004;6;93;2.0
4;111;1004;1021;17;93;2.0
4;112;1021;1022;1;93;2.0
4;113;1022;1025;3;93;2.0
4;114;1025;1028;3;93;2.0
4;115;1028;1030;2;93;2.0
4;116;1030;1044;14;93;2.0
4;117;1044;1045;1;93;2.0
4;118;1045;1058;13;93;2.0
4;119;1058;1064;6;93;2.0
4;120;1064;1065;1;93;2.0
4;121;1065;1077;12;93;2.0
4;122;1077;1084;7;93;2.0
4;123;1084;1085;1;93;2.0
4;124;1085;1089;4;93;2.0
4;125;1089;1095;6;93;2.0
4;126;1095;1099;4;93;2.0
4;127;1099;1102;3;93;2.0
4;128;1102;1118;16;93;2.0
4;129;1118;1144;26;93;2.0
4;130;1144;1148;4;93;2.0
4;131;1148;1172;24;93;2.0
4;132;1172;1178;6;93;2.0
4;133;1178;1204;26;93;2.0
4;134;1204;1219;15;93;2.0
4;135;1219;1222;3;93;2.0
4;136;1222;1225;3;93;2.0
4;137;1225;1264;39;93;2.0
4;138;1264;1268;4;93;2.0
4;139;1268;1282;14;93;2.0
4;140;1282;1283;1;93;2.0
4;141;1283;1314;31;93;2.0
4;142;1314;1321;7;93;2.0
4;143;1321;1338;17;93;2.0
4;144;1338;1346;8;93;2.0
4;145;1346;1378;32;93;2.0
4;146;1378;1387;9;93;2.0
4;147;1387;1388;1;93;2.0
4;148;1388;1396;8;93;2.0
4;149;1396;1411;15;93;2.0
4;150;1411;1426;15;93;2.0
4;151;1426;1441;15;93;2.0
4;152;1441;1456;15;93;2.0
4;153;1456;1471;15;93;2.0
4;154;1471;1486;15;93;2.0
4;155;1486;1501;15;93;2.0
4;156;1501;1516;15;93;2.0
4;157;1516;1531;15;93;2.0
4;158;1531;1546;15;93;2.0
4;159;1546;1561;15;93;2.0
4;160;1561;1576;15;93;2.0
4;161;1576;1591;15;93;2.0
4;162;1591;1606;15;93;2.0
4;163;1606;1621;15;93;2.0
4;164;1621;1636;15;93;2.0
4;165;1636;1651;15;93;2.0
4;166;1651;1666;15;93;2.0
4;167;1666;1680;14;93;2.0
5;0;245;327;82;112;2.0
5;1;327;331;4;112;2.0
5;2;331;334;3;112;2.0
5;3;334;335;1;112;2.0
5;4;335;342;7;112;2.0
5;5;342;349;7;112;2.0
5;6;349;354;5;112;2.0
5;7;354;355;1;112;2.0
5;8;355;357;2;112;2.0
5;9;357;360;3;112;2.0
5;10;360;367;7;112;2.0
5;11;367;370;3;112;2.0
5;12;370;377;7;112;2.0
5;13;377;386;9;112;2.0
5;14;386;389;3;112;2.0
5;15;389;390;1;112;2.0
5;16;390;392;2;112;2.0
5;17;392;404;12;112;2.0
5;18;404;405;1;112;2.0
5;19;405;412;7;112;2.0
5;20;412;418;6;112;2.0
5;21;418;420;2;112;2.0
5;22;420;421;1;112;2.0
5;23;421;424;3;112;2.0
5;24;424;425;1;112;2.0
5;25;425;430;5;112;2.0
5;26;430;440;10;112;2.0
5;27;440;447;7;112;2.0
5;28;447;449;2;112;2.0
5;29;449;450;1;112;2.0
5;30;450;453;3;112;2.0
5;31;453;460;7;112;2.0
5;32;460;462;2;112;2.0
5;33;462;463;1;112;2.0
5;34;463;464;1;112;2.0
5;35;464;473;9;112;2.0
5;36;473;479;6;112;2.0
5;37;479;485;6;112;2.0
5;38;485;494;9;112;2.0
5;39;494;495;1;112;2.0
5;40;495;503;8;112;2.0
5;41;503;504;1;112;2.0
5;42;504;513;9;112;2.0
5;43;513;516;3;112;2.0
5;44;516;525;9;112;2.0
5;45;525;527;2;112;2.0
5;46;527;543;16;112;2.0
5;47;543;549;6;112;2.0
5;48;549;550;1;112;2.0
5;49;550;580;30;112;2.0
5;50;580;588;8;112;2.0
5;51;588;589;1;112;2.0
5;52;589;593;4;112;2.0
5;53;593;618;25;112;2.0
5;54;618;630;12;112;2.0
5;55;630;631;1;112;2.0
5;56;631;652;21;112;2.0
5;57;652;658;6;112;2.0
5;58;658;683;25;112;2.0
5;59;683;700;17;112;2.0
5;60;700;709;9;112;2.0
5;61;709;718;9;112;2.0
5;62;718;723;5;112;2.0
5;63;723;738;15;112;2.0
5;64;738;742;4;112;2.0
5;65;742;751;9;112;2.0
5;66;751;760;9;112;2.0
5;67;760;763;3;112;2.0
5;68;763;778;15;112;2.0
5;69;778;793;15;112;2.0
5;70;793;795;2;112;2.0
5;71;795;814;19;112;2.0
5;72;814;817;3;112;2.0
5;73;817;820;3;112;2.0
5;74;820;833;13;112;2.0
5;75;833;834;1;112;2.0
5;76;834;835;1;112;2.0
5;77;835;845;10;112;2.0
5;78;845;848;3;112;2.0
5;79;848;863;15;112;2.0
5;80;863;865;2;112;2.0
5;81;865;867;2;112;2.0
5;82;867;878;11;112;2.0
5;83;878;879;1;112;2.0
5;84;879;880;1;112;2.0
5;85;880;888;8;112;2.0
5;86;888;900;12;112;2.0
5;87;900;901;1;112;2.0
5;88;901;903;2;112;2.0
5;89;903;908;5;112;2.0
5;90;908;913;5;112;2.0
5;91;913;915;2;112;2.0
5;92;915;923;8;112;2.0
5;93;923;927;4;112;2.0
5;94;927;931;4;112;2.0
5;95;931;938;7;112;2.0
5;96;938;939;1;112;2.0
5;97;939;940;1;112;2.0
5;98;940;943;3;112;2.0
5;99;943;955;12;112;2.0
5;100;955;958;3;112;2.0
5;101;958;961;3;112;2.0
5;102;961;968;7;112;2.0
5;103;968;973;5;112;2.0
5;104;973;975;2;112;2.0
5;105;975;978;3;112;2.0
5;106;978;982;4;112;2.0
5;107;982;993;11;112;2.0
5;108;993;995;2;112;2.0
5;109;995;999;4;112;2.0
5;110;999;1003;4;112;2.0
5;111;1003;1017;14;112;2.0
5;112;1017;1021;4;112;2.0
5;113;1021;1025;4;112;2.0
5;114;1025;1028;3;112;2.0
5;115;1028;1033;5;112;2.0
5;116;1033;1043;10;112;2.0
5;117;1043;1045;2;112;2.0
5;118;1045;1059;14;112;2.0
5;119;1059;1063;4;112;2.0
5;120;1063;1065;2;112;2.0
5;121;1065;1072;7;112;2.0
5;122;1072;1083;11;112;2.0
5;123;1083;1085;2;112;2.0
5;124;1085;1088;3;112;2.0
5;125;1088;1095;7;112;2.0
5;126;1095;1098;3;112;2.0
5;127;1098;1101;3;112;2.0
5;128;1101;1102;1;112;2.0
5;129;1102;1123;21;112;2.0
5;130;1123;1143;20;112;2.0
5;131;1143;1144;1;112;2.0
5;132;1144;1171;27;112;2.0
5;133;1171;1178;7;112;2.0
5;134;1178;1204;26;112;2.0
5;135;1204;1218;14;112;2.0
5;136;1218;1221;3;112;2.0
5;137;1221;1225;4;112;2.0
5;138;1225;1263;38;112;2.0
5;139;1263;1264;1;112;2.0
5;140;1264;1281;17;112;2.0
5;141;1281;1283;2;112;2.0
5;142;1283;1314;31;112;2.0
5;143;1314;1319;5;112;2.0
5;144;1319;1333;14;112;2.0
5;145;1333;1346;13;112;2.0
5;146;1346;1378;32;112;2.0
5;147;1378;1383;5;112;2.0
5;148;1383;1386;3;112;2.0
5;149;1386;1396;10;112;2.0
5;150;1396;1411;15;112;2.0
5;151;1411;1426;15;112;2.0
5;152;1426;1441;15;112;2.0
5;153;1441;1456;15;112;2.0
5;154;1456;1471;15;112;2.0
5;155;1471;1486;15;112;2.0
5;156;1486;1501;15;112;2.0
5;157;1501;1516;15;112;2.0
5;158;1516;1531;15;112;2.0
5;159;1531;1546;15;112;2.0
5;160;1546;1561;15;112;2.0
5;161;1561;1576;15;112;2.0
5;162;1576;1591;15;112;2.0
5;163;1591;1606;15;112;2.0
5;164;1606;1621;15;112;2.0
5;165;1621;1636;15;112;2.0
5;166;1636;1651;15;112;2.0
5;167;1651;1666;15;112;2.0
5;168;1666;1680;14;112;2.0
6;0;245;327;82;112;2.0
6;1;327;331;4;112;2.0
6;2;331;334;3;112;2.0
6;3;334;335;1;112;2.0
6;4;335;342;7;112;2.0
6;5;342;349;7;112;2.0
6;6;349;354;5;112;2.0
6;7;354;355;1;112;2.0
6;8;355;357;2;112;2.0
6;9;357;360;3;112;2.0
6;10;360;367;7;112;2.0
6;11;367;370;3;112;2.0
6;12;370;377;7;112;2.0
6;13;377;386;9;112;2.0
6;14;386;389;3;112;2.0
6;15;389;390;1;112;2.0
6;16;390;392;2;112;2.0
6;17;392;404;12;112;2.0
6;18;404;405;1;112;2.0
6;19;405;412;7;112;2.0
6;20;412;418;6;112;2.0
6;21;418;420;2;112;2.0
6;22;420;421;1;112;2.0
6;23;421;424;3;112;2.0
6;24;424;425;1;112;2.0
6;25;425;430;5;112;2.0
6;26;430;440;10;112;2.0
6;27;440;447;7;112;2.0
6;28;447;449;2;112;2.0
6;29;449;450;1;112;2.0
6;30;450;453;3;112;2.0
6;31;453;460;7;112;2.0
6;32;460;462;2;112;2.0
6;33;462;463;1;112;2.0
6;34;463;464;1;112;2.0
6;35;464;473;9;112;2.0
6;36;473;479;6;112;2.0
6;37;479;485;6;112;2.0
6;38;485;494;9;112;2.0
6;39;494;495;1;112;2.0
6;40;495;503;8;112;2.0
6;41;503;504;1;112;2.0
6;42;504;513;9;112;2.0
6;43;513;516;3;112;2.0
6;44;516;525;9;112;2.0
6;45;525;527;2;112;2.0
6;46;527;543;16;112;2.0
6;47;543;549;6;112;2.0
6;48;549;550;1;112;2.0
6;49;550;580;30;112;2.0
6;50;580;588;8;112;2.0
6;51;588;589;1;112;2.0
6;52;589;593;4;112;2.0
6;53;593;618;25;112;2.0
6;54;618;630;12;112;2.0
6;55;630;631;1;112;2.0
6;56;631;652;21;112;2.0
6;57;652;658;6;112;2.0
6;58;658;683;25;112;2.0
6;59;683;700;17;112;2.0
6;60;700;709;9;112;2.0
6;61;709;718;9;112;2.0
6;62;718;723;5;112;2.0
6;63;723;738;15;112;2.0
6;64;738;742;4;112;2.0
6;65;742;751;9;112;2.0
6;66;751;760;9;112;2.0
6;67;760;763;3;112;2.0
6;68;763;778;15;112;2.0
6;69;778;793;15;112;2.0
6;70;793;795;2;112;2.0
6;71;795;814;19;112;2.0
6;72;814;817;3;112;2.0
6;73;817;820;3;112;2.0
6;74;820;833;13;112;2.0
6;75;833;834;1;112;2.0
6;76;834;835;1;112;2.0
6;77;835;845;10;112;2.0
6;78;845;848;3;112;2.0
6;79;848;863;15;112;2.0
6;80;863;865;2;112;2.0
6;81;865;867;2;112;2.0
6;82;867;878;11;112;2.0
6;83;878;879;1;112;2.0
6;84;879;880;1;112;2.0
6;85;880;888;8;112;2.0
6;86;888;900;12;112;2.0
6;87;900;901;1;112;2.0
6;88;901;903;2;112;2.0
6;89;903;908;5;112;2.0
6;90;908;913;5;112;2.0
6;91;913;915;2;112;2.0
6;92;915;923;8;112;2.0
6;93;923;927;4;112;2.0
6;94;927;931;4;112;2.0
6;95;931;938;7;112;2.0
6;96;938;939;1;112;2.0
6;97;939;940;1;112;2.0
6;98;940;943;3;112;2.0
6;99;943;955;12;112;2.0
6;100;955;958;3;112;2.0
6;101;958;961;3;112;2.0
6;102;961;968;7;112;2.0
6;103;968;973;5;112;2.0
6;104;973;975;2;112;2.0
6;105;975;978;3;112;2.0
6;106;978;982;4;112;2.0
6;107;982;993;11;112;2.0
6;108;993;995;2;112;2.0
6;109;995;999;4;112;2.0
6;110;999;1003;4;112;2.0
6;111;1003;1017;14;112;2.0
6;112;1017;1021;4;112;2.0
6;113;1021;1025;4;112;2.0
6;114;1025;1028;3;112;2.0
6;115;1028;1033;5;112;2.0
6;116;1033;1043;10;112;2.0
6;117;1043;1045;2;112;2.0
6;118;1045;1059;14;112;2.0
6;119;1059;1063;4;112;2.0
6;120;1063;1065;2;112;2.0
6;121;1065;1072;7;112;2.0
6;122;1072;1083;11;112;2.0
6;123;1083;1085;2;112;2.0
6;124;1085;1088;3;112;2.0
6;125;1088;1095;7;112;2.0
6;126;1095;1098;3;112;2.0
6;127;1098;1101;3;112;2.0
6;128;1101;1102;1;112;2.0
6;129;1102;1123;21;112;2.0
6;130;1123;1143;20;112;2.0
6;131;1143;1144;1;112;2.0
6;132;1144;1171;27;112;2.0
6;133;1171;1178;7;112;2.0
6;134;1178;1204;26;112;2.0
6;135;1204;1218;14;112;2.0
6;136;1218;1221;3;112;2.0
6;137;1221;1225;4;112;2.0
6;138;1225;1263;38;112;2.0
6;139;1263;1264;1;112;2.0
6;140;1264;1281;17;112;2.0
6;141;1281;1283;2;112;2.0
6;142;1283;1314;31;112;2.0
6;143;1314;1319;5;112;2.0
6;144;1319;1333;14;112;2.0
6;145;1333;1346;13;112;2.0
6;146;1346;1378;32;112;2.0
6;147;1378;1383;5;112;2.0
6;148;1383;1386;3;112;2.0
6;149;1386;1396;10;112;2.0
6;150;1396;1411;15;112;2.0
6;151;1411;1426;15;112;2.0
6;152;1426;1441;15;112;2.0
6;153;1441;1456;15;112;2.0
6;154;1456;1471;15;112;2.0
6;155;1471;1486;15;112;2.0
6;156;1486;1501;15;112;2.0
6;157;1501;1516;15;112;2.0
6;158;1516;1531;15;112;2.0
6;159;1531;1546;15;112;2.0
6;160;1546;1561;15;112;2.0
6;161;1561;1576;15;112;2.0
6;162;1576;1591;15;112;2.0
6;163;1591;1606;15;112;2.0
6;164;1606;1621;15;112;2.0
6;165;1621;1636;15;112;2.0
6;166;1636;1651;15;112;2.0
6;167;1651;1666;15;112;2.0
6;168;1666;1680;14;112;2.0
7;0;240;330;90;28;0.83
7;1;330;331;1;28;0.83
7;2;331;333;2;28;0.83
7;3;333;336;3;28;0.83
7;4;336;346;10;28;0.83
7;5;346;351;5;28;0.83
7;6;351;353;2;28;0.83
7;7;353;356;3;28;0.83
7;8;356;357;1;28;0.83
7;9;357;361;4;28;0.83
7;10;361;367;6;28;0.83
7;11;367;368;1;28;0.83
7;12;368;371;3;28;0.83
7;13;371;381;10;28;0.83
7;14;381;384;3;28;0.83
7;15;384;387;3;28;0.83
7;16;387;388;1;28;0.83
7;17;388;391;3;28;0.83
7;18;391;396;5;28;0.83
7;19;396;403;7;28;0.83
7;20;403;406;3;28;0.83
7;21;406;416;10;28;0.83
7;22;416;417;1;28;0.83
7;23;417;418;1;28;0.83
7;24;418;423;5;28;0.83
7;25;423;427;4;28;0.83
7;26;427;428;1;28;0.83
7;27;428;438;10;28;0.83
7;28;438;447;9;28;0.83
7;29;447;448;1;28;0.83
7;30;448;451;3;28;0.83
7;31;451;452;1;28;0.83
7;32;452;453;1;28;0.83
7;33;453;458;5;28;0.83
7;34;458;459;1;28;0.83
7;35;459;463;4;28;0.83
7;36;463;466;3;28;0.83
7;37;466;473;7;28;0.83
7;38;473;481;8;28;0.83
7;39;481;482;1;28;0.83
7;40;482;493;11;28;0.83
7;41;493;498;5;28;0.83
7;42;498;501;3;28;0.83
7;43;501;504;3;28;0.83
7;44;504;513;9;28;0.83
7;45;513;514;1;28;0.83
7;46;514;523;9;28;0.83
7;47;523;531;8;28;0.83
7;48;531;543;12;28;0.83
7;49;543;547;4;28;0.83
7;50;547;549;2;28;0.83
7;51;549;578;29;28;0.83
7;52;578;590;12;28;0.83
7;53;590;593;3;28;0.83
7;54;593;617;24;28;0.83
7;55;617;627;10;28;0.83
7;56;627;628;1;28;0.83
7;57;628;629;1;28;0.83
7;58;629;656;27;28;0.83
7;59;656;660;4;28;0.83
7;60;660;681;21;28;0.83
7;61;681;698;17;28;0.83
7;62;698;713;15;28;0.83
7;63;713;718;5;28;0.83
7;64;718;725;7;28;0.83
7;65;725;737;12;28;0.83
7;66;737;746;9;28;0.83
7;67;746;749;3;28;0.83
7;68;749;758;9;28;0.83
7;69;758;760;2;28;0.83
7;70;760;778;18;28;0.83
7;71;778;793;15;28;0.83
7;72;793;795;2;28;0.83
7;73;795;818;23;28;0.83
7;74;818;821;3;28;0.83
7;75;821;830;9;28;0.83
7;76;830;832;2;28;0.83
7;77;832;833;1;28;0.83
7;78;833;837;4;28;0.83
7;79;837;843;6;28;0.83
7;80;843;850;7;28;0.83
7;81;850;863;13;28;0.83
7;82;863;865;2;28;0.83
7;83;865;871;6;28;0.83
7;84;871;877;6;28;0.83
7;85;877;878;1;28;0.83
7;86;878;880;2;28;0.83
7;87;880;883;3;28;0.83
7;88;883;885;2;28;0.83
7;89;885;888;3;28;0.83
7;90;888;898;10;28;0.83
7;91;898;899;1;28;0.83
7;92;899;903;4;28;0.83
7;93;903;910;7;28;0.83
7;94;910;913;3;28;0.83
7;95;913;922;9;28;0.83
7;96;922;929;7;28;0.83
7;97;929;931;2;28;0.83
7;98;931;938;7;28;0.83
7;99;938;940;2;28;0.83
7;100;940;943;3;28;0.83
7;101;943;945;2;28;0.83
7;102;945;953;8;28;0.83
7;103;953;958;5;28;0.83
7;104;958;959;1;28;0.83
7;105;959;970;11;28;0.83
7;106;970;973;3;28;0.83
7;107;973;978;5;28;0.83
7;108;978;980;2;28;0.83
7;109;980;993;13;28;0.83
7;110;993;1000;7;28;0.83
7;111;1000;1003;3;28;0.83
7;112;1003;1019;16;28;0.83
7;113;1019;1021;2;28;0.83
7;114;1021;1023;2;28;0.83
7;115;1023;1030;7;28;0.83
7;116;1030;1043;13;28;0.83
7;117;1043;1060;17;28;0.83
7;118;1060;1063;3;28;0.83
7;119;1063;1065;2;28;0.83
7;120;1065;1076;11;28;0.83
7;121;1076;1083;7;28;0.83
7;122;1083;1087;4;28;0.83
7;123;1087;1093;6;28;0.83
7;124;1093;1098;5;28;0.83
7;125;1098;1100;2;28;0.83
7;126;1100;1101;1;28;0.83
7;127;1101;1120;19;28;0.83
7;128;1120;1142;22;28;0.83
7;129;1142;1147;5;28;0.83
7;130;1147;1171;24;28;0.83
7;131;1171;1176;5;28;0.83
7;132;1176;1202;26;28;0.83
7;133;1202;1217;15;28;0.83
7;134;1217;1221;4;28;0.83
7;135;1221;1223;2;28;0.83
7;136;1223;1262;39;28;0.83
7;137;1262;1267;5;28;0.83
7;138;1267;1281;14;28;0.83
7;139;1281;1312;31;28;0.83
7;140;1312;1321;9;28;0.83
7;141;1321;1337;16;28;0.83
7;142;1337;1344;7;28;0.83
7;143;1344;1376;32;28;0.83
7;144;1376;1386;10;28;0.83
7;145;1386;1387;1;28;0.83
7;146;1387;1394;7;28;0.83
7;147;1394;1409;15;28;0.83
7;148;1409;1424;15;28;0.83
7;149;1424;1439;15;28;0.83
7;150;1439;1454;15;28;0.83
7;151;1454;1469;15;28;0.83
7;152;1469;1484;15;28;0.83
7;153;1484;1499;15;28;0.83
7;154;1499;1514;15;28;0.83
7;155;1514;1529;15;28;0.83
7;156;1529;1544;15;28;0.83
7;157;1544;1559;15;28;0.83
7;158;1559;1574;15;28;0.83
7;159;1574;1589;15;28;0.83
7;160;1589;1604;15;28;0.83
7;161;1604;1619;15;28;0.83
7;162;1619;1634;15;28;0.83
7;163;1634;1649;15;28;0.83
7;164;1649;1664;15;28;0.83
7;165;1664;1679;15;28;0.83
7;166;1679;1680;1;28;0.83
8;0;240;330;90;28;0.83
8;1;330;331;1;28;0.83
8;2;331;333;2;28;0.83
8;3;333;336;3;28;0.83
8;4;336;346;10;28;0.83
8;5;346;351;5;28;0.83
8;6;351;353;2;28;0.83
8;7;353;356;3;28;0.83
8;8;356;357;1;28;0.83
8;9;357;361;4;28;0.83
8;10;361;367;6;28;0.83
8;11;367;368;1;28;0.83
8;12;368;371;3;28;0.83
8;13;371;381;10;28;0.83
8;14;381;384;3;28;0.83
8;15;384;387;3;28;0.83
8;16;387;388;1;28;0.83
8;17;388;391;3;28;0.83
8;18;391;396;5;28;0.83
8;19;396;403;7;28;0.83
8;20;403;406;3;28;0.83
8;21;406;416;10;28;0.83
8;22;416;417;1;28;0.83
8;23;417;418;1;28;0.83
8;24;418;423;5;28;0.83
8;25;423;427;4;28;0.83
8;26;427;428;1;28;0.83
8;27;428;438;10;28;0.83
8;28;438;447;9;28;0.83
8;29;447;448;1;28;0.83
8;30;448;451;3;28;0.83
8;31;451;452;1;28;0.83
8;32;452;453;1;28;0.83
8;33;453;458;5;28;0.83
8;34;458;459;1;28;0.83
8;35;459;463;4;28;0.83
8;36;463;466;3;28;0.83
8;37;466;473;7;28;0.83
8;38;473;481;8;28;0.83
8;39;481;482;1;28;0.83
8;40;482;493;11;28;0.83
8;41;493;498;5;28;0.83
8;42;498;501;3;28;0.83
8;43;501;504;3;28;0.83
8;44;504;513;9;28;0.83
8;45;513;514;1;28;0.83
8;46;514;523;9;28;0.83
8;47;523;531;8;28;0.83
8;48;531;543;12;28;0.83
8;49;543;547;4;28;0.83
8;50;547;549;2;28;0.83
8;51;549;578;29;28;0.83
8;52;578;590;12;28;0.83
8;53;590;593;3;28;0.83
8;54;593;617;24;28;0.83
8;55;617;627;10;28;0.83
8;56;627;628;1;28;0.83
8;57;628;629;1;28;0.83
8;58;629;656;27;28;0.83
8;59;656;660;4;28;0.83
8;60;660;681;21;28;0.83
8;61;681;698;17;28;0.83
8;62;698;713;15;28;0.83
8;63;713;718;5;28;0.83
8;64;718;725;7;28;0.83
8;65;725;737;12;28;0.83
8;66;737;746;9;28;0.83
8;67;746;749;3;28;0.83
8;68;749;758;9;28;0.83
8;69;758;760;2;28;0.83
8;70;760;778;18;28;0.83
8;71;778;793;15;28;0.83
8;72;793;795;2;28;0.83
8;73;795;818;23;28;0.83
8;74;818;821;3;28;0.83
8;75;821;830;9;28;0.83
8;76;830;832;2;28;0.83
8;77;832;833;1;28;0.83
8;78;833;837;4;28;0.83
8;79;837;843;6;28;0.83
8;80;843;850;7;28;0.83
8;81;850;863;13;28;0.83
8;82;863;865;2;28;0.83
8;83;865;871;6;28;0.83
8;84;871;877;6;28;0.83
8;85;877;878;1;28;0.83
8;86;878;880;2;28;0.83
8;87;880;883;3;28;0.83
8;88;883;885;2;28;0.83
8;89;885;888;3;28;0.83
8;90;888;898;10;28;0.83
8;91;898;899;1;28;0.83
8;92;899;903;4;28;0.83
8;93;903;910;7;28;0.83
8;94;910;913;3;28;0.83
8;95;913;922;9;28;0.83
8;96;922;929;7;28;0.83
8;97;929;931;2;28;0.83
8;98;931;938;7;28;0.83
8;99;938;940;2;28;0.83
8;100;940;943;3;28;0.83
8;101;943;945;2;28;0.83
8;102;945;953;8;28;0.83
8;103;953;958;5;28;0.83
8;104;958;959;1;28;0.83
8;105;959;970;11;28;0.83
8;106;970;973;3;28;0.83
8;107;973;978;5;28;0.83
8;108;978;980;2;28;0.83
8;109;980;993;13;28;0.83
8;110;993;1000;7;28;0.83
8;111;1000;1003;3;28;0.83
8;112;1003;1019;16;28;0.83
8;113;1019;1021;2;28;0.83
8;114;1021;1023;2;28;0.83
8;115;1023;1030;7;28;0.83
8;116;1030;1043;13;28;0.83
8;117;1043;1060;17;28;0.83
8;118;1060;1063;3;28;0.83
8;119;1063;1065;2;28;0.83
8;120;1065;1076;11;28;0.83
8;121;1076;1083;7;28;0.83
8;122;1083;1087;4;28;0.83
8;123;1087;1093;6;28;0.83
8;124;1093;1098;5;28;0.83
8;125;1098;1100;2;28;0.83
8;126;1100;1101;1;28;0.83
8;127;1101;1120;19;28;0.83
8;128;1120;1142;22;28;0.83
8;129;1142;1147;5;28;0.83
8;130;1147;1171;24;28;0.83
8;131;1171;1176;5;28;0.83
8;132;1176;1202;26;28;0.83
8;133;1202;1217;15;28;0.83
8;134;1217;1221;4;28;0.83
8;135;1221;1223;2;28;0.83
8;136;1223;1262;39;28;0.83
8;137;1262;1267;5;28;0.83
8;138;1267;1281;14;28;0.83
8;139;1281;1312;31;28;0.83
8;140;1312;1321;9;28;0.83
8;141;1321;1337;16;28;0.83
8;142;1337;1344;7;28;0.83
8;143;1344;1376;32;28;0.83
8;144;1376;1386;10;28;0.83
8;145;1386;1387;1;28;0.83
8;146;1387;1394;7;28;0.83
8;147;1394;1409;15;28;0.83
8;148;1409;1424;15;28;0.83
8;149;1424;1439;15;28;0.83
8;150;1439;1454;15;28;0.83
8;151;1454;1469;15;28;0.83
8;152;1469;1484;15;28;0.83
8;153;1484;1499;15;28;0.83
8;154;1499;1514;15;28;0.83
8;155;1514;1529;15;28;0.83
8;156;1529;1544;15;28;0.83
8;157;1544;1559;15;28;0.83
8;158;1559;1574;15;28;0.83
8;159;1574;1589;15;28;0.83
8;160;1589;1604;15;28;0.83
8;161;1604;1619;15;28;0.83
8;162;1619;1634;15;28;0.83
8;163;1634;1649;15;28;0.83
8;164;1649;1664;15;28;0.83
8;165;1664;1679;15;28;0.83
8;166;1679;1680;1;28;0.83
9;0;240;330;90;28;0.83
9;1;330;331;1;28;0.83
9;2;331;333;2;28;0.83
9;3;333;336;3;28;0.83
9;4;336;346;10;28;0.83
9;5;346;351;5;28;0.83
9;6;351;353;2;28;0.83
9;7;353;356;3;28;0.83
9;8;356;357;1;28;0.83
9;9;357;361;4;28;0.83
9;10;361;367;6;28;0.83
9;11;367;368;1;28;0.83
9;12;368;371;3;28;0.83
9;13;371;381;10;28;0.83
9;14;381;384;3;28;0.83
9;15;384;387;3;28;0.83
9;16;387;388;1;28;0.83
9;17;388;391;3;28;0.83
9;18;391;396;5;28;0.83
9;19;396;403;7;28;0.83
9;20;403;406;3;28;0.83
9;21;406;416;10;28;0.83
9;22;416;417;1;28;0.83
9;23;417;418;1;28;0.83
9;24;418;423;5;28;0.83
9;25;423;427;4;28;0.83
9;26;427;428;1;28;0.83
9;27;428;438;10;28;0.83
9;28;438;447;9;28;0.83
9;29;447;448;1;28;0.83
9;30;448;451;3;28;0.83
9;31;451;452;1;28;0.83
9;32;452;453;1;28;0.83
9;33;453;458;5;28;0.83
9;34;458;459;1;28;0.83
9;35;459;463;4;28;0.83
9;36;463;466;3;28;0.83
9;37;466;473;7;28;0.83
9;38;473;481;8;28;0.83
9;39;481;482;1;28;0.83
9;40;482;493;11;28;0.83
9;41;493;498;5;28;0.83
9;42;498;501;3;28;0.83
9;43;501;504;3;28;0.83
9;44;504;513;9;28;0.83
9;45;513;514;1;28;0.83
9;46;514;523;9;28;0.83
9;47;523;531;8;28;0.83
9;48;531;543;12;28;0.83
9;49;543;547;4;28;0.83
9;50;547;549;2;28;0.83
9;51;549;578;29;28;0.83
9;52;578;590;12;28;0.83
9;53;590;593;3;28;0.83
9;54;593;617;24;28;0.83
9;55;617;627;10;28;0.83
9;56;627;628;1;28;0.83
9;57;628;629;1;28;0.83
9;58;629;656;27;28;0.83
9;59;656;660;4;28;0.83
9;60;660;681;21;28;0.83
9;61;681;698;17;28;0.83
9;62;698;713;15;28;0.83
9;63;713;718;5;28;0.83
9;64;718;725;7;28;0.83
9;65;725;737;12;28;0.83
9;66;737;746;9;28;0.83
9;67;746;749;3;28;0.83
9;68;749;758;9;28;0.83
9;69;758;760;2;28;0.83
9;70;760;778;18;28;0.83
9;71;778;793;15;28;0.83
9;72;793;795;2;28;0.83
9;73;795;818;23;28;0.83
9;74;818;821;3;28;0.83
9;75;821;830;9;28;0.83
9;76;830;832;2;28;0.83
9;77;832;833;1;28;0.83
9;78;833;837;4;28;0.83
9;79;837;843;6;28;0.83
9;80;843;850;7;28;0.83
9;81;850;863;13;28;0.83
9;82;863;865;2;28;0.83
9;83;865;871;6;28;0.83
9;84;871;877;6;28;0.83
9;85;877;878;1;28;0.83
9;86;878;880;2;28;0.83
9;87;880;883;3;28;0.83
9;88;883;885;2;28;0.83
9;89;885;888;3;28;0.83
9;90;888;898;10;28;0.83
9;91;898;899;1;28;0.83
9;92;899;903;4;28;0.83
9;93;903;910;7;28;0.83
9;94;910;913;3;28;0.83
9;95;913;922;9;28;0.83
9;96;922;929;7;28;0.83
9;97;929;931;2;28;0.83
9;98;931;938;7;28;0.83
9;99;938;940;2;28;0.83
9;100;940;943;3;28;0.83
9;101;943;945;2;28;0.83
9;102;945;953;8;28;0.83
9;103;953;958;5;28;0.83
9;104;958;959;1;28;0.83
9;105;959;970;11;28;0.83
9;106;970;973;3;28;0.83
9;107;973;978;5;28;0.83
9;108;978;980;2;28;0.83
9;109;980;993;13;28;0.83
9;110;993;1000;7;28;0.83
9;111;1000;1003;3;28;0.83
9;112;1003;1019;16;28;0.83
9;113;1019;1021;2;28;0.83
9;114;1021;1023;2;28;0.83
9;115;1023;1030;7;28;0.83
9;116;1030;1043;13;28;0.83
9;117;1043;1060;17;28;0.83
9;118;1060;1063;3;28;0.83
9;119;1063;1065;2;28;0.83
9;120;1065;1076;11;28;0.83
9;121;1076;1083;7;28;0.83
9;122;1083;1087;4;28;0.83
9;123;1087;1093;6;28;0.83
9;124;1093;1098;5;28;0.83
9;125;1098;1100;2;28;0.83
9;126;1100;1101;1;28;0.83
9;127;1101;1120;19;28;0.83
9;128;1120;1142;22;28;0.83
9;129;1142;1147;5;28;0.83
9;130;1147;1171;24;28;0.83
9;131;1171;1176;5;28;0.83
9;132;1176;1202;26;28;0.83
9;133;1202;1217;15;28;0.83
9;134;1217;1221;4;28;0.83
9;135;1221;1223;2;28;0.83
9;136;1223;1262;39;28;0.83
9;137;1262;1267;5;28;0.83
9;138;1267;1281;14;28;0.83
9;139;1281;1312;31;28;0.83
9;140;1312;1321;9;28;0.83
9;141;1321;1337;16;28;0.83
9;142;1337;1344;7;28;0.83
9;143;1344;1376;32;28;0.83
9;144;1376;1386;10;28;0.83
9;145;1386;1387;1;28;0.83
9;146;1387;1394;7;28;0.83
9;147;1394;1409;15;28;0.83
9;148;1409;1424;15;28;0.83
9;149;1424;1439;15;28;0.83
9;150;1439;1454;15;28;0.83
9;151;1454;1469;15;28;0.83
9;152;1469;1484;15;28;0.83
9;153;1484;1499;15;28;0.83
9;154;1499;1514;15;28;0.83
9;155;1514;1529;15;28;0.83
9;156;1529;1544;15;28;0.83
9;157;1544;1559;15;28;0.83
9;158;1559;1574;15;28;0.83
9;159;1574;1589;15;28;0.83
9;160;1589;1604;15;28;0.83
9;161;1604;1619;15;28;0.83
9;162;1619;1634;15;28;0.83
9;163;1634;1649;15;28;0.83
9;164;1649;1664;15;28;0.83
9;165;1664;1679;15;28;0.83
9;166;1679;1680;1;28;0.83
10;0;240;330;90;28;0.83
10;1;330;331;1;28;0.83
10;2;331;333;2;28;0.83
10;3;333;336;3;28;0.83
10;4;336;346;10;28;0.83
10;5;346;351;5;28;0.83
10;6;351;353;2;28;0.83
10;7;353;356;3;28;0.83
10;8;356;357;1;28;0.83
10;9;357;361;4;28;0.83
10;10;361;367;6;28;0.83
10;11;367;368;1;28;0.83
10;12;368;371;3;28;0.83
10;13;371;381;10;28;0.83
10;14;381;384;3;28;0.83
10;15;384;387;3;28;0.83
10;16;387;388;1;28;0.83
10;17;388;391;3;28;0.83
10;18;391;396;5;28;0.83
10;19;396;403;7;28;0.83
10;20;403;406;3;28;0.83
10;21;406;416;10;28;0.83
10;22;416;417;1;28;0.83
10;23;417;418;1;28;0.83
10;24;418;423;5;28;0.83
10;25;423;427;4;28;0.83
10;26;427;428;1;28;0.83
10;27;428;438;10;28;0.83
10;28;438;447;9;28;0.83
10;29;447;448;1;28;0.83
10;30;448;451;3;28;0.83
10;31;451;452;1;28;0.83
10;32;452;453;1;28;0.83
10;33;453;458;5;28;0.83
10;34;458;459;1;28;0.83
10;35;459;463;4;28;0.83
10;36;463;466;3;28;0.83
10;37;466;473;7;28;0.83
10;38;473;481;8;28;0.83
10;39;481;482;1;28;0.83
10;40;482;493;11;28;0.83
10;41;493;498;5;28;0.83
10;42;498;501;3;28;0.83
10;43;501;504;3;28;0.83
10;44;504;513;9;28;0.83
10;45;513;514;1;28;0.83
10;46;514;523;9;28;0.83
10;47;523;531;8;28;0.83
10;48;531;543;12;28;0.83
10;49;543;547;4;28;0.83
10;50;547;549;2;28;0.83
10;51;549;578;29;28;0.83
10;52;578;590;12;28;0.83
10;53;590;593;3;28;0.83
10;54;593;617;24;28;0.83
10;55;617;627;10;28;0.83
10;56;627;628;1;28;0.83
10;57;628;629;1;28;0.83
10;58;629;656;27;28;0.83
10;59;656;660;4;28;0.83
10;60;660;681;21;28;0.83
10;61;681;698;17;28;0.83
10;62;698;713;15;28;0.83
10;63;713;718;5;28;0.83
10;64;718;725;7;28;0.83
10;65;725;737;12;28;0.83
10;66;737;746;9;28;0.83
10;67;746;749;3;28;0.83
10;68;749;758;9;28;0.83
10;69;758;760;2;28;0.83
10;70;760;778;18;28;0.83
10;71;778;793;15;28;0.83
10;72;793;795;2;28;0.83
10;73;795;818;23;28;0.83
10;74;818;821;3;28;0.83
10;75;821;830;9;28;0.83
10;76;830;832;2;28;0.83
10;77;832;833;1;28;0.83
10;78;833;837;4;28;0.83
10;79;837;843;6;28;0.83
10;80;843;850;7;28;0.83
10;81;850;863;13;28;0.83
10;82;863;865;2;28;0.83
10;83;865;871;6;28;0.83
10;84;871;877;6;28;0.83
10;85;877;878;1;28;0.83
10;86;878;880;2;28;0.83
10;87;880;883;3;28;0.83
10;88;883;885;2;28;0.83
10;89;885;888;3;28;0.83
10;90;888;898;10;28;0.83
10;91;898;899;1;28;0.83
10;92;899;903;4;28;0.83
10;93;903;910;7;28;0.83
10;94;910;913;3;28;0.83
10;95;913;922;9;28;0.83
10;96;922;929;7;28;0.83
10;97;929;931;2;28;0.83
10;98;931;938;7;28;0.83
10;99;938;940;2;28;0.83
10;100;940;943;3;28;0.83
10;101;943;945;2;28;0.83
10;102;945;953;8;28;0.83
10;103;953;958;5;28;0.83
10;104;958;959;1;28;0.83
10;105;959;970;11;28;0.83
10;106;970;973;3;28;0.83
10;107;973;978;5;28;0.83
10;108;978;980;2;28;0.83
10;109;980;993;13;28;0.83
10;110;993;1000;7;28;0.83
10;111;1000;1003;3;28;0.83
10;112;1003;1019;16;28;0.83
10;113;1019;1021;2;28;0.83
10;114;1021;1023;2;28;0.83
10;115;1023;1030;7;28;0.83
10;116;1030;1043;13;28;0.83
10;117;1043;1060;17;28;0.83
10;118;1060;1063;3;28;0.83
10;119;1063;1065;2;28;0.83
10;120;1065;1076;11;28;0.83
10;121;1076;1083;7;28;0.83
10;122;1083;1087;4;28;0.83
10;123;1087;1093;6;28;0.83
10;124;1093;1098;5;28;0.83
10;125;1098;1100;2;28;0.83
10;126;1100;1101;1;28;0.83
10;127;1101;1120;19;28;0.83
10;128;1120;1142;22;28;0.83
10;129;1142;1147;5;28;0.83
10;130;1147;1171;24;28;0.83
10;131;1171;1176;5;28;0.83
10;132;1176;1202;26;28;0.83
10;133;1202;1217;15;28;0.83
10;134;1217;1221;4;28;0.83
10;135;1221;1223;2;28;0.83
10;136;1223;1262;39;28;0.83
10;137;1262;1267;5;28;0.83
10;138;1267;1281;14;28;0.83
10;139;1281;1312;31;28;0.83
10;140;1312;1321;9;28;0.83
10;141;1321;1337;16;28;0.83
10;142;1337;1344;7;28;0.83
10;143;1344;1376;32;28;0.83
10;144;1376;1386;10;28;0.83
10;145;1386;1387;1;28;0.83
10;146;1387;1394;7;28;0.83
10;147;1394;1409;15;28;0.83
10;148;1409;1424;15;28;0.83
10;149;1424;1439;15;28;0.83
10;150;1439;1454;15;28;0.83
10;151;1454;1469;15;28;0.83
10;152;1469;1484;15;28;0.83
10;153;1484;1499;15;28;0.83
10;154;1499;1514;15;28;0.83
10;155;1514;1529;15;28;0.83
10;156;1529;1544;15;28;0.83
10;157;1544;1559;15;28;0.83
10;158;1559;1574;15;28;0.83
10;159;1574;1589;15;28;0.83
10;160;1589;1604;15;28;0.83
10;161;1604;1619;15;28;0.83
10;162;1619;1634;15;28;0.83
10;163;1634;1649;15;28;0.83
10;164;1649;1664;15;28;0.83
10;165;1664;1679;15;28;0.83
10;166;1679;1680;1;28;0.83
