Index Nabijacky;Index Udalosti;Cas Zaciatku;Cas Konca;CasTrvania;Miesto;Rychlost nabijania
0;0;242;280;38;42;2.0
0;1;280;324;44;42;2.0
0;2;324;327;3;42;2.0
0;3;327;328;1;42;2.0
0;4;328;330;2;42;2.0
0;5;330;332;2;42;2.0
0;6;332;333;1;42;2.0
0;7;333;334;1;42;2.0
0;8;334;336;2;42;2.0
0;9;336;338;2;42;2.0
0;10;338;339;1;42;2.0
0;11;339;340;1;42;2.0
0;12;340;341;1;42;2.0
0;13;341;343;2;42;2.0
0;14;343;345;2;42;2.0
0;15;345;347;2;42;2.0
0;16;347;349;2;42;2.0
0;17;349;351;2;42;2.0
0;18;351;353;2;42;2.0
0;19;353;354;1;42;2.0
0;20;354;355;1;42;2.0
0;21;355;356;1;42;2.0
0;22;356;357;1;42;2.0
0;23;357;358;1;42;2.0
0;24;358;360;2;42;2.0
0;25;360;361;1;42;2.0
0;26;361;362;1;42;2.0
0;27;362;363;1;42;2.0
0;28;363;366;3;42;2.0
0;29;366;367;1;42;2.0
0;30;367;368;1;42;2.0
0;31;368;369;1;42;2.0
0;32;369;376;7;42;2.0
0;33;376;377;1;42;2.0
0;34;377;379;2;42;2.0
0;35;379;380;1;42;2.0
0;36;380;382;2;42;2.0
0;37;382;383;1;42;2.0
0;38;383;386;3;42;2.0
0;39;386;387;1;42;2.0
0;40;387;388;1;42;2.0
0;41;388;389;1;42;2.0
0;42;389;390;1;42;2.0
0;43;390;391;1;42;2.0
0;44;391;392;1;42;2.0
0;45;392;393;1;42;2.0
0;46;393;394;1;42;2.0
0;47;394;395;1;42;2.0
0;48;395;396;1;42;2.0
0;49;396;399;3;42;2.0
0;50;399;400;1;42;2.0
0;51;400;402;2;42;2.0
0;52;402;403;1;42;2.0
0;53;403;404;1;42;2.0
0;54;404;405;1;42;2.0
0;55;405;406;1;42;2.0
0;56;406;407;1;42;2.0
0;57;407;408;1;42;2.0
0;58;408;409;1;42;2.0
0;59;409;410;1;42;2.0
0;60;410;411;1;42;2.0
0;61;411;413;2;42;2.0
0;62;413;414;1;42;2.0
0;63;414;415;1;42;2.0
0;64;415;416;1;42;2.0
0;65;416;417;1;42;2.0
0;66;417;418;1;42;2.0
0;67;418;419;1;42;2.0
0;68;419;420;1;42;2.0
0;69;420;421;1;42;2.0
0;70;421;423;2;42;2.0
0;71;423;424;1;42;2.0
0;72;424;426;2;42;2.0
0;73;426;427;1;42;2.0
0;74;427;428;1;42;2.0
0;75;428;429;1;42;2.0
0;76;429;430;1;42;2.0
0;77;430;433;3;42;2.0
0;78;433;435;2;42;2.0
0;79;435;436;1;42;2.0
0;80;436;438;2;42;2.0
0;81;438;439;1;42;2.0
0;82;439;440;1;42;2.0
0;83;440;441;1;42;2.0
0;84;441;442;1;42;2.0
0;85;442;443;1;42;2.0
0;86;443;446;3;42;2.0
0;87;446;448;2;42;2.0
0;88;448;449;1;42;2.0
0;89;449;450;1;42;2.0
0;90;450;451;1;42;2.0
0;91;451;452;1;42;2.0
0;92;452;453;1;42;2.0
0;93;453;456;3;42;2.0
0;94;456;457;1;42;2.0
0;95;457;459;2;42;2.0
0;96;459;460;1;42;2.0
0;97;460;461;1;42;2.0
0;98;461;463;2;42;2.0
0;99;463;465;2;42;2.0
0;100;465;466;1;42;2.0
0;101;466;467;1;42;2.0
0;102;467;468;1;42;2.0
0;103;468;469;1;42;2.0
0;104;469;470;1;42;2.0
0;105;470;471;1;42;2.0
0;106;471;473;2;42;2.0
0;107;473;476;3;42;2.0
0;108;476;477;1;42;2.0
0;109;477;478;1;42;2.0
0;110;478;479;1;42;2.0
0;111;479;480;1;42;2.0
0;112;480;481;1;42;2.0
0;113;481;482;1;42;2.0
0;114;482;483;1;42;2.0
0;115;483;486;3;42;2.0
0;116;486;488;2;42;2.0
0;117;488;489;1;42;2.0
0;118;489;490;1;42;2.0
0;119;490;491;1;42;2.0
0;120;491;492;1;42;2.0
0;121;492;493;1;42;2.0
0;122;493;494;1;42;2.0
0;123;494;495;1;42;2.0
0;124;495;496;1;42;2.0
0;125;496;497;1;42;2.0
0;126;497;498;1;42;2.0
0;127;498;499;1;42;2.0
0;128;499;502;3;42;2.0
0;129;502;503;1;42;2.0
0;130;503;505;2;42;2.0
0;131;505;506;1;42;2.0
0;132;506;509;3;42;2.0
0;133;509;511;2;42;2.0
0;134;511;512;1;42;2.0
0;135;512;513;1;42;2.0
0;136;513;516;3;42;2.0
0;137;516;517;1;42;2.0
0;138;517;519;2;42;2.0
0;139;519;522;3;42;2.0
0;140;522;523;1;42;2.0
0;141;523;524;1;42;2.0
0;142;524;526;2;42;2.0
0;143;526;529;3;42;2.0
0;144;529;530;1;42;2.0
0;145;530;533;3;42;2.0
0;146;533;535;2;42;2.0
0;147;535;536;1;42;2.0
0;148;536;539;3;42;2.0
0;149;539;540;1;42;2.0
0;150;540;541;1;42;2.0
0;151;541;543;2;42;2.0
0;152;543;544;1;42;2.0
0;153;544;546;2;42;2.0
0;154;546;547;1;42;2.0
0;155;547;548;1;42;2.0
0;156;548;549;1;42;2.0
0;157;549;552;3;42;2.0
0;158;552;554;2;42;2.0
0;159;554;556;2;42;2.0
0;160;556;557;1;42;2.0
0;161;557;558;1;42;2.0
0;162;558;559;1;42;2.0
0;163;559;560;1;42;2.0
0;164;560;563;3;42;2.0
0;165;563;566;3;42;2.0
0;166;566;569;3;42;2.0
0;167;569;570;1;42;2.0
0;168;570;571;1;42;2.0
0;169;571;573;2;42;2.0
0;170;573;576;3;42;2.0
0;171;576;578;2;42;2.0
0;172;578;579;1;42;2.0
0;173;579;580;1;42;2.0
0;174;580;583;3;42;2.0
0;175;583;586;3;42;2.0
0;176;586;587;1;42;2.0
0;177;587;589;2;42;2.0
0;178;589;590;1;42;2.0
0;179;590;591;1;42;2.0
0;180;591;593;2;42;2.0
0;181;593;596;3;42;2.0
0;182;596;597;1;42;2.0
0;183;597;599;2;42;2.0
0;184;599;600;1;42;2.0
0;185;600;603;3;42;2.0
0;186;603;606;3;42;2.0
0;187;606;608;2;42;2.0
0;188;608;609;1;42;2.0
0;189;609;610;1;42;2.0
0;190;610;613;3;42;2.0
0;191;613;616;3;42;2.0
0;192;616;617;1;42;2.0
0;193;617;618;1;42;2.0
0;194;618;619;1;42;2.0
0;195;619;620;1;42;2.0
0;196;620;622;2;42;2.0
0;197;622;623;1;42;2.0
0;198;623;624;1;42;2.0
0;199;624;626;2;42;2.0
0;200;626;627;1;42;2.0
0;201;627;628;1;42;2.0
0;202;628;629;1;42;2.0
0;203;629;630;1;42;2.0
0;204;630;631;1;42;2.0
0;205;631;632;1;42;2.0
0;206;632;636;4;42;2.0
0;207;636;639;3;42;2.0
0;208;639;640;1;42;2.0
0;209;640;643;3;42;2.0
0;210;643;646;3;42;2.0
0;211;646;649;3;42;2.0
0;212;649;653;4;42;2.0
0;213;653;655;2;42;2.0
0;214;655;656;1;42;2.0
0;215;656;657;1;42;2.0
0;216;657;659;2;42;2.0
0;217;659;660;1;42;2.0
0;218;660;663;3;42;2.0
0;219;663;666;3;42;2.0
0;220;666;668;2;42;2.0
0;221;668;669;1;42;2.0
0;222;669;670;1;42;2.0
0;223;670;672;2;42;2.0
0;224;672;676;4;42;2.0
0;225;676;679;3;42;2.0
0;226;679;680;1;42;2.0
0;227;680;683;3;42;2.0
0;228;683;686;3;42;2.0
0;229;686;689;3;42;2.0
0;230;689;690;1;42;2.0
0;231;690;691;1;42;2.0
0;232;691;692;1;42;2.0
0;233;692;693;1;42;2.0
0;234;693;696;3;42;2.0
0;235;696;699;3;42;2.0
0;236;699;700;1;42;2.0
0;237;700;703;3;42;2.0
0;238;703;704;1;42;2.0
0;239;704;706;2;42;2.0
0;240;706;708;2;42;2.0
0;241;708;709;1;42;2.0
0;242;709;711;2;42;2.0
0;243;711;713;2;42;2.0
0;244;713;716;3;42;2.0
0;245;716;717;1;42;2.0
0;246;717;719;2;42;2.0
0;247;719;720;1;42;2.0
0;248;720;723;3;42;2.0
0;249;723;725;2;42;2.0
0;250;725;726;1;42;2.0
0;251;726;727;1;42;2.0
0;252;727;729;2;42;2.0
0;253;729;730;1;42;2.0
0;254;730;733;3;42;2.0
0;255;733;736;3;42;2.0
0;256;736;737;1;42;2.0
0;257;737;738;1;42;2.0
0;258;738;739;1;42;2.0
0;259;739;740;1;42;2.0
0;260;740;743;3;42;2.0
0;261;743;745;2;42;2.0
0;262;745;746;1;42;2.0
0;263;746;747;1;42;2.0
0;264;747;749;2;42;2.0
0;265;749;750;1;42;2.0
0;266;750;751;1;42;2.0
0;267;751;756;5;42;2.0
0;268;756;759;3;42;2.0
0;269;759;760;1;42;2.0
0;270;760;761;1;42;2.0
0;271;761;762;1;42;2.0
0;272;762;763;1;42;2.0
0;273;763;765;2;42;2.0
0;274;765;766;1;42;2.0
0;275;766;767;1;42;2.0
0;276;767;769;2;42;2.0
0;277;769;770;1;42;2.0
0;278;770;773;3;42;2.0
0;279;773;774;1;42;2.0
0;280;774;776;2;42;2.0
0;281;776;777;1;42;2.0
0;282;777;779;2;42;2.0
0;283;779;780;1;42;2.0
0;284;780;782;2;42;2.0
0;285;782;783;1;42;2.0
0;286;783;786;3;42;2.0
0;287;786;787;1;42;2.0
0;288;787;789;2;42;2.0
0;289;789;790;1;42;2.0
0;290;790;793;3;42;2.0
0;291;793;794;1;42;2.0
0;292;794;795;1;42;2.0
0;293;795;796;1;42;2.0
0;294;796;798;2;42;2.0
0;295;798;799;1;42;2.0
0;296;799;800;1;42;2.0
0;297;800;803;3;42;2.0
0;298;803;805;2;42;2.0
0;299;805;806;1;42;2.0
0;300;806;809;3;42;2.0
0;301;809;811;2;42;2.0
0;302;811;812;1;42;2.0
0;303;812;813;1;42;2.0
0;304;813;816;3;42;2.0
0;305;816;817;1;42;2.0
0;306;817;819;2;42;2.0
0;307;819;820;1;42;2.0
0;308;820;823;3;42;2.0
0;309;823;826;3;42;2.0
0;310;826;828;2;42;2.0
0;311;828;829;1;42;2.0
0;312;829;830;1;42;2.0
0;313;830;831;1;42;2.0
0;314;831;833;2;42;2.0
0;315;833;834;1;42;2.0
0;316;834;835;1;42;2.0
0;317;835;836;1;42;2.0
0;318;836;837;1;42;2.0
0;319;837;838;1;42;2.0
0;320;838;839;1;42;2.0
0;321;839;840;1;42;2.0
0;322;840;843;3;42;2.0
0;323;843;844;1;42;2.0
0;324;844;846;2;42;2.0
0;325;846;847;1;42;2.0
0;326;847;848;1;42;2.0
0;327;848;849;1;42;2.0
0;328;849;850;1;42;2.0
0;329;850;853;3;42;2.0
0;330;853;854;1;42;2.0
0;331;854;856;2;42;2.0
0;332;856;858;2;42;2.0
0;333;858;859;1;42;2.0
0;334;859;860;1;42;2.0
0;335;860;862;2;42;2.0
0;336;862;863;1;42;2.0
0;337;863;864;1;42;2.0
0;338;864;865;1;42;2.0
0;339;865;866;1;42;2.0
0;340;866;868;2;42;2.0
0;341;868;869;1;42;2.0
0;342;869;870;1;42;2.0
0;343;870;871;1;42;2.0
0;344;871;873;2;42;2.0
0;345;873;874;1;42;2.0
0;346;874;876;2;42;2.0
0;347;876;878;2;42;2.0
0;348;878;879;1;42;2.0
0;349;879;880;1;42;2.0
0;350;880;881;1;42;2.0
0;351;881;882;1;42;2.0
0;352;882;883;1;42;2.0
0;353;883;885;2;42;2.0
0;354;885;886;1;42;2.0
0;355;886;887;1;42;2.0
0;356;887;888;1;42;2.0
0;357;888;889;1;42;2.0
0;358;889;890;1;42;2.0
0;359;890;891;1;42;2.0
0;360;891;893;2;42;2.0
0;361;893;896;3;42;2.0
0;362;896;897;1;42;2.0
0;363;897;899;2;42;2.0
0;364;899;900;1;42;2.0
0;365;900;901;1;42;2.0
0;366;901;902;1;42;2.0
0;367;902;903;1;42;2.0
0;368;903;905;2;42;2.0
0;369;905;906;1;42;2.0
0;370;906;908;2;42;2.0
0;371;908;909;1;42;2.0
0;372;909;910;1;42;2.0
0;373;910;911;1;42;2.0
0;374;911;913;2;42;2.0
0;375;913;914;1;42;2.0
0;376;914;916;2;42;2.0
0;377;916;917;1;42;2.0
0;378;917;918;1;42;2.0
0;379;918;919;1;42;2.0
0;380;919;920;1;42;2.0
0;381;920;922;2;42;2.0
0;382;922;923;1;42;2.0
0;383;923;926;3;42;2.0
0;384;926;927;1;42;2.0
0;385;927;928;1;42;2.0
0;386;928;929;1;42;2.0
0;387;929;930;1;42;2.0
0;388;930;931;1;42;2.0
0;389;931;933;2;42;2.0
0;390;933;936;3;42;2.0
0;391;936;937;1;42;2.0
0;392;937;938;1;42;2.0
0;393;938;939;1;42;2.0
0;394;939;940;1;42;2.0
0;395;940;941;1;42;2.0
0;396;941;943;2;42;2.0
0;397;943;945;2;42;2.0
0;398;945;946;1;42;2.0
0;399;946;948;2;42;2.0
0;400;948;949;1;42;2.0
0;401;949;950;1;42;2.0
0;402;950;953;3;42;2.0
0;403;953;954;1;42;2.0
0;404;954;956;2;42;2.0
0;405;956;957;1;42;2.0
0;406;957;958;1;42;2.0
0;407;958;959;1;42;2.0
0;408;959;960;1;42;2.0
0;409;960;963;3;42;2.0
0;410;963;964;1;42;2.0
0;411;964;965;1;42;2.0
0;412;965;966;1;42;2.0
0;413;966;967;1;42;2.0
0;414;967;968;1;42;2.0
0;415;968;969;1;42;2.0
0;416;969;970;1;42;2.0
0;417;970;971;1;42;2.0
0;418;971;973;2;42;2.0
0;419;973;974;1;42;2.0
0;420;974;976;2;42;2.0
0;421;976;977;1;42;2.0
0;422;977;978;1;42;2.0
0;423;978;979;1;42;2.0
0;424;979;980;1;42;2.0
0;425;980;983;3;42;2.0
0;426;983;986;3;42;2.0
0;427;986;988;2;42;2.0
0;428;988;989;1;42;2.0
0;429;989;990;1;42;2.0
0;430;990;991;1;42;2.0
0;431;991;993;2;42;2.0
0;432;993;994;1;42;2.0
0;433;994;996;2;42;2.0
0;434;996;997;1;42;2.0
0;435;997;998;1;42;2.0
0;436;998;999;1;42;2.0
0;437;999;1000;1;42;2.0
0;438;1000;1001;1;42;2.0
0;439;1001;1002;1;42;2.0
0;440;1002;1003;1;42;2.0
0;441;1003;1005;2;42;2.0
0;442;1005;1006;1;42;2.0
0;443;1006;1008;2;42;2.0
0;444;1008;1009;1;42;2.0
0;445;1009;1010;1;42;2.0
0;446;1010;1012;2;42;2.0
0;447;1012;1013;1;42;2.0
0;448;1013;1016;3;42;2.0
0;449;1016;1017;1;42;2.0
0;450;1017;1018;1;42;2.0
0;451;1018;1019;1;42;2.0
0;452;1019;1020;1;42;2.0
0;453;1020;1021;1;42;2.0
0;454;1021;1024;3;42;2.0
0;455;1024;1025;1;42;2.0
0;456;1025;1028;3;42;2.0
0;457;1028;1029;1;42;2.0
0;458;1029;1030;1;42;2.0
0;459;1030;1031;1;42;2.0
0;460;1031;1032;1;42;2.0
0;461;1032;1033;1;42;2.0
0;462;1033;1035;2;42;2.0
0;463;1035;1036;1;42;2.0
0;464;1036;1039;3;42;2.0
0;465;1039;1040;1;42;2.0
0;466;1040;1041;1;42;2.0
0;467;1041;1042;1;42;2.0
0;468;1042;1043;1;42;2.0
0;469;1043;1044;1;42;2.0
0;470;1044;1046;2;42;2.0
0;471;1046;1048;2;42;2.0
0;472;1048;1049;1;42;2.0
0;473;1049;1050;1;42;2.0
0;474;1050;1054;4;42;2.0
0;475;1054;1055;1;42;2.0
0;476;1055;1056;1;42;2.0
0;477;1056;1057;1;42;2.0
0;478;1057;1059;2;42;2.0
0;479;1059;1060;1;42;2.0
0;480;1060;1061;1;42;2.0
0;481;1061;1063;2;42;2.0
0;482;1063;1064;1;42;2.0
0;483;1064;1065;1;42;2.0
0;484;1065;1066;1;42;2.0
0;485;1066;1068;2;42;2.0
0;486;1068;1069;1;42;2.0
0;487;1069;1070;1;42;2.0
0;488;1070;1072;2;42;2.0
0;489;1072;1073;1;42;2.0
0;490;1073;1074;1;42;2.0
0;491;1074;1075;1;42;2.0
0;492;1075;1076;1;42;2.0
0;493;1076;1077;1;42;2.0
0;494;1077;1078;1;42;2.0
0;495;1078;1079;1;42;2.0
0;496;1079;1081;2;42;2.0
0;497;1081;1082;1;42;2.0
0;498;1082;1084;2;42;2.0
0;499;1084;1085;1;42;2.0
0;500;1085;1087;2;42;2.0
0;501;1087;1088;1;42;2.0
0;502;1088;1089;1;42;2.0
0;503;1089;1090;1;42;2.0
0;504;1090;1091;1;42;2.0
0;505;1091;1092;1;42;2.0
0;506;1092;1093;1;42;2.0
0;507;1093;1095;2;42;2.0
0;508;1095;1096;1;42;2.0
0;509;1096;1098;2;42;2.0
0;510;1098;1099;1;42;2.0
0;511;1099;1100;1;42;2.0
0;512;1100;1101;1;42;2.0
0;513;1101;1106;5;42;2.0
0;514;1106;1107;1;42;2.0
0;515;1107;1108;1;42;2.0
0;516;1108;1109;1;42;2.0
0;517;1109;1110;1;42;2.0
0;518;1110;1111;1;42;2.0
0;519;1111;1115;4;42;2.0
0;520;1115;1116;1;42;2.0
0;521;1116;1118;2;42;2.0
0;522;1118;1119;1;42;2.0
0;523;1119;1120;1;42;2.0
0;524;1120;1121;1;42;2.0
0;525;1121;1127;6;42;2.0
0;526;1127;1129;2;42;2.0
0;527;1129;1132;3;42;2.0
0;528;1132;1133;1;42;2.0
0;529;1133;1136;3;42;2.0
0;530;1136;1138;2;42;2.0
0;531;1138;1139;1;42;2.0
0;532;1139;1140;1;42;2.0
0;533;1140;1141;1;42;2.0
0;534;1141;1142;1;42;2.0
0;535;1142;1143;1;42;2.0
0;536;1143;1145;2;42;2.0
0;537;1145;1146;1;42;2.0
0;538;1146;1148;2;42;2.0
0;539;1148;1150;2;42;2.0
0;540;1150;1152;2;42;2.0
0;541;1152;1153;1;42;2.0
0;542;1153;1154;1;42;2.0
0;543;1154;1156;2;42;2.0
0;544;1156;1157;1;42;2.0
0;545;1157;1158;1;42;2.0
0;546;1158;1160;2;42;2.0
0;547;1160;1163;3;42;2.0
0;548;1163;1169;6;42;2.0
0;549;1169;1170;1;42;2.0
0;550;1170;1171;1;42;2.0
0;551;1171;1173;2;42;2.0
0;552;1173;1174;1;42;2.0
0;553;1174;1176;2;42;2.0
0;554;1176;1177;1;42;2.0
0;555;1177;1179;2;42;2.0
0;556;1179;1180;1;42;2.0
0;557;1180;1183;3;42;2.0
0;558;1183;1187;4;42;2.0
0;559;1187;1189;2;42;2.0
0;560;1189;1197;8;42;2.0
0;561;1197;1198;1;42;2.0
0;562;1198;1199;1;42;2.0
0;563;1199;1200;1;42;2.0
0;564;1200;1201;1;42;2.0
0;565;1201;1202;1;42;2.0
0;566;1202;1203;1;42;2.0
0;567;1203;1208;5;42;2.0
0;568;1208;1211;3;42;2.0
0;569;1211;1217;6;42;2.0
0;570;1217;1219;2;42;2.0
0;571;1219;1221;2;42;2.0
0;572;1221;1225;4;42;2.0
0;573;1225;1227;2;42;2.0
0;574;1227;1228;1;42;2.0
0;575;1228;1229;1;42;2.0
0;576;1229;1230;1;42;2.0
0;577;1230;1233;3;42;2.0
0;578;1233;1237;4;42;2.0
0;579;1237;1246;9;42;2.0
0;580;1246;1250;4;42;2.0
0;581;1250;1253;3;42;2.0
0;582;1253;1254;1;42;2.0
0;583;1254;1256;2;42;2.0
0;584;1256;1261;5;42;2.0
0;585;1261;1262;1;42;2.0
0;586;1262;1263;1;42;2.0
0;587;1263;1265;2;42;2.0
0;588;1265;1267;2;42;2.0
0;589;1267;1268;1;42;2.0
0;590;1268;1269;1;42;2.0
0;591;1269;1271;2;42;2.0
0;592;1271;1272;1;42;2.0
0;593;1272;1273;1;42;2.0
0;594;1273;1275;2;42;2.0
0;595;1275;1278;3;42;2.0
0;596;1278;1279;1;42;2.0
0;597;1279;1280;1;42;2.0
0;598;1280;1286;6;42;2.0
0;599;1286;1287;1;42;2.0
0;600;1287;1290;3;42;2.0
0;601;1290;1294;4;42;2.0
0;602;1294;1298;4;42;2.0
0;603;1298;1300;2;42;2.0
0;604;1300;1303;3;42;2.0
0;605;1303;1304;1;42;2.0
0;606;1304;1307;3;42;2.0
0;607;1307;1308;1;42;2.0
0;608;1308;1311;3;42;2.0
0;609;1311;1312;1;42;2.0
0;610;1312;1313;1;42;2.0
0;611;1313;1317;4;42;2.0
0;612;1317;1321;4;42;2.0
0;613;1321;1322;1;42;2.0
0;614;1322;1323;1;42;2.0
0;615;1323;1326;3;42;2.0
0;616;1326;1328;2;42;2.0
0;617;1328;1330;2;42;2.0
0;618;1330;1336;6;42;2.0
0;619;1336;1337;1;42;2.0
0;620;1337;1339;2;42;2.0
0;621;1339;1340;1;42;2.0
0;622;1340;1342;2;42;2.0
0;623;1342;1343;1;42;2.0
0;624;1343;1348;5;42;2.0
0;625;1348;1350;2;42;2.0
0;626;1350;1356;6;42;2.0
0;627;1356;1358;2;42;2.0
0;628;1358;1360;2;42;2.0
0;629;1360;1361;1;42;2.0
0;630;1361;1363;2;42;2.0
0;631;1363;1364;1;42;2.0
0;632;1364;1365;1;42;2.0
0;633;1365;1369;4;42;2.0
0;634;1369;1373;4;42;2.0
0;635;1373;1376;3;42;2.0
0;636;1376;1377;1;42;2.0
0;637;1377;1381;4;42;2.0
0;638;1381;1382;1;42;2.0
0;639;1382;1384;2;42;2.0
0;640;1384;1385;1;42;2.0
0;641;1385;1387;2;42;2.0
0;642;1387;1392;5;42;2.0
0;643;1392;1407;15;42;2.0
0;644;1407;1422;15;42;2.0
0;645;1422;1437;15;42;2.0
0;646;1437;1452;15;42;2.0
0;647;1452;1467;15;42;2.0
0;648;1467;1482;15;42;2.0
0;649;1482;1497;15;42;2.0
0;650;1497;1512;15;42;2.0
0;651;1512;1527;15;42;2.0
0;652;1527;1542;15;42;2.0
0;653;1542;1557;15;42;2.0
0;654;1557;1572;15;42;2.0
0;655;1572;1587;15;42;2.0
0;656;1587;1602;15;42;2.0
0;657;1602;1617;15;42;2.0
0;658;1617;1632;15;42;2.0
0;659;1632;1647;15;42;2.0
0;660;1647;1662;15;42;2.0
0;661;1662;1677;15;42;2.0
0;662;1677;1680;3;42;2.0
1;0;243;284;41;93;2.0
1;1;284;323;39;93;2.0
1;2;323;326;3;93;2.0
1;3;326;327;1;93;2.0
1;4;327;329;2;93;2.0
1;5;329;331;2;93;2.0
1;6;331;332;1;93;2.0
1;7;332;334;2;93;2.0
1;8;334;335;1;93;2.0
1;9;335;336;1;93;2.0
1;10;336;338;2;93;2.0
1;11;338;340;2;93;2.0
1;12;340;343;3;93;2.0
1;13;343;344;1;93;2.0
1;14;344;345;1;93;2.0
1;15;345;346;1;93;2.0
1;16;346;347;1;93;2.0
1;17;347;348;1;93;2.0
1;18;348;349;1;93;2.0
1;19;349;351;2;93;2.0
1;20;351;352;1;93;2.0
1;21;352;353;1;93;2.0
1;22;353;354;1;93;2.0
1;23;354;355;1;93;2.0
1;24;355;356;1;93;2.0
1;25;356;358;2;93;2.0
1;26;358;359;1;93;2.0
1;27;359;360;1;93;2.0
1;28;360;361;1;93;2.0
1;29;361;362;1;93;2.0
1;30;362;363;1;93;2.0
1;31;363;364;1;93;2.0
1;32;364;365;1;93;2.0
1;33;365;366;1;93;2.0
1;34;366;367;1;93;2.0
1;35;367;368;1;93;2.0
1;36;368;370;2;93;2.0
1;37;370;371;1;93;2.0
1;38;371;372;1;93;2.0
1;39;372;373;1;93;2.0
1;40;373;376;3;93;2.0
1;41;376;378;2;93;2.0
1;42;378;379;1;93;2.0
1;43;379;380;1;93;2.0
1;44;380;382;2;93;2.0
1;45;382;383;1;93;2.0
1;46;383;385;2;93;2.0
1;47;385;386;1;93;2.0
1;48;386;387;1;93;2.0
1;49;387;388;1;93;2.0
1;50;388;390;2;93;2.0
1;51;390;391;1;93;2.0
1;52;391;393;2;93;2.0
1;53;393;395;2;93;2.0
1;54;395;396;1;93;2.0
1;55;396;397;1;93;2.0
1;56;397;398;1;93;2.0
1;57;398;399;1;93;2.0
1;58;399;403;4;93;2.0
1;59;403;405;2;93;2.0
1;60;405;406;1;93;2.0
1;61;406;410;4;93;2.0
1;62;410;412;2;93;2.0
1;63;412;413;1;93;2.0
1;64;413;414;1;93;2.0
1;65;414;415;1;93;2.0
1;66;415;416;1;93;2.0
1;67;416;417;1;93;2.0
1;68;417;418;1;93;2.0
1;69;418;419;1;93;2.0
1;70;419;420;1;93;2.0
1;71;420;421;1;93;2.0
1;72;421;423;2;93;2.0
1;73;423;425;2;93;2.0
1;74;425;426;1;93;2.0
1;75;426;427;1;93;2.0
1;76;427;428;1;93;2.0
1;77;428;429;1;93;2.0
1;78;429;430;1;93;2.0
1;79;430;431;1;93;2.0
1;80;431;432;1;93;2.0
1;81;432;433;1;93;2.0
1;82;433;436;3;93;2.0
1;83;436;437;1;93;2.0
1;84;437;439;2;93;2.0
1;85;439;440;1;93;2.0
1;86;440;442;2;93;2.0
1;87;442;443;1;93;2.0
1;88;443;445;2;93;2.0
1;89;445;446;1;93;2.0
1;90;446;447;1;93;2.0
1;91;447;450;3;93;2.0
1;92;450;451;1;93;2.0
1;93;451;452;1;93;2.0
1;94;452;453;1;93;2.0
1;95;453;454;1;93;2.0
1;96;454;455;1;93;2.0
1;97;455;456;1;93;2.0
1;98;456;457;1;93;2.0
1;99;457;458;1;93;2.0
1;100;458;459;1;93;2.0
1;101;459;460;1;93;2.0
1;102;460;463;3;93;2.0
1;103;463;464;1;93;2.0
1;104;464;466;2;93;2.0
1;105;466;467;1;93;2.0
1;106;467;468;1;93;2.0
1;107;468;469;1;93;2.0
1;108;469;470;1;93;2.0
1;109;470;472;2;93;2.0
1;110;472;473;1;93;2.0
1;111;473;474;1;93;2.0
1;112;474;476;2;93;2.0
1;113;476;478;2;93;2.0
1;114;478;479;1;93;2.0
1;115;479;480;1;93;2.0
1;116;480;481;1;93;2.0
1;117;481;482;1;93;2.0
1;118;482;483;1;93;2.0
1;119;483;486;3;93;2.0
1;120;486;490;4;93;2.0
1;121;490;493;3;93;2.0
1;122;493;495;2;93;2.0
1;123;495;496;1;93;2.0
1;124;496;499;3;93;2.0
1;125;499;500;1;93;2.0
1;126;500;501;1;93;2.0
1;127;501;503;2;93;2.0
1;128;503;505;2;93;2.0
1;129;505;506;1;93;2.0
1;130;506;507;1;93;2.0
1;131;507;513;6;93;2.0
1;132;513;514;1;93;2.0
1;133;514;516;2;93;2.0
1;134;516;518;2;93;2.0
1;135;518;519;1;93;2.0
1;136;519;520;1;93;2.0
1;137;520;522;2;93;2.0
1;138;522;523;1;93;2.0
1;139;523;525;2;93;2.0
1;140;525;526;1;93;2.0
1;141;526;527;1;93;2.0
1;142;527;529;2;93;2.0
1;143;529;532;3;93;2.0
1;144;532;534;2;93;2.0
1;145;534;536;2;93;2.0
1;146;536;538;2;93;2.0
1;147;538;539;1;93;2.0
1;148;539;540;1;93;2.0
1;149;540;543;3;93;2.0
1;150;543;544;1;93;2.0
1;151;544;545;1;93;2.0
1;152;545;546;1;93;2.0
1;153;546;548;2;93;2.0
1;154;548;549;1;93;2.0
1;155;549;550;1;93;2.0
1;156;550;552;2;93;2.0
1;157;552;553;1;93;2.0
1;158;553;555;2;93;2.0
1;159;555;556;1;93;2.0
1;160;556;557;1;93;2.0
1;161;557;558;1;93;2.0
1;162;558;559;1;93;2.0
1;163;559;560;1;93;2.0
1;164;560;563;3;93;2.0
1;165;563;566;3;93;2.0
1;166;566;569;3;93;2.0
1;167;569;573;4;93;2.0
1;168;573;574;1;93;2.0
1;169;574;576;2;93;2.0
1;170;576;578;2;93;2.0
1;171;578;579;1;93;2.0
1;172;579;580;1;93;2.0
1;173;580;583;3;93;2.0
1;174;583;586;3;93;2.0
1;175;586;587;1;93;2.0
1;176;587;588;1;93;2.0
1;177;588;590;2;93;2.0
1;178;590;591;1;93;2.0
1;179;591;592;1;93;2.0
1;180;592;593;1;93;2.0
1;181;593;594;1;93;2.0
1;182;594;596;2;93;2.0
1;183;596;598;2;93;2.0
1;184;598;599;1;93;2.0
1;185;599;603;4;93;2.0
1;186;603;605;2;93;2.0
1;187;605;606;1;93;2.0
1;188;606;609;3;93;2.0
1;189;609;616;7;93;2.0
1;190;616;617;1;93;2.0
1;191;617;618;1;93;2.0
1;192;618;619;1;93;2.0
1;193;619;620;1;93;2.0
1;194;620;623;3;93;2.0
1;195;623;625;2;93;2.0
1;196;625;626;1;93;2.0
1;197;626;627;1;93;2.0
1;198;627;629;2;93;2.0
1;199;629;630;1;93;2.0
1;200;630;631;1;93;2.0
1;201;631;633;2;93;2.0
1;202;633;636;3;93;2.0
1;203;636;638;2;93;2.0
1;204;638;639;1;93;2.0
1;205;639;643;4;93;2.0
1;206;643;646;3;93;2.0
1;207;646;652;6;93;2.0
1;208;652;653;1;93;2.0
1;209;653;656;3;93;2.0
1;210;656;657;1;93;2.0
1;211;657;658;1;93;2.0
1;212;658;659;1;93;2.0
1;213;659;660;1;93;2.0
1;214;660;663;3;93;2.0
1;215;663;666;3;93;2.0
1;216;666;669;3;93;2.0
1;217;669;671;2;93;2.0
1;218;671;676;5;93;2.0
1;219;676;678;2;93;2.0
1;220;678;679;1;93;2.0
1;221;679;683;4;93;2.0
1;222;683;686;3;93;2.0
1;223;686;689;3;93;2.0
1;224;689;693;4;93;2.0
1;225;693;694;1;93;2.0
1;226;694;696;2;93;2.0
1;227;696;697;1;93;2.0
1;228;697;698;1;93;2.0
1;229;698;699;1;93;2.0
1;230;699;700;1;93;2.0
1;231;700;703;3;93;2.0
1;232;703;705;2;93;2.0
1;233;705;706;1;93;2.0
1;234;706;712;6;93;2.0
1;235;712;713;1;93;2.0
1;236;713;714;1;93;2.0
1;237;714;716;2;93;2.0
1;238;716;718;2;93;2.0
1;239;718;719;1;93;2.0
1;240;719;721;2;93;2.0
1;241;721;723;2;93;2.0
1;242;723;725;2;93;2.0
1;243;725;726;1;93;2.0
1;244;726;727;1;93;2.0
1;245;727;728;1;93;2.0
1;246;728;729;1;93;2.0
1;247;729;736;7;93;2.0
1;248;736;737;1;93;2.0
1;249;737;738;1;93;2.0
1;250;738;739;1;93;2.0
1;251;739;743;4;93;2.0
1;252;743;746;3;93;2.0
1;253;746;747;1;93;2.0
1;254;747;749;2;93;2.0
1;255;749;750;1;93;2.0
1;256;750;751;1;93;2.0
1;257;751;753;2;93;2.0
1;258;753;756;3;93;2.0
1;259;756;758;2;93;2.0
1;260;758;759;1;93;2.0
1;261;759;760;1;93;2.0
1;262;760;763;3;93;2.0
1;263;763;766;3;93;2.0
1;264;766;768;2;93;2.0
1;265;768;772;4;93;2.0
1;266;772;773;1;93;2.0
1;267;773;775;2;93;2.0
1;268;775;776;1;93;2.0
1;269;776;777;1;93;2.0
1;270;777;778;1;93;2.0
1;271;778;779;1;93;2.0
1;272;779;783;4;93;2.0
1;273;783;785;2;93;2.0
1;274;785;786;1;93;2.0
1;275;786;788;2;93;2.0
1;276;788;789;1;93;2.0
1;277;789;793;4;93;2.0
1;278;793;794;1;93;2.0
1;279;794;795;1;93;2.0
1;280;795;796;1;93;2.0
1;281;796;797;1;93;2.0
1;282;797;798;1;93;2.0
1;283;798;799;1;93;2.0
1;284;799;800;1;93;2.0
1;285;800;801;1;93;2.0
1;286;801;802;1;93;2.0
1;287;802;803;1;93;2.0
1;288;803;806;3;93;2.0
1;289;806;807;1;93;2.0
1;290;807;810;3;93;2.0
1;291;810;812;2;93;2.0
1;292;812;813;1;93;2.0
1;293;813;815;2;93;2.0
1;294;815;816;1;93;2.0
1;295;816;818;2;93;2.0
1;296;818;819;1;93;2.0
1;297;819;820;1;93;2.0
1;298;820;822;2;93;2.0
1;299;822;823;1;93;2.0
1;300;823;826;3;93;2.0
1;301;826;828;2;93;2.0
1;302;828;830;2;93;2.0
1;303;830;832;2;93;2.0
1;304;832;833;1;93;2.0
1;305;833;834;1;93;2.0
1;306;834;835;1;93;2.0
1;307;835;836;1;93;2.0
1;308;836;837;1;93;2.0
1;309;837;838;1;93;2.0
1;310;838;839;1;93;2.0
1;311;839;841;2;93;2.0
1;312;841;843;2;93;2.0
1;313;843;845;2;93;2.0
1;314;845;846;1;93;2.0
1;315;846;847;1;93;2.0
1;316;847;848;1;93;2.0
1;317;848;849;1;93;2.0
1;318;849;850;1;93;2.0
1;319;850;853;3;93;2.0
1;320;853;854;1;93;2.0
1;321;854;856;2;93;2.0
1;322;856;857;1;93;2.0
1;323;857;858;1;93;2.0
1;324;858;859;1;93;2.0
1;325;859;860;1;93;2.0
1;326;860;861;1;93;2.0
1;327;861;863;2;93;2.0
1;328;863;865;2;93;2.0
1;329;865;866;1;93;2.0
1;330;866;869;3;93;2.0
1;331;869;870;1;93;2.0
1;332;870;871;1;93;2.0
1;333;871;872;1;93;2.0
1;334;872;873;1;93;2.0
1;335;873;874;1;93;2.0
1;336;874;875;1;93;2.0
1;337;875;876;1;93;2.0
1;338;876;877;1;93;2.0
1;339;877;878;1;93;2.0
1;340;878;879;1;93;2.0
1;341;879;880;1;93;2.0
1;342;880;883;3;93;2.0
1;343;883;884;1;93;2.0
1;344;884;886;2;93;2.0
1;345;886;887;1;93;2.0
1;346;887;888;1;93;2.0
1;347;888;889;1;93;2.0
1;348;889;890;1;93;2.0
1;349;890;892;2;93;2.0
1;350;892;893;1;93;2.0
1;351;893;894;1;93;2.0
1;352;894;896;2;93;2.0
1;353;896;897;1;93;2.0
1;354;897;898;1;93;2.0
1;355;898;899;1;93;2.0
1;356;899;900;1;93;2.0
1;357;900;901;1;93;2.0
1;358;901;903;2;93;2.0
1;359;903;904;1;93;2.0
1;360;904;906;2;93;2.0
1;361;906;907;1;93;2.0
1;362;907;908;1;93;2.0
1;363;908;909;1;93;2.0
1;364;909;910;1;93;2.0
1;365;910;912;2;93;2.0
1;366;912;913;1;93;2.0
1;367;913;914;1;93;2.0
1;368;914;915;1;93;2.0
1;369;915;916;1;93;2.0
1;370;916;917;1;93;2.0
1;371;917;918;1;93;2.0
1;372;918;919;1;93;2.0
1;373;919;920;1;93;2.0
1;374;920;922;2;93;2.0
1;375;922;923;1;93;2.0
1;376;923;924;1;93;2.0
1;377;924;926;2;93;2.0
1;378;926;927;1;93;2.0
1;379;927;929;2;93;2.0
1;380;929;930;1;93;2.0
1;381;930;931;1;93;2.0
1;382;931;932;1;93;2.0
1;383;932;933;1;93;2.0
1;384;933;934;1;93;2.0
1;385;934;936;2;93;2.0
1;386;936;938;2;93;2.0
1;387;938;939;1;93;2.0
1;388;939;940;1;93;2.0
1;389;940;942;2;93;2.0
1;390;942;943;1;93;2.0
1;391;943;944;1;93;2.0
1;392;944;945;1;93;2.0
1;393;945;946;1;93;2.0
1;394;946;948;2;93;2.0
1;395;948;949;1;93;2.0
1;396;949;950;1;93;2.0
1;397;950;952;2;93;2.0
1;398;952;953;1;93;2.0
1;399;953;955;2;93;2.0
1;400;955;956;1;93;2.0
1;401;956;957;1;93;2.0
1;402;957;958;1;93;2.0
1;403;958;959;1;93;2.0
1;404;959;961;2;93;2.0
1;405;961;963;2;93;2.0
1;406;963;964;1;93;2.0
1;407;964;966;2;93;2.0
1;408;966;967;1;93;2.0
1;409;967;968;1;93;2.0
1;410;968;969;1;93;2.0
1;411;969;970;1;93;2.0
1;412;970;972;2;93;2.0
1;413;972;973;1;93;2.0
1;414;973;975;2;93;2.0
1;415;975;976;1;93;2.0
1;416;976;977;1;93;2.0
1;417;977;978;1;93;2.0
1;418;978;979;1;93;2.0
1;419;979;980;1;93;2.0
1;420;980;982;2;93;2.0
1;421;982;983;1;93;2.0
1;422;983;986;3;93;2.0
1;423;986;989;3;93;2.0
1;424;989;990;1;93;2.0
1;425;990;993;3;93;2.0
1;426;993;994;1;93;2.0
1;427;994;995;1;93;2.0
1;428;995;996;1;93;2.0
1;429;996;998;2;93;2.0
1;430;998;999;1;93;2.0
1;431;999;1000;1;93;2.0
1;432;1000;1002;2;93;2.0
1;433;1002;1003;1;93;2.0
1;434;1003;1004;1;93;2.0
1;435;1004;1006;2;93;2.0
1;436;1006;1007;1;93;2.0
1;437;1007;1008;1;93;2.0
1;438;1008;1010;2;93;2.0
1;439;1010;1012;2;93;2.0
1;440;1012;1013;1;93;2.0
1;441;1013;1014;1;93;2.0
1;442;1014;1015;1;93;2.0
1;443;1015;1016;1;93;2.0
1;444;1016;1017;1;93;2.0
1;445;1017;1018;1;93;2.0
1;446;1018;1019;1;93;2.0
1;447;1019;1021;2;93;2.0
1;448;1021;1022;1;93;2.0
1;449;1022;1025;3;93;2.0
1;450;1025;1026;1;93;2.0
1;451;1026;1027;1;93;2.0
1;452;1027;1028;1;93;2.0
1;453;1028;1029;1;93;2.0
1;454;1029;1030;1;93;2.0
1;455;1030;1032;2;93;2.0
1;456;1032;1033;1;93;2.0
1;457;1033;1034;1;93;2.0
1;458;1034;1036;2;93;2.0
1;459;1036;1038;2;93;2.0
1;460;1038;1039;1;93;2.0
1;461;1039;1042;3;93;2.0
1;462;1042;1043;1;93;2.0
1;463;1043;1044;1;93;2.0
1;464;1044;1045;1;93;2.0
1;465;1045;1046;1;93;2.0
1;466;1046;1047;1;93;2.0
1;467;1047;1048;1;93;2.0
1;468;1048;1049;1;93;2.0
1;469;1049;1050;1;93;2.0
1;470;1050;1051;1;93;2.0
1;471;1051;1058;7;93;2.0
1;472;1058;1059;1;93;2.0
1;473;1059;1060;1;93;2.0
1;474;1060;1063;3;93;2.0
1;475;1063;1064;1;93;2.0
1;476;1064;1065;1;93;2.0
1;477;1065;1066;1;93;2.0
1;478;1066;1068;2;93;2.0
1;479;1068;1070;2;93;2.0
1;480;1070;1071;1;93;2.0
1;481;1071;1072;1;93;2.0
1;482;1072;1073;1;93;2.0
1;483;1073;1077;4;93;2.0
1;484;1077;1078;1;93;2.0
1;485;1078;1079;1;93;2.0
1;486;1079;1081;2;93;2.0
1;487;1081;1083;2;93;2.0
1;488;1083;1084;1;93;2.0
1;489;1084;1085;1;93;2.0
1;490;1085;1086;1;93;2.0
1;491;1086;1088;2;93;2.0
1;492;1088;1089;1;93;2.0
1;493;1089;1090;1;93;2.0
1;494;1090;1093;3;93;2.0
1;495;1093;1095;2;93;2.0
1;496;1095;1096;1;93;2.0
1;497;1096;1097;1;93;2.0
1;498;1097;1098;1;93;2.0
1;499;1098;1099;1;93;2.0
1;500;1099;1102;3;93;2.0
1;501;1102;1103;1;93;2.0
1;502;1103;1105;2;93;2.0
1;503;1105;1107;2;93;2.0
1;504;1107;1108;1;93;2.0
1;505;1108;1110;2;93;2.0
1;506;1110;1111;1;93;2.0
1;507;1111;1113;2;93;2.0
1;508;1113;1114;1;93;2.0
1;509;1114;1115;1;93;2.0
1;510;1115;1118;3;93;2.0
1;511;1118;1120;2;93;2.0
1;512;1120;1123;3;93;2.0
1;513;1123;1128;5;93;2.0
1;514;1128;1129;1;93;2.0
1;515;1129;1130;1;93;2.0
1;516;1130;1132;2;93;2.0
1;517;1132;1134;2;93;2.0
1;518;1134;1136;2;93;2.0
1;519;1136;1137;1;93;2.0
1;520;1137;1138;1;93;2.0
1;521;1138;1140;2;93;2.0
1;522;1140;1143;3;93;2.0
1;523;1143;1144;1;93;2.0
1;524;1144;1145;1;93;2.0
1;525;1145;1148;3;93;2.0
1;526;1148;1152;4;93;2.0
1;527;1152;1153;1;93;2.0
1;528;1153;1156;3;93;2.0
1;529;1156;1158;2;93;2.0
1;530;1158;1160;2;93;2.0
1;531;1160;1162;2;93;2.0
1;532;1162;1168;6;93;2.0
1;533;1168;1171;3;93;2.0
1;534;1171;1172;1;93;2.0
1;535;1172;1173;1;93;2.0
1;536;1173;1174;1;93;2.0
1;537;1174;1177;3;93;2.0
1;538;1177;1178;1;93;2.0
1;539;1178;1180;2;93;2.0
1;540;1180;1183;3;93;2.0
1;541;1183;1184;1;93;2.0
1;542;1184;1188;4;93;2.0
1;543;1188;1190;2;93;2.0
1;544;1190;1193;3;93;2.0
1;545;1193;1195;2;93;2.0
1;546;1195;1200;5;93;2.0
1;547;1200;1202;2;93;2.0
1;548;1202;1203;1;93;2.0
1;549;1203;1204;1;93;2.0
1;550;1204;1207;3;93;2.0
1;551;1207;1209;2;93;2.0
1;552;1209;1211;2;93;2.0
1;553;1211;1213;2;93;2.0
1;554;1213;1219;6;93;2.0
1;555;1219;1222;3;93;2.0
1;556;1222;1223;1;93;2.0
1;557;1223;1224;1;93;2.0
1;558;1224;1225;1;93;2.0
1;559;1225;1228;3;93;2.0
1;560;1228;1230;2;93;2.0
1;561;1230;1231;1;93;2.0
1;562;1231;1233;2;93;2.0
1;563;1233;1234;1;93;2.0
1;564;1234;1237;3;93;2.0
1;565;1237;1248;11;93;2.0
1;566;1248;1250;2;93;2.0
1;567;1250;1252;2;93;2.0
1;568;1252;1253;1;93;2.0
1;569;1253;1258;5;93;2.0
1;570;1258;1259;1;93;2.0
1;571;1259;1262;3;93;2.0
1;572;1262;1264;2;93;2.0
1;573;1264;1265;1;93;2.0
1;574;1265;1268;3;93;2.0
1;575;1268;1269;1;93;2.0
1;576;1269;1270;1;93;2.0
1;577;1270;1272;2;93;2.0
1;578;1272;1273;1;93;2.0
1;579;1273;1275;2;93;2.0
1;580;1275;1282;7;93;2.0
1;581;1282;1283;1;93;2.0
1;582;1283;1284;1;93;2.0
1;583;1284;1294;10;93;2.0
1;584;1294;1298;4;93;2.0
1;585;1298;1300;2;93;2.0
1;586;1300;1306;6;93;2.0
1;587;1306;1307;1;93;2.0
1;588;1307;1308;1;93;2.0
1;589;1308;1310;2;93;2.0
1;590;1310;1311;1;93;2.0
1;591;1311;1314;3;93;2.0
1;592;1314;1320;6;93;2.0
1;593;1320;1321;1;93;2.0
1;594;1321;1322;1;93;2.0
1;595;1322;1323;1;93;2.0
1;596;1323;1325;2;93;2.0
1;597;1325;1326;1;93;2.0
1;598;1326;1328;2;93;2.0
1;599;1328;1330;2;93;2.0
1;600;1330;1332;2;93;2.0
1;601;1332;1333;1;93;2.0
1;602;1333;1334;1;93;2.0
1;603;1334;1338;4;93;2.0
1;604;1338;1339;1;93;2.0
1;605;1339;1340;1;93;2.0
1;606;1340;1343;3;93;2.0
1;607;1343;1344;1;93;2.0
1;608;1344;1345;1;93;2.0
1;609;1345;1346;1;93;2.0
1;610;1346;1350;4;93;2.0
1;611;1350;1358;8;93;2.0
1;612;1358;1360;2;93;2.0
1;613;1360;1361;1;93;2.0
1;614;1361;1362;1;93;2.0
1;615;1362;1364;2;93;2.0
1;616;1364;1365;1;93;2.0
1;617;1365;1366;1;93;2.0
1;618;1366;1367;1;93;2.0
1;619;1367;1373;6;93;2.0
1;620;1373;1374;1;93;2.0
1;621;1374;1378;4;93;2.0
1;622;1378;1380;2;93;2.0
1;623;1380;1381;1;93;2.0
1;624;1381;1383;2;93;2.0
1;625;1383;1387;4;93;2.0
1;626;1387;1388;1;93;2.0
1;627;1388;1396;8;93;2.0
1;628;1396;1411;15;93;2.0
1;629;1411;1426;15;93;2.0
1;630;1426;1441;15;93;2.0
1;631;1441;1456;15;93;2.0
1;632;1456;1471;15;93;2.0
1;633;1471;1486;15;93;2.0
1;634;1486;1501;15;93;2.0
1;635;1501;1516;15;93;2.0
1;636;1516;1531;15;93;2.0
1;637;1531;1546;15;93;2.0
1;638;1546;1561;15;93;2.0
1;639;1561;1576;15;93;2.0
1;640;1576;1591;15;93;2.0
1;641;1591;1606;15;93;2.0
1;642;1606;1621;15;93;2.0
1;643;1621;1636;15;93;2.0
1;644;1636;1651;15;93;2.0
1;645;1651;1666;15;93;2.0
1;646;1666;1680;14;93;2.0
2;0;245;284;39;112;2.0
2;1;284;322;38;112;2.0
2;2;322;327;5;112;2.0
2;3;327;328;1;112;2.0
2;4;328;329;1;112;2.0
2;5;329;331;2;112;2.0
2;6;331;332;1;112;2.0
2;7;332;333;1;112;2.0
2;8;333;334;1;112;2.0
2;9;334;335;1;112;2.0
2;10;335;338;3;112;2.0
2;11;338;339;1;112;2.0
2;12;339;340;1;112;2.0
2;13;340;341;1;112;2.0
2;14;341;342;1;112;2.0
2;15;342;343;1;112;2.0
2;16;343;344;1;112;2.0
2;17;344;347;3;112;2.0
2;18;347;349;2;112;2.0
2;19;349;350;1;112;2.0
2;20;350;351;1;112;2.0
2;21;351;353;2;112;2.0
2;22;353;354;1;112;2.0
2;23;354;355;1;112;2.0
2;24;355;356;1;112;2.0
2;25;356;357;1;112;2.0
2;26;357;358;1;112;2.0
2;27;358;359;1;112;2.0
2;28;359;360;1;112;2.0
2;29;360;361;1;112;2.0
2;30;361;364;3;112;2.0
2;31;364;365;1;112;2.0
2;32;365;366;1;112;2.0
2;33;366;367;1;112;2.0
2;34;367;369;2;112;2.0
2;35;369;370;1;112;2.0
2;36;370;371;1;112;2.0
2;37;371;373;2;112;2.0
2;38;373;377;4;112;2.0
2;39;377;378;1;112;2.0
2;40;378;379;1;112;2.0
2;41;379;380;1;112;2.0
2;42;380;382;2;112;2.0
2;43;382;384;2;112;2.0
2;44;384;386;2;112;2.0
2;45;386;387;1;112;2.0
2;46;387;388;1;112;2.0
2;47;388;389;1;112;2.0
2;48;389;390;1;112;2.0
2;49;390;391;1;112;2.0
2;50;391;392;1;112;2.0
2;51;392;393;1;112;2.0
2;52;393;394;1;112;2.0
2;53;394;395;1;112;2.0
2;54;395;398;3;112;2.0
2;55;398;400;2;112;2.0
2;56;400;402;2;112;2.0
2;57;402;403;1;112;2.0
2;58;403;404;1;112;2.0
2;59;404;405;1;112;2.0
2;60;405;407;2;112;2.0
2;61;407;408;1;112;2.0
2;62;408;409;1;112;2.0
2;63;409;411;2;112;2.0
2;64;411;412;1;112;2.0
2;65;412;413;1;112;2.0
2;66;413;414;1;112;2.0
2;67;414;416;2;112;2.0
2;68;416;417;1;112;2.0
2;69;417;418;1;112;2.0
2;70;418;419;1;112;2.0
2;71;419;420;1;112;2.0
2;72;420;421;1;112;2.0
2;73;421;422;1;112;2.0
2;74;422;424;2;112;2.0
2;75;424;425;1;112;2.0
2;76;425;427;2;112;2.0
2;77;427;428;1;112;2.0
2;78;428;429;1;112;2.0
2;79;429;430;1;112;2.0
2;80;430;431;1;112;2.0
2;81;431;432;1;112;2.0
2;82;432;433;1;112;2.0
2;83;433;434;1;112;2.0
2;84;434;435;1;112;2.0
2;85;435;436;1;112;2.0
2;86;436;438;2;112;2.0
2;87;438;440;2;112;2.0
2;88;440;442;2;112;2.0
2;89;442;444;2;112;2.0
2;90;444;446;2;112;2.0
2;91;446;447;1;112;2.0
2;92;447;448;1;112;2.0
2;93;448;449;1;112;2.0
2;94;449;450;1;112;2.0
2;95;450;451;1;112;2.0
2;96;451;452;1;112;2.0
2;97;452;453;1;112;2.0
2;98;453;454;1;112;2.0
2;99;454;458;4;112;2.0
2;100;458;459;1;112;2.0
2;101;459;460;1;112;2.0
2;102;460;462;2;112;2.0
2;103;462;463;1;112;2.0
2;104;463;464;1;112;2.0
2;105;464;465;1;112;2.0
2;106;465;467;2;112;2.0
2;107;467;468;1;112;2.0
2;108;468;469;1;112;2.0
2;109;469;471;2;112;2.0
2;110;471;472;1;112;2.0
2;111;472;473;1;112;2.0
2;112;473;474;1;112;2.0
2;113;474;476;2;112;2.0
2;114;476;477;1;112;2.0
2;115;477;478;1;112;2.0
2;116;478;479;1;112;2.0
2;117;479;480;1;112;2.0
2;118;480;481;1;112;2.0
2;119;481;482;1;112;2.0
2;120;482;484;2;112;2.0
2;121;484;485;1;112;2.0
2;122;485;488;3;112;2.0
2;123;488;491;3;112;2.0
2;124;491;492;1;112;2.0
2;125;492;493;1;112;2.0
2;126;493;494;1;112;2.0
2;127;494;495;1;112;2.0
2;128;495;499;4;112;2.0
2;129;499;500;1;112;2.0
2;130;500;503;3;112;2.0
2;131;503;504;1;112;2.0
2;132;504;507;3;112;2.0
2;133;507;508;1;112;2.0
2;134;508;511;3;112;2.0
2;135;511;512;1;112;2.0
2;136;512;513;1;112;2.0
2;137;513;514;1;112;2.0
2;138;514;516;2;112;2.0
2;139;516;517;1;112;2.0
2;140;517;519;2;112;2.0
2;141;519;520;1;112;2.0
2;142;520;524;4;112;2.0
2;143;524;525;1;112;2.0
2;144;525;526;1;112;2.0
2;145;526;527;1;112;2.0
2;146;527;528;1;112;2.0
2;147;528;531;3;112;2.0
2;148;531;532;1;112;2.0
2;149;532;533;1;112;2.0
2;150;533;534;1;112;2.0
2;151;534;535;1;112;2.0
2;152;535;536;1;112;2.0
2;153;536;537;1;112;2.0
2;154;537;539;2;112;2.0
2;155;539;540;1;112;2.0
2;156;540;542;2;112;2.0
2;157;542;543;1;112;2.0
2;158;543;544;1;112;2.0
2;159;544;545;1;112;2.0
2;160;545;548;3;112;2.0
2;161;548;549;1;112;2.0
2;162;549;550;1;112;2.0
2;163;550;551;1;112;2.0
2;164;551;552;1;112;2.0
2;165;552;553;1;112;2.0
2;166;553;554;1;112;2.0
2;167;554;559;5;112;2.0
2;168;559;560;1;112;2.0
2;169;560;561;1;112;2.0
2;170;561;562;1;112;2.0
2;171;562;564;2;112;2.0
2;172;564;568;4;112;2.0
2;173;568;570;2;112;2.0
2;174;570;571;1;112;2.0
2;175;571;572;1;112;2.0
2;176;572;573;1;112;2.0
2;177;573;580;7;112;2.0
2;178;580;581;1;112;2.0
2;179;581;582;1;112;2.0
2;180;582;584;2;112;2.0
2;181;584;587;3;112;2.0
2;182;587;588;1;112;2.0
2;183;588;589;1;112;2.0
2;184;589;591;2;112;2.0
2;185;591;593;2;112;2.0
2;186;593;595;2;112;2.0
2;187;595;596;1;112;2.0
2;188;596;599;3;112;2.0
2;189;599;600;1;112;2.0
2;190;600;602;2;112;2.0
2;191;602;604;2;112;2.0
2;192;604;608;4;112;2.0
2;193;608;611;3;112;2.0
2;194;611;612;1;112;2.0
2;195;612;613;1;112;2.0
2;196;613;614;1;112;2.0
2;197;614;617;3;112;2.0
2;198;617;618;1;112;2.0
2;199;618;620;2;112;2.0
2;200;620;622;2;112;2.0
2;201;622;624;2;112;2.0
2;202;624;625;1;112;2.0
2;203;625;628;3;112;2.0
2;204;628;630;2;112;2.0
2;205;630;631;1;112;2.0
2;206;631;632;1;112;2.0
2;207;632;633;1;112;2.0
2;208;633;640;7;112;2.0
2;209;640;642;2;112;2.0
2;210;642;644;2;112;2.0
2;211;644;647;3;112;2.0
2;212;647;648;1;112;2.0
2;213;648;651;3;112;2.0
2;214;651;652;1;112;2.0
2;215;652;653;1;112;2.0
2;216;653;654;1;112;2.0
2;217;654;655;1;112;2.0
2;218;655;656;1;112;2.0
2;219;656;657;1;112;2.0
2;220;657;658;1;112;2.0
2;221;658;659;1;112;2.0
2;222;659;660;1;112;2.0
2;223;660;662;2;112;2.0
2;224;662;664;2;112;2.0
2;225;664;668;4;112;2.0
2;226;668;671;3;112;2.0
2;227;671;672;1;112;2.0
2;228;672;673;1;112;2.0
2;229;673;680;7;112;2.0
2;230;680;682;2;112;2.0
2;231;682;683;1;112;2.0
2;232;683;684;1;112;2.0
2;233;684;688;4;112;2.0
2;234;688;690;2;112;2.0
2;235;690;691;1;112;2.0
2;236;691;692;1;112;2.0
2;237;692;693;1;112;2.0
2;238;693;694;1;112;2.0
2;239;694;699;5;112;2.0
2;240;699;700;1;112;2.0
2;241;700;702;2;112;2.0
2;242;702;704;2;112;2.0
2;243;704;708;4;112;2.0
2;244;708;709;1;112;2.0
2;245;709;711;2;112;2.0
2;246;711;713;2;112;2.0
2;247;713;715;2;112;2.0
2;248;715;716;1;112;2.0
2;249;716;717;1;112;2.0
2;250;717;718;1;112;2.0
2;251;718;719;1;112;2.0
2;252;719;720;1;112;2.0
2;253;720;722;2;112;2.0
2;254;722;723;1;112;2.0
2;255;723;724;1;112;2.0
2;256;724;727;3;112;2.0
2;257;727;728;1;112;2.0
2;258;728;731;3;112;2.0
2;259;731;732;1;112;2.0
2;260;732;733;1;112;2.0
2;261;733;737;4;112;2.0
2;262;737;738;1;112;2.0
2;263;738;740;2;112;2.0
2;264;740;741;1;112;2.0
2;265;741;742;1;112;2.0
2;266;742;744;2;112;2.0
2;267;744;748;4;112;2.0
2;268;748;750;2;112;2.0
2;269;750;751;1;112;2.0
2;270;751;752;1;112;2.0
2;271;752;753;1;112;2.0
2;272;753;759;6;112;2.0
2;273;759;760;1;112;2.0
2;274;760;762;2;112;2.0
2;275;762;763;1;112;2.0
2;276;763;764;1;112;2.0
2;277;764;767;3;112;2.0
2;278;767;768;1;112;2.0
2;279;768;770;2;112;2.0
2;280;770;771;1;112;2.0
2;281;771;773;2;112;2.0
2;282;773;774;1;112;2.0
2;283;774;775;1;112;2.0
2;284;775;776;1;112;2.0
2;285;776;778;2;112;2.0
2;286;778;779;1;112;2.0
2;287;779;780;1;112;2.0
2;288;780;782;2;112;2.0
2;289;782;784;2;112;2.0
2;290;784;787;3;112;2.0
2;291;787;788;1;112;2.0
2;292;788;790;2;112;2.0
2;293;790;791;1;112;2.0
2;294;791;792;1;112;2.0
2;295;792;793;1;112;2.0
2;296;793;794;1;112;2.0
2;297;794;795;1;112;2.0
2;298;795;797;2;112;2.0
2;299;797;798;1;112;2.0
2;300;798;800;2;112;2.0
2;301;800;802;2;112;2.0
2;302;802;803;1;112;2.0
2;303;803;804;1;112;2.0
2;304;804;806;2;112;2.0
2;305;806;808;2;112;2.0
2;306;808;811;3;112;2.0
2;307;811;813;2;112;2.0
2;308;813;814;1;112;2.0
2;309;814;816;2;112;2.0
2;310;816;817;1;112;2.0
2;311;817;818;1;112;2.0
2;312;818;819;1;112;2.0
2;313;819;820;1;112;2.0
2;314;820;822;2;112;2.0
2;315;822;824;2;112;2.0
2;316;824;825;1;112;2.0
2;317;825;828;3;112;2.0
2;318;828;830;2;112;2.0
2;319;830;831;1;112;2.0
2;320;831;832;1;112;2.0
2;321;832;833;1;112;2.0
2;322;833;834;1;112;2.0
2;323;834;835;1;112;2.0
2;324;835;836;1;112;2.0
2;325;836;837;1;112;2.0
2;326;837;838;1;112;2.0
2;327;838;839;1;112;2.0
2;328;839;840;1;112;2.0
2;329;840;841;1;112;2.0
2;330;841;842;1;112;2.0
2;331;842;844;2;112;2.0
2;332;844;845;1;112;2.0
2;333;845;847;2;112;2.0
2;334;847;848;1;112;2.0
2;335;848;851;3;112;2.0
2;336;851;852;1;112;2.0
2;337;852;853;1;112;2.0
2;338;853;854;1;112;2.0
2;339;854;857;3;112;2.0
2;340;857;858;1;112;2.0
2;341;858;860;2;112;2.0
2;342;860;862;2;112;2.0
2;343;862;863;1;112;2.0
2;344;863;864;1;112;2.0
2;345;864;865;1;112;2.0
2;346;865;866;1;112;2.0
2;347;866;867;1;112;2.0
2;348;867;868;1;112;2.0
2;349;868;869;1;112;2.0
2;350;869;871;2;112;2.0
2;351;871;872;1;112;2.0
2;352;872;873;1;112;2.0
2;353;873;874;1;112;2.0
2;354;874;876;2;112;2.0
2;355;876;878;2;112;2.0
2;356;878;879;1;112;2.0
2;357;879;880;1;112;2.0
2;358;880;882;2;112;2.0
2;359;882;883;1;112;2.0
2;360;883;884;1;112;2.0
2;361;884;885;1;112;2.0
2;362;885;886;1;112;2.0
2;363;886;887;1;112;2.0
2;364;887;888;1;112;2.0
2;365;888;889;1;112;2.0
2;366;889;891;2;112;2.0
2;367;891;892;1;112;2.0
2;368;892;893;1;112;2.0
2;369;893;894;1;112;2.0
2;370;894;895;1;112;2.0
2;371;895;896;1;112;2.0
2;372;896;898;2;112;2.0
2;373;898;899;1;112;2.0
2;374;899;900;1;112;2.0
2;375;900;901;1;112;2.0
2;376;901;902;1;112;2.0
2;377;902;903;1;112;2.0
2;378;903;904;1;112;2.0
2;379;904;905;1;112;2.0
2;380;905;906;1;112;2.0
2;381;906;907;1;112;2.0
2;382;907;908;1;112;2.0
2;383;908;909;1;112;2.0
2;384;909;911;2;112;2.0
2;385;911;912;1;112;2.0
2;386;912;913;1;112;2.0
2;387;913;914;1;112;2.0
2;388;914;915;1;112;2.0
2;389;915;916;1;112;2.0
2;390;916;917;1;112;2.0
2;391;917;918;1;112;2.0
2;392;918;920;2;112;2.0
2;393;920;922;2;112;2.0
2;394;922;923;1;112;2.0
2;395;923;924;1;112;2.0
2;396;924;925;1;112;2.0
2;397;925;927;2;112;2.0
2;398;927;928;1;112;2.0
2;399;928;931;3;112;2.0
2;400;931;932;1;112;2.0
2;401;932;933;1;112;2.0
2;402;933;934;1;112;2.0
2;403;934;935;1;112;2.0
2;404;935;936;1;112;2.0
2;405;936;937;1;112;2.0
2;406;937;938;1;112;2.0
2;407;938;939;1;112;2.0
2;408;939;940;1;112;2.0
2;409;940;942;2;112;2.0
2;410;942;943;1;112;2.0
2;411;943;944;1;112;2.0
2;412;944;945;1;112;2.0
2;413;945;946;1;112;2.0
2;414;946;948;2;112;2.0
2;415;948;951;3;112;2.0
2;416;951;952;1;112;2.0
2;417;952;953;1;112;2.0
2;418;953;954;1;112;2.0
2;419;954;955;1;112;2.0
2;420;955;956;1;112;2.0
2;421;956;957;1;112;2.0
2;422;957;958;1;112;2.0
2;423;958;959;1;112;2.0
2;424;959;960;1;112;2.0
2;425;960;961;1;112;2.0
2;426;961;962;1;112;2.0
2;427;962;964;2;112;2.0
2;428;964;965;1;112;2.0
2;429;965;966;1;112;2.0
2;430;966;968;2;112;2.0
2;431;968;969;1;112;2.0
2;432;969;971;2;112;2.0
2;433;971;972;1;112;2.0
2;434;972;973;1;112;2.0
2;435;973;974;1;112;2.0
2;436;974;975;1;112;2.0
2;437;975;976;1;112;2.0
2;438;976;977;1;112;2.0
2;439;977;978;1;112;2.0
2;440;978;980;2;112;2.0
2;441;980;981;1;112;2.0
2;442;981;982;1;112;2.0
2;443;982;984;2;112;2.0
2;444;984;985;1;112;2.0
2;445;985;988;3;112;2.0
2;446;988;991;3;112;2.0
2;447;991;992;1;112;2.0
2;448;992;993;1;112;2.0
2;449;993;994;1;112;2.0
2;450;994;995;1;112;2.0
2;451;995;997;2;112;2.0
2;452;997;998;1;112;2.0
2;453;998;999;1;112;2.0
2;454;999;1000;1;112;2.0
2;455;1000;1002;2;112;2.0
2;456;1002;1003;1;112;2.0
2;457;1003;1004;1;112;2.0
2;458;1004;1005;1;112;2.0
2;459;1005;1006;1;112;2.0
2;460;1006;1007;1;112;2.0
2;461;1007;1008;1;112;2.0
2;462;1008;1010;2;112;2.0
2;463;1010;1011;1;112;2.0
2;464;1011;1012;1;112;2.0
2;465;1012;1013;1;112;2.0
2;466;1013;1014;1;112;2.0
2;467;1014;1016;2;112;2.0
2;468;1016;1017;1;112;2.0
2;469;1017;1018;1;112;2.0
2;470;1018;1019;1;112;2.0
2;471;1019;1020;1;112;2.0
2;472;1020;1021;1;112;2.0
2;473;1021;1022;1;112;2.0
2;474;1022;1025;3;112;2.0
2;475;1025;1027;2;112;2.0
2;476;1027;1028;1;112;2.0
2;477;1028;1030;2;112;2.0
2;478;1030;1031;1;112;2.0
2;479;1031;1032;1;112;2.0
2;480;1032;1033;1;112;2.0
2;481;1033;1034;1;112;2.0
2;482;1034;1036;2;112;2.0
2;483;1036;1037;1;112;2.0
2;484;1037;1038;1;112;2.0
2;485;1038;1040;2;112;2.0
2;486;1040;1042;2;112;2.0
2;487;1042;1043;1;112;2.0
2;488;1043;1045;2;112;2.0
2;489;1045;1047;2;112;2.0
2;490;1047;1048;1;112;2.0
2;491;1048;1049;1;112;2.0
2;492;1049;1051;2;112;2.0
2;493;1051;1052;1;112;2.0
2;494;1052;1053;1;112;2.0
2;495;1053;1054;1;112;2.0
2;496;1054;1055;1;112;2.0
2;497;1055;1057;2;112;2.0
2;498;1057;1059;2;112;2.0
2;499;1059;1060;1;112;2.0
2;500;1060;1063;3;112;2.0
2;501;1063;1064;1;112;2.0
2;502;1064;1065;1;112;2.0
2;503;1065;1066;1;112;2.0
2;504;1066;1067;1;112;2.0
2;505;1067;1071;4;112;2.0
2;506;1071;1072;1;112;2.0
2;507;1072;1073;1;112;2.0
2;508;1073;1075;2;112;2.0
2;509;1075;1076;1;112;2.0
2;510;1076;1077;1;112;2.0
2;511;1077;1078;1;112;2.0
2;512;1078;1079;1;112;2.0
2;513;1079;1080;1;112;2.0
2;514;1080;1083;3;112;2.0
2;515;1083;1084;1;112;2.0
2;516;1084;1085;1;112;2.0
2;517;1085;1086;1;112;2.0
2;518;1086;1087;1;112;2.0
2;519;1087;1088;1;112;2.0
2;520;1088;1091;3;112;2.0
2;521;1091;1092;1;112;2.0
2;522;1092;1093;1;112;2.0
2;523;1093;1094;1;112;2.0
2;524;1094;1095;1;112;2.0
2;525;1095;1097;2;112;2.0
2;526;1097;1098;1;112;2.0
2;527;1098;1099;1;112;2.0
2;528;1099;1101;2;112;2.0
2;529;1101;1102;1;112;2.0
2;530;1102;1105;3;112;2.0
2;531;1105;1106;1;112;2.0
2;532;1106;1108;2;112;2.0
2;533;1108;1109;1;112;2.0
2;534;1109;1110;1;112;2.0
2;535;1110;1111;1;112;2.0
2;536;1111;1113;2;112;2.0
2;537;1113;1117;4;112;2.0
2;538;1117;1120;3;112;2.0
2;539;1120;1121;1;112;2.0
2;540;1121;1123;2;112;2.0
2;541;1123;1124;1;112;2.0
2;542;1124;1129;5;112;2.0
2;543;1129;1132;3;112;2.0
2;544;1132;1133;1;112;2.0
2;545;1133;1134;1;112;2.0
2;546;1134;1135;1;112;2.0
2;547;1135;1139;4;112;2.0
2;548;1139;1140;1;112;2.0
2;549;1140;1141;1;112;2.0
2;550;1141;1143;2;112;2.0
2;551;1143;1144;1;112;2.0
2;552;1144;1148;4;112;2.0
2;553;1148;1150;2;112;2.0
2;554;1150;1152;2;112;2.0
2;555;1152;1153;1;112;2.0
2;556;1153;1155;2;112;2.0
2;557;1155;1156;1;112;2.0
2;558;1156;1159;3;112;2.0
2;559;1159;1161;2;112;2.0
2;560;1161;1162;1;112;2.0
2;561;1162;1165;3;112;2.0
2;562;1165;1166;1;112;2.0
2;563;1166;1170;4;112;2.0
2;564;1170;1171;1;112;2.0
2;565;1171;1173;2;112;2.0
2;566;1173;1178;5;112;2.0
2;567;1178;1179;1;112;2.0
2;568;1179;1180;1;112;2.0
2;569;1180;1181;1;112;2.0
2;570;1181;1185;4;112;2.0
2;571;1185;1190;5;112;2.0
2;572;1190;1192;2;112;2.0
2;573;1192;1196;4;112;2.0
2;574;1196;1198;2;112;2.0
2;575;1198;1199;1;112;2.0
2;576;1199;1200;1;112;2.0
2;577;1200;1201;1;112;2.0
2;578;1201;1203;2;112;2.0
2;579;1203;1204;1;112;2.0
2;580;1204;1205;1;112;2.0
2;581;1205;1207;2;112;2.0
2;582;1207;1208;1;112;2.0
2;583;1208;1210;2;112;2.0
2;584;1210;1213;3;112;2.0
2;585;1213;1218;5;112;2.0
2;586;1218;1219;1;112;2.0
2;587;1219;1221;2;112;2.0
2;588;1221;1225;4;112;2.0
2;589;1225;1226;1;112;2.0
2;590;1226;1230;4;112;2.0
2;591;1230;1231;1;112;2.0
2;592;1231;1235;4;112;2.0
2;593;1235;1238;3;112;2.0
2;594;1238;1239;1;112;2.0
2;595;1239;1243;4;112;2.0
2;596;1243;1251;8;112;2.0
2;597;1251;1254;3;112;2.0
2;598;1254;1255;1;112;2.0
2;599;1255;1256;1;112;2.0
2;600;1256;1257;1;112;2.0
2;601;1257;1259;2;112;2.0
2;602;1259;1263;4;112;2.0
2;603;1263;1264;1;112;2.0
2;604;1264;1265;1;112;2.0
2;605;1265;1268;3;112;2.0
2;606;1268;1269;1;112;2.0
2;607;1269;1270;1;112;2.0
2;608;1270;1272;2;112;2.0
2;609;1272;1273;1;112;2.0
2;610;1273;1275;2;112;2.0
2;611;1275;1276;1;112;2.0
2;612;1276;1280;4;112;2.0
2;613;1280;1281;1;112;2.0
2;614;1281;1282;1;112;2.0
2;615;1282;1283;1;112;2.0
2;616;1283;1284;1;112;2.0
2;617;1284;1288;4;112;2.0
2;618;1288;1289;1;112;2.0
2;619;1289;1290;1;112;2.0
2;620;1290;1295;5;112;2.0
2;621;1295;1300;5;112;2.0
2;622;1300;1301;1;112;2.0
2;623;1301;1305;4;112;2.0
2;624;1305;1306;1;112;2.0
2;625;1306;1308;2;112;2.0
2;626;1308;1313;5;112;2.0
2;627;1313;1314;1;112;2.0
2;628;1314;1315;1;112;2.0
2;629;1315;1319;4;112;2.0
2;630;1319;1320;1;112;2.0
2;631;1320;1322;2;112;2.0
2;632;1322;1323;1;112;2.0
2;633;1323;1325;2;112;2.0
2;634;1325;1331;6;112;2.0
2;635;1331;1333;2;112;2.0
2;636;1333;1334;1;112;2.0
2;637;1334;1338;4;112;2.0
2;638;1338;1339;1;112;2.0
2;639;1339;1340;1;112;2.0
2;640;1340;1344;4;112;2.0
2;641;1344;1345;1;112;2.0
2;642;1345;1346;1;112;2.0
2;643;1346;1350;4;112;2.0
2;644;1350;1351;1;112;2.0
2;645;1351;1353;2;112;2.0
2;646;1353;1356;3;112;2.0
2;647;1356;1357;1;112;2.0
2;648;1357;1359;2;112;2.0
2;649;1359;1363;4;112;2.0
2;650;1363;1366;3;112;2.0
2;651;1366;1367;1;112;2.0
2;652;1367;1368;1;112;2.0
2;653;1368;1369;1;112;2.0
2;654;1369;1373;4;112;2.0
2;655;1373;1378;5;112;2.0
2;656;1378;1380;2;112;2.0
2;657;1380;1381;1;112;2.0
2;658;1381;1383;2;112;2.0
2;659;1383;1384;1;112;2.0
2;660;1384;1386;2;112;2.0
2;661;1386;1390;4;112;2.0
2;662;1390;1396;6;112;2.0
2;663;1396;1411;15;112;2.0
2;664;1411;1426;15;112;2.0
2;665;1426;1441;15;112;2.0
2;666;1441;1456;15;112;2.0
2;667;1456;1471;15;112;2.0
2;668;1471;1486;15;112;2.0
2;669;1486;1501;15;112;2.0
2;670;1501;1516;15;112;2.0
2;671;1516;1531;15;112;2.0
2;672;1531;1546;15;112;2.0
2;673;1546;1561;15;112;2.0
2;674;1561;1576;15;112;2.0
2;675;1576;1591;15;112;2.0
2;676;1591;1606;15;112;2.0
2;677;1606;1621;15;112;2.0
2;678;1621;1636;15;112;2.0
2;679;1636;1651;15;112;2.0
2;680;1651;1666;15;112;2.0
2;681;1666;1680;14;112;2.0
3;0;245;284;39;112;2.0
3;1;284;322;38;112;2.0
3;2;322;327;5;112;2.0
3;3;327;328;1;112;2.0
3;4;328;329;1;112;2.0
3;5;329;331;2;112;2.0
3;6;331;332;1;112;2.0
3;7;332;333;1;112;2.0
3;8;333;334;1;112;2.0
3;9;334;335;1;112;2.0
3;10;335;338;3;112;2.0
3;11;338;339;1;112;2.0
3;12;339;340;1;112;2.0
3;13;340;341;1;112;2.0
3;14;341;342;1;112;2.0
3;15;342;343;1;112;2.0
3;16;343;344;1;112;2.0
3;17;344;347;3;112;2.0
3;18;347;349;2;112;2.0
3;19;349;350;1;112;2.0
3;20;350;351;1;112;2.0
3;21;351;353;2;112;2.0
3;22;353;354;1;112;2.0
3;23;354;355;1;112;2.0
3;24;355;356;1;112;2.0
3;25;356;357;1;112;2.0
3;26;357;358;1;112;2.0
3;27;358;359;1;112;2.0
3;28;359;360;1;112;2.0
3;29;360;361;1;112;2.0
3;30;361;364;3;112;2.0
3;31;364;365;1;112;2.0
3;32;365;366;1;112;2.0
3;33;366;367;1;112;2.0
3;34;367;369;2;112;2.0
3;35;369;370;1;112;2.0
3;36;370;371;1;112;2.0
3;37;371;373;2;112;2.0
3;38;373;377;4;112;2.0
3;39;377;378;1;112;2.0
3;40;378;379;1;112;2.0
3;41;379;380;1;112;2.0
3;42;380;382;2;112;2.0
3;43;382;384;2;112;2.0
3;44;384;386;2;112;2.0
3;45;386;387;1;112;2.0
3;46;387;388;1;112;2.0
3;47;388;389;1;112;2.0
3;48;389;390;1;112;2.0
3;49;390;391;1;112;2.0
3;50;391;392;1;112;2.0
3;51;392;393;1;112;2.0
3;52;393;394;1;112;2.0
3;53;394;395;1;112;2.0
3;54;395;398;3;112;2.0
3;55;398;400;2;112;2.0
3;56;400;402;2;112;2.0
3;57;402;403;1;112;2.0
3;58;403;404;1;112;2.0
3;59;404;405;1;112;2.0
3;60;405;407;2;112;2.0
3;61;407;408;1;112;2.0
3;62;408;409;1;112;2.0
3;63;409;411;2;112;2.0
3;64;411;412;1;112;2.0
3;65;412;413;1;112;2.0
3;66;413;414;1;112;2.0
3;67;414;416;2;112;2.0
3;68;416;417;1;112;2.0
3;69;417;418;1;112;2.0
3;70;418;419;1;112;2.0
3;71;419;420;1;112;2.0
3;72;420;421;1;112;2.0
3;73;421;422;1;112;2.0
3;74;422;424;2;112;2.0
3;75;424;425;1;112;2.0
3;76;425;427;2;112;2.0
3;77;427;428;1;112;2.0
3;78;428;429;1;112;2.0
3;79;429;430;1;112;2.0
3;80;430;431;1;112;2.0
3;81;431;432;1;112;2.0
3;82;432;433;1;112;2.0
3;83;433;434;1;112;2.0
3;84;434;435;1;112;2.0
3;85;435;436;1;112;2.0
3;86;436;438;2;112;2.0
3;87;438;440;2;112;2.0
3;88;440;442;2;112;2.0
3;89;442;444;2;112;2.0
3;90;444;446;2;112;2.0
3;91;446;447;1;112;2.0
3;92;447;448;1;112;2.0
3;93;448;449;1;112;2.0
3;94;449;450;1;112;2.0
3;95;450;451;1;112;2.0
3;96;451;452;1;112;2.0
3;97;452;453;1;112;2.0
3;98;453;454;1;112;2.0
3;99;454;458;4;112;2.0
3;100;458;459;1;112;2.0
3;101;459;460;1;112;2.0
3;102;460;462;2;112;2.0
3;103;462;463;1;112;2.0
3;104;463;464;1;112;2.0
3;105;464;465;1;112;2.0
3;106;465;467;2;112;2.0
3;107;467;468;1;112;2.0
3;108;468;469;1;112;2.0
3;109;469;471;2;112;2.0
3;110;471;472;1;112;2.0
3;111;472;473;1;112;2.0
3;112;473;474;1;112;2.0
3;113;474;476;2;112;2.0
3;114;476;477;1;112;2.0
3;115;477;478;1;112;2.0
3;116;478;479;1;112;2.0
3;117;479;480;1;112;2.0
3;118;480;481;1;112;2.0
3;119;481;482;1;112;2.0
3;120;482;484;2;112;2.0
3;121;484;485;1;112;2.0
3;122;485;488;3;112;2.0
3;123;488;491;3;112;2.0
3;124;491;492;1;112;2.0
3;125;492;493;1;112;2.0
3;126;493;494;1;112;2.0
3;127;494;495;1;112;2.0
3;128;495;499;4;112;2.0
3;129;499;500;1;112;2.0
3;130;500;503;3;112;2.0
3;131;503;504;1;112;2.0
3;132;504;507;3;112;2.0
3;133;507;508;1;112;2.0
3;134;508;511;3;112;2.0
3;135;511;512;1;112;2.0
3;136;512;513;1;112;2.0
3;137;513;514;1;112;2.0
3;138;514;516;2;112;2.0
3;139;516;517;1;112;2.0
3;140;517;519;2;112;2.0
3;141;519;520;1;112;2.0
3;142;520;524;4;112;2.0
3;143;524;525;1;112;2.0
3;144;525;526;1;112;2.0
3;145;526;527;1;112;2.0
3;146;527;528;1;112;2.0
3;147;528;531;3;112;2.0
3;148;531;532;1;112;2.0
3;149;532;533;1;112;2.0
3;150;533;534;1;112;2.0
3;151;534;535;1;112;2.0
3;152;535;536;1;112;2.0
3;153;536;537;1;112;2.0
3;154;537;539;2;112;2.0
3;155;539;540;1;112;2.0
3;156;540;542;2;112;2.0
3;157;542;543;1;112;2.0
3;158;543;544;1;112;2.0
3;159;544;545;1;112;2.0
3;160;545;548;3;112;2.0
3;161;548;549;1;112;2.0
3;162;549;550;1;112;2.0
3;163;550;551;1;112;2.0
3;164;551;552;1;112;2.0
3;165;552;553;1;112;2.0
3;166;553;554;1;112;2.0
3;167;554;559;5;112;2.0
3;168;559;560;1;112;2.0
3;169;560;561;1;112;2.0
3;170;561;562;1;112;2.0
3;171;562;564;2;112;2.0
3;172;564;568;4;112;2.0
3;173;568;570;2;112;2.0
3;174;570;571;1;112;2.0
3;175;571;572;1;112;2.0
3;176;572;573;1;112;2.0
3;177;573;580;7;112;2.0
3;178;580;581;1;112;2.0
3;179;581;582;1;112;2.0
3;180;582;584;2;112;2.0
3;181;584;587;3;112;2.0
3;182;587;588;1;112;2.0
3;183;588;589;1;112;2.0
3;184;589;591;2;112;2.0
3;185;591;593;2;112;2.0
3;186;593;595;2;112;2.0
3;187;595;596;1;112;2.0
3;188;596;599;3;112;2.0
3;189;599;600;1;112;2.0
3;190;600;602;2;112;2.0
3;191;602;604;2;112;2.0
3;192;604;608;4;112;2.0
3;193;608;611;3;112;2.0
3;194;611;612;1;112;2.0
3;195;612;613;1;112;2.0
3;196;613;614;1;112;2.0
3;197;614;617;3;112;2.0
3;198;617;618;1;112;2.0
3;199;618;620;2;112;2.0
3;200;620;622;2;112;2.0
3;201;622;624;2;112;2.0
3;202;624;625;1;112;2.0
3;203;625;628;3;112;2.0
3;204;628;630;2;112;2.0
3;205;630;631;1;112;2.0
3;206;631;632;1;112;2.0
3;207;632;633;1;112;2.0
3;208;633;640;7;112;2.0
3;209;640;642;2;112;2.0
3;210;642;644;2;112;2.0
3;211;644;647;3;112;2.0
3;212;647;648;1;112;2.0
3;213;648;651;3;112;2.0
3;214;651;652;1;112;2.0
3;215;652;653;1;112;2.0
3;216;653;654;1;112;2.0
3;217;654;655;1;112;2.0
3;218;655;656;1;112;2.0
3;219;656;657;1;112;2.0
3;220;657;658;1;112;2.0
3;221;658;659;1;112;2.0
3;222;659;660;1;112;2.0
3;223;660;662;2;112;2.0
3;224;662;664;2;112;2.0
3;225;664;668;4;112;2.0
3;226;668;671;3;112;2.0
3;227;671;672;1;112;2.0
3;228;672;673;1;112;2.0
3;229;673;680;7;112;2.0
3;230;680;682;2;112;2.0
3;231;682;683;1;112;2.0
3;232;683;684;1;112;2.0
3;233;684;688;4;112;2.0
3;234;688;690;2;112;2.0
3;235;690;691;1;112;2.0
3;236;691;692;1;112;2.0
3;237;692;693;1;112;2.0
3;238;693;694;1;112;2.0
3;239;694;699;5;112;2.0
3;240;699;700;1;112;2.0
3;241;700;702;2;112;2.0
3;242;702;704;2;112;2.0
3;243;704;708;4;112;2.0
3;244;708;709;1;112;2.0
3;245;709;711;2;112;2.0
3;246;711;713;2;112;2.0
3;247;713;715;2;112;2.0
3;248;715;716;1;112;2.0
3;249;716;717;1;112;2.0
3;250;717;718;1;112;2.0
3;251;718;719;1;112;2.0
3;252;719;720;1;112;2.0
3;253;720;722;2;112;2.0
3;254;722;723;1;112;2.0
3;255;723;724;1;112;2.0
3;256;724;727;3;112;2.0
3;257;727;728;1;112;2.0
3;258;728;731;3;112;2.0
3;259;731;732;1;112;2.0
3;260;732;733;1;112;2.0
3;261;733;737;4;112;2.0
3;262;737;738;1;112;2.0
3;263;738;740;2;112;2.0
3;264;740;741;1;112;2.0
3;265;741;742;1;112;2.0
3;266;742;744;2;112;2.0
3;267;744;748;4;112;2.0
3;268;748;750;2;112;2.0
3;269;750;751;1;112;2.0
3;270;751;752;1;112;2.0
3;271;752;753;1;112;2.0
3;272;753;759;6;112;2.0
3;273;759;760;1;112;2.0
3;274;760;762;2;112;2.0
3;275;762;763;1;112;2.0
3;276;763;764;1;112;2.0
3;277;764;767;3;112;2.0
3;278;767;768;1;112;2.0
3;279;768;770;2;112;2.0
3;280;770;771;1;112;2.0
3;281;771;773;2;112;2.0
3;282;773;774;1;112;2.0
3;283;774;775;1;112;2.0
3;284;775;776;1;112;2.0
3;285;776;778;2;112;2.0
3;286;778;779;1;112;2.0
3;287;779;780;1;112;2.0
3;288;780;782;2;112;2.0
3;289;782;784;2;112;2.0
3;290;784;787;3;112;2.0
3;291;787;788;1;112;2.0
3;292;788;790;2;112;2.0
3;293;790;791;1;112;2.0
3;294;791;792;1;112;2.0
3;295;792;793;1;112;2.0
3;296;793;794;1;112;2.0
3;297;794;795;1;112;2.0
3;298;795;797;2;112;2.0
3;299;797;798;1;112;2.0
3;300;798;800;2;112;2.0
3;301;800;802;2;112;2.0
3;302;802;803;1;112;2.0
3;303;803;804;1;112;2.0
3;304;804;806;2;112;2.0
3;305;806;808;2;112;2.0
3;306;808;811;3;112;2.0
3;307;811;813;2;112;2.0
3;308;813;814;1;112;2.0
3;309;814;816;2;112;2.0
3;310;816;817;1;112;2.0
3;311;817;818;1;112;2.0
3;312;818;819;1;112;2.0
3;313;819;820;1;112;2.0
3;314;820;822;2;112;2.0
3;315;822;824;2;112;2.0
3;316;824;825;1;112;2.0
3;317;825;828;3;112;2.0
3;318;828;830;2;112;2.0
3;319;830;831;1;112;2.0
3;320;831;832;1;112;2.0
3;321;832;833;1;112;2.0
3;322;833;834;1;112;2.0
3;323;834;835;1;112;2.0
3;324;835;836;1;112;2.0
3;325;836;837;1;112;2.0
3;326;837;838;1;112;2.0
3;327;838;839;1;112;2.0
3;328;839;840;1;112;2.0
3;329;840;841;1;112;2.0
3;330;841;842;1;112;2.0
3;331;842;844;2;112;2.0
3;332;844;845;1;112;2.0
3;333;845;847;2;112;2.0
3;334;847;848;1;112;2.0
3;335;848;851;3;112;2.0
3;336;851;852;1;112;2.0
3;337;852;853;1;112;2.0
3;338;853;854;1;112;2.0
3;339;854;857;3;112;2.0
3;340;857;858;1;112;2.0
3;341;858;860;2;112;2.0
3;342;860;862;2;112;2.0
3;343;862;863;1;112;2.0
3;344;863;864;1;112;2.0
3;345;864;865;1;112;2.0
3;346;865;866;1;112;2.0
3;347;866;867;1;112;2.0
3;348;867;868;1;112;2.0
3;349;868;869;1;112;2.0
3;350;869;871;2;112;2.0
3;351;871;872;1;112;2.0
3;352;872;873;1;112;2.0
3;353;873;874;1;112;2.0
3;354;874;876;2;112;2.0
3;355;876;878;2;112;2.0
3;356;878;879;1;112;2.0
3;357;879;880;1;112;2.0
3;358;880;882;2;112;2.0
3;359;882;883;1;112;2.0
3;360;883;884;1;112;2.0
3;361;884;885;1;112;2.0
3;362;885;886;1;112;2.0
3;363;886;887;1;112;2.0
3;364;887;888;1;112;2.0
3;365;888;889;1;112;2.0
3;366;889;891;2;112;2.0
3;367;891;892;1;112;2.0
3;368;892;893;1;112;2.0
3;369;893;894;1;112;2.0
3;370;894;895;1;112;2.0
3;371;895;896;1;112;2.0
3;372;896;898;2;112;2.0
3;373;898;899;1;112;2.0
3;374;899;900;1;112;2.0
3;375;900;901;1;112;2.0
3;376;901;902;1;112;2.0
3;377;902;903;1;112;2.0
3;378;903;904;1;112;2.0
3;379;904;905;1;112;2.0
3;380;905;906;1;112;2.0
3;381;906;907;1;112;2.0
3;382;907;908;1;112;2.0
3;383;908;909;1;112;2.0
3;384;909;911;2;112;2.0
3;385;911;912;1;112;2.0
3;386;912;913;1;112;2.0
3;387;913;914;1;112;2.0
3;388;914;915;1;112;2.0
3;389;915;916;1;112;2.0
3;390;916;917;1;112;2.0
3;391;917;918;1;112;2.0
3;392;918;920;2;112;2.0
3;393;920;922;2;112;2.0
3;394;922;923;1;112;2.0
3;395;923;924;1;112;2.0
3;396;924;925;1;112;2.0
3;397;925;927;2;112;2.0
3;398;927;928;1;112;2.0
3;399;928;931;3;112;2.0
3;400;931;932;1;112;2.0
3;401;932;933;1;112;2.0
3;402;933;934;1;112;2.0
3;403;934;935;1;112;2.0
3;404;935;936;1;112;2.0
3;405;936;937;1;112;2.0
3;406;937;938;1;112;2.0
3;407;938;939;1;112;2.0
3;408;939;940;1;112;2.0
3;409;940;942;2;112;2.0
3;410;942;943;1;112;2.0
3;411;943;944;1;112;2.0
3;412;944;945;1;112;2.0
3;413;945;946;1;112;2.0
3;414;946;948;2;112;2.0
3;415;948;951;3;112;2.0
3;416;951;952;1;112;2.0
3;417;952;953;1;112;2.0
3;418;953;954;1;112;2.0
3;419;954;955;1;112;2.0
3;420;955;956;1;112;2.0
3;421;956;957;1;112;2.0
3;422;957;958;1;112;2.0
3;423;958;959;1;112;2.0
3;424;959;960;1;112;2.0
3;425;960;961;1;112;2.0
3;426;961;962;1;112;2.0
3;427;962;964;2;112;2.0
3;428;964;965;1;112;2.0
3;429;965;966;1;112;2.0
3;430;966;968;2;112;2.0
3;431;968;969;1;112;2.0
3;432;969;971;2;112;2.0
3;433;971;972;1;112;2.0
3;434;972;973;1;112;2.0
3;435;973;974;1;112;2.0
3;436;974;975;1;112;2.0
3;437;975;976;1;112;2.0
3;438;976;977;1;112;2.0
3;439;977;978;1;112;2.0
3;440;978;980;2;112;2.0
3;441;980;981;1;112;2.0
3;442;981;982;1;112;2.0
3;443;982;984;2;112;2.0
3;444;984;985;1;112;2.0
3;445;985;988;3;112;2.0
3;446;988;991;3;112;2.0
3;447;991;992;1;112;2.0
3;448;992;993;1;112;2.0
3;449;993;994;1;112;2.0
3;450;994;995;1;112;2.0
3;451;995;997;2;112;2.0
3;452;997;998;1;112;2.0
3;453;998;999;1;112;2.0
3;454;999;1000;1;112;2.0
3;455;1000;1002;2;112;2.0
3;456;1002;1003;1;112;2.0
3;457;1003;1004;1;112;2.0
3;458;1004;1005;1;112;2.0
3;459;1005;1006;1;112;2.0
3;460;1006;1007;1;112;2.0
3;461;1007;1008;1;112;2.0
3;462;1008;1010;2;112;2.0
3;463;1010;1011;1;112;2.0
3;464;1011;1012;1;112;2.0
3;465;1012;1013;1;112;2.0
3;466;1013;1014;1;112;2.0
3;467;1014;1016;2;112;2.0
3;468;1016;1017;1;112;2.0
3;469;1017;1018;1;112;2.0
3;470;1018;1019;1;112;2.0
3;471;1019;1020;1;112;2.0
3;472;1020;1021;1;112;2.0
3;473;1021;1022;1;112;2.0
3;474;1022;1025;3;112;2.0
3;475;1025;1027;2;112;2.0
3;476;1027;1028;1;112;2.0
3;477;1028;1030;2;112;2.0
3;478;1030;1031;1;112;2.0
3;479;1031;1032;1;112;2.0
3;480;1032;1033;1;112;2.0
3;481;1033;1034;1;112;2.0
3;482;1034;1036;2;112;2.0
3;483;1036;1037;1;112;2.0
3;484;1037;1038;1;112;2.0
3;485;1038;1040;2;112;2.0
3;486;1040;1042;2;112;2.0
3;487;1042;1043;1;112;2.0
3;488;1043;1045;2;112;2.0
3;489;1045;1047;2;112;2.0
3;490;1047;1048;1;112;2.0
3;491;1048;1049;1;112;2.0
3;492;1049;1051;2;112;2.0
3;493;1051;1052;1;112;2.0
3;494;1052;1053;1;112;2.0
3;495;1053;1054;1;112;2.0
3;496;1054;1055;1;112;2.0
3;497;1055;1057;2;112;2.0
3;498;1057;1059;2;112;2.0
3;499;1059;1060;1;112;2.0
3;500;1060;1063;3;112;2.0
3;501;1063;1064;1;112;2.0
3;502;1064;1065;1;112;2.0
3;503;1065;1066;1;112;2.0
3;504;1066;1067;1;112;2.0
3;505;1067;1071;4;112;2.0
3;506;1071;1072;1;112;2.0
3;507;1072;1073;1;112;2.0
3;508;1073;1075;2;112;2.0
3;509;1075;1076;1;112;2.0
3;510;1076;1077;1;112;2.0
3;511;1077;1078;1;112;2.0
3;512;1078;1079;1;112;2.0
3;513;1079;1080;1;112;2.0
3;514;1080;1083;3;112;2.0
3;515;1083;1084;1;112;2.0
3;516;1084;1085;1;112;2.0
3;517;1085;1086;1;112;2.0
3;518;1086;1087;1;112;2.0
3;519;1087;1088;1;112;2.0
3;520;1088;1091;3;112;2.0
3;521;1091;1092;1;112;2.0
3;522;1092;1093;1;112;2.0
3;523;1093;1094;1;112;2.0
3;524;1094;1095;1;112;2.0
3;525;1095;1097;2;112;2.0
3;526;1097;1098;1;112;2.0
3;527;1098;1099;1;112;2.0
3;528;1099;1101;2;112;2.0
3;529;1101;1102;1;112;2.0
3;530;1102;1105;3;112;2.0
3;531;1105;1106;1;112;2.0
3;532;1106;1108;2;112;2.0
3;533;1108;1109;1;112;2.0
3;534;1109;1110;1;112;2.0
3;535;1110;1111;1;112;2.0
3;536;1111;1113;2;112;2.0
3;537;1113;1117;4;112;2.0
3;538;1117;1120;3;112;2.0
3;539;1120;1121;1;112;2.0
3;540;1121;1123;2;112;2.0
3;541;1123;1124;1;112;2.0
3;542;1124;1129;5;112;2.0
3;543;1129;1132;3;112;2.0
3;544;1132;1133;1;112;2.0
3;545;1133;1134;1;112;2.0
3;546;1134;1135;1;112;2.0
3;547;1135;1139;4;112;2.0
3;548;1139;1140;1;112;2.0
3;549;1140;1141;1;112;2.0
3;550;1141;1143;2;112;2.0
3;551;1143;1144;1;112;2.0
3;552;1144;1148;4;112;2.0
3;553;1148;1150;2;112;2.0
3;554;1150;1152;2;112;2.0
3;555;1152;1153;1;112;2.0
3;556;1153;1155;2;112;2.0
3;557;1155;1156;1;112;2.0
3;558;1156;1159;3;112;2.0
3;559;1159;1161;2;112;2.0
3;560;1161;1162;1;112;2.0
3;561;1162;1165;3;112;2.0
3;562;1165;1166;1;112;2.0
3;563;1166;1170;4;112;2.0
3;564;1170;1171;1;112;2.0
3;565;1171;1173;2;112;2.0
3;566;1173;1178;5;112;2.0
3;567;1178;1179;1;112;2.0
3;568;1179;1180;1;112;2.0
3;569;1180;1181;1;112;2.0
3;570;1181;1185;4;112;2.0
3;571;1185;1190;5;112;2.0
3;572;1190;1192;2;112;2.0
3;573;1192;1196;4;112;2.0
3;574;1196;1198;2;112;2.0
3;575;1198;1199;1;112;2.0
3;576;1199;1200;1;112;2.0
3;577;1200;1201;1;112;2.0
3;578;1201;1203;2;112;2.0
3;579;1203;1204;1;112;2.0
3;580;1204;1205;1;112;2.0
3;581;1205;1207;2;112;2.0
3;582;1207;1208;1;112;2.0
3;583;1208;1210;2;112;2.0
3;584;1210;1213;3;112;2.0
3;585;1213;1218;5;112;2.0
3;586;1218;1219;1;112;2.0
3;587;1219;1221;2;112;2.0
3;588;1221;1225;4;112;2.0
3;589;1225;1226;1;112;2.0
3;590;1226;1230;4;112;2.0
3;591;1230;1231;1;112;2.0
3;592;1231;1235;4;112;2.0
3;593;1235;1238;3;112;2.0
3;594;1238;1239;1;112;2.0
3;595;1239;1243;4;112;2.0
3;596;1243;1251;8;112;2.0
3;597;1251;1254;3;112;2.0
3;598;1254;1255;1;112;2.0
3;599;1255;1256;1;112;2.0
3;600;1256;1257;1;112;2.0
3;601;1257;1259;2;112;2.0
3;602;1259;1263;4;112;2.0
3;603;1263;1264;1;112;2.0
3;604;1264;1265;1;112;2.0
3;605;1265;1268;3;112;2.0
3;606;1268;1269;1;112;2.0
3;607;1269;1270;1;112;2.0
3;608;1270;1272;2;112;2.0
3;609;1272;1273;1;112;2.0
3;610;1273;1275;2;112;2.0
3;611;1275;1276;1;112;2.0
3;612;1276;1280;4;112;2.0
3;613;1280;1281;1;112;2.0
3;614;1281;1282;1;112;2.0
3;615;1282;1283;1;112;2.0
3;616;1283;1284;1;112;2.0
3;617;1284;1288;4;112;2.0
3;618;1288;1289;1;112;2.0
3;619;1289;1290;1;112;2.0
3;620;1290;1295;5;112;2.0
3;621;1295;1300;5;112;2.0
3;622;1300;1301;1;112;2.0
3;623;1301;1305;4;112;2.0
3;624;1305;1306;1;112;2.0
3;625;1306;1308;2;112;2.0
3;626;1308;1313;5;112;2.0
3;627;1313;1314;1;112;2.0
3;628;1314;1315;1;112;2.0
3;629;1315;1319;4;112;2.0
3;630;1319;1320;1;112;2.0
3;631;1320;1322;2;112;2.0
3;632;1322;1323;1;112;2.0
3;633;1323;1325;2;112;2.0
3;634;1325;1331;6;112;2.0
3;635;1331;1333;2;112;2.0
3;636;1333;1334;1;112;2.0
3;637;1334;1338;4;112;2.0
3;638;1338;1339;1;112;2.0
3;639;1339;1340;1;112;2.0
3;640;1340;1344;4;112;2.0
3;641;1344;1345;1;112;2.0
3;642;1345;1346;1;112;2.0
3;643;1346;1350;4;112;2.0
3;644;1350;1351;1;112;2.0
3;645;1351;1353;2;112;2.0
3;646;1353;1356;3;112;2.0
3;647;1356;1357;1;112;2.0
3;648;1357;1359;2;112;2.0
3;649;1359;1363;4;112;2.0
3;650;1363;1366;3;112;2.0
3;651;1366;1367;1;112;2.0
3;652;1367;1368;1;112;2.0
3;653;1368;1369;1;112;2.0
3;654;1369;1373;4;112;2.0
3;655;1373;1378;5;112;2.0
3;656;1378;1380;2;112;2.0
3;657;1380;1381;1;112;2.0
3;658;1381;1383;2;112;2.0
3;659;1383;1384;1;112;2.0
3;660;1384;1386;2;112;2.0
3;661;1386;1390;4;112;2.0
3;662;1390;1396;6;112;2.0
3;663;1396;1411;15;112;2.0
3;664;1411;1426;15;112;2.0
3;665;1426;1441;15;112;2.0
3;666;1441;1456;15;112;2.0
3;667;1456;1471;15;112;2.0
3;668;1471;1486;15;112;2.0
3;669;1486;1501;15;112;2.0
3;670;1501;1516;15;112;2.0
3;671;1516;1531;15;112;2.0
3;672;1531;1546;15;112;2.0
3;673;1546;1561;15;112;2.0
3;674;1561;1576;15;112;2.0
3;675;1576;1591;15;112;2.0
3;676;1591;1606;15;112;2.0
3;677;1606;1621;15;112;2.0
3;678;1621;1636;15;112;2.0
3;679;1636;1651;15;112;2.0
3;680;1651;1666;15;112;2.0
3;681;1666;1680;14;112;2.0
4;0;245;284;39;112;2.0
4;1;284;322;38;112;2.0
4;2;322;327;5;112;2.0
4;3;327;328;1;112;2.0
4;4;328;329;1;112;2.0
4;5;329;331;2;112;2.0
4;6;331;332;1;112;2.0
4;7;332;333;1;112;2.0
4;8;333;334;1;112;2.0
4;9;334;335;1;112;2.0
4;10;335;338;3;112;2.0
4;11;338;339;1;112;2.0
4;12;339;340;1;112;2.0
4;13;340;341;1;112;2.0
4;14;341;342;1;112;2.0
4;15;342;343;1;112;2.0
4;16;343;344;1;112;2.0
4;17;344;347;3;112;2.0
4;18;347;349;2;112;2.0
4;19;349;350;1;112;2.0
4;20;350;351;1;112;2.0
4;21;351;353;2;112;2.0
4;22;353;354;1;112;2.0
4;23;354;355;1;112;2.0
4;24;355;356;1;112;2.0
4;25;356;357;1;112;2.0
4;26;357;358;1;112;2.0
4;27;358;359;1;112;2.0
4;28;359;360;1;112;2.0
4;29;360;361;1;112;2.0
4;30;361;364;3;112;2.0
4;31;364;365;1;112;2.0
4;32;365;366;1;112;2.0
4;33;366;367;1;112;2.0
4;34;367;369;2;112;2.0
4;35;369;370;1;112;2.0
4;36;370;371;1;112;2.0
4;37;371;373;2;112;2.0
4;38;373;377;4;112;2.0
4;39;377;378;1;112;2.0
4;40;378;379;1;112;2.0
4;41;379;380;1;112;2.0
4;42;380;382;2;112;2.0
4;43;382;384;2;112;2.0
4;44;384;386;2;112;2.0
4;45;386;387;1;112;2.0
4;46;387;388;1;112;2.0
4;47;388;389;1;112;2.0
4;48;389;390;1;112;2.0
4;49;390;391;1;112;2.0
4;50;391;392;1;112;2.0
4;51;392;393;1;112;2.0
4;52;393;394;1;112;2.0
4;53;394;395;1;112;2.0
4;54;395;398;3;112;2.0
4;55;398;400;2;112;2.0
4;56;400;402;2;112;2.0
4;57;402;403;1;112;2.0
4;58;403;404;1;112;2.0
4;59;404;405;1;112;2.0
4;60;405;407;2;112;2.0
4;61;407;408;1;112;2.0
4;62;408;409;1;112;2.0
4;63;409;411;2;112;2.0
4;64;411;412;1;112;2.0
4;65;412;413;1;112;2.0
4;66;413;414;1;112;2.0
4;67;414;416;2;112;2.0
4;68;416;417;1;112;2.0
4;69;417;418;1;112;2.0
4;70;418;419;1;112;2.0
4;71;419;420;1;112;2.0
4;72;420;421;1;112;2.0
4;73;421;422;1;112;2.0
4;74;422;424;2;112;2.0
4;75;424;425;1;112;2.0
4;76;425;427;2;112;2.0
4;77;427;428;1;112;2.0
4;78;428;429;1;112;2.0
4;79;429;430;1;112;2.0
4;80;430;431;1;112;2.0
4;81;431;432;1;112;2.0
4;82;432;433;1;112;2.0
4;83;433;434;1;112;2.0
4;84;434;435;1;112;2.0
4;85;435;436;1;112;2.0
4;86;436;438;2;112;2.0
4;87;438;440;2;112;2.0
4;88;440;442;2;112;2.0
4;89;442;444;2;112;2.0
4;90;444;446;2;112;2.0
4;91;446;447;1;112;2.0
4;92;447;448;1;112;2.0
4;93;448;449;1;112;2.0
4;94;449;450;1;112;2.0
4;95;450;451;1;112;2.0
4;96;451;452;1;112;2.0
4;97;452;453;1;112;2.0
4;98;453;454;1;112;2.0
4;99;454;458;4;112;2.0
4;100;458;459;1;112;2.0
4;101;459;460;1;112;2.0
4;102;460;462;2;112;2.0
4;103;462;463;1;112;2.0
4;104;463;464;1;112;2.0
4;105;464;465;1;112;2.0
4;106;465;467;2;112;2.0
4;107;467;468;1;112;2.0
4;108;468;469;1;112;2.0
4;109;469;471;2;112;2.0
4;110;471;472;1;112;2.0
4;111;472;473;1;112;2.0
4;112;473;474;1;112;2.0
4;113;474;476;2;112;2.0
4;114;476;477;1;112;2.0
4;115;477;478;1;112;2.0
4;116;478;479;1;112;2.0
4;117;479;480;1;112;2.0
4;118;480;481;1;112;2.0
4;119;481;482;1;112;2.0
4;120;482;484;2;112;2.0
4;121;484;485;1;112;2.0
4;122;485;488;3;112;2.0
4;123;488;491;3;112;2.0
4;124;491;492;1;112;2.0
4;125;492;493;1;112;2.0
4;126;493;494;1;112;2.0
4;127;494;495;1;112;2.0
4;128;495;499;4;112;2.0
4;129;499;500;1;112;2.0
4;130;500;503;3;112;2.0
4;131;503;504;1;112;2.0
4;132;504;507;3;112;2.0
4;133;507;508;1;112;2.0
4;134;508;511;3;112;2.0
4;135;511;512;1;112;2.0
4;136;512;513;1;112;2.0
4;137;513;514;1;112;2.0
4;138;514;516;2;112;2.0
4;139;516;517;1;112;2.0
4;140;517;519;2;112;2.0
4;141;519;520;1;112;2.0
4;142;520;524;4;112;2.0
4;143;524;525;1;112;2.0
4;144;525;526;1;112;2.0
4;145;526;527;1;112;2.0
4;146;527;528;1;112;2.0
4;147;528;531;3;112;2.0
4;148;531;532;1;112;2.0
4;149;532;533;1;112;2.0
4;150;533;534;1;112;2.0
4;151;534;535;1;112;2.0
4;152;535;536;1;112;2.0
4;153;536;537;1;112;2.0
4;154;537;539;2;112;2.0
4;155;539;540;1;112;2.0
4;156;540;542;2;112;2.0
4;157;542;543;1;112;2.0
4;158;543;544;1;112;2.0
4;159;544;545;1;112;2.0
4;160;545;548;3;112;2.0
4;161;548;549;1;112;2.0
4;162;549;550;1;112;2.0
4;163;550;551;1;112;2.0
4;164;551;552;1;112;2.0
4;165;552;553;1;112;2.0
4;166;553;554;1;112;2.0
4;167;554;559;5;112;2.0
4;168;559;560;1;112;2.0
4;169;560;561;1;112;2.0
4;170;561;562;1;112;2.0
4;171;562;564;2;112;2.0
4;172;564;568;4;112;2.0
4;173;568;570;2;112;2.0
4;174;570;571;1;112;2.0
4;175;571;572;1;112;2.0
4;176;572;573;1;112;2.0
4;177;573;580;7;112;2.0
4;178;580;581;1;112;2.0
4;179;581;582;1;112;2.0
4;180;582;584;2;112;2.0
4;181;584;587;3;112;2.0
4;182;587;588;1;112;2.0
4;183;588;589;1;112;2.0
4;184;589;591;2;112;2.0
4;185;591;593;2;112;2.0
4;186;593;595;2;112;2.0
4;187;595;596;1;112;2.0
4;188;596;599;3;112;2.0
4;189;599;600;1;112;2.0
4;190;600;602;2;112;2.0
4;191;602;604;2;112;2.0
4;192;604;608;4;112;2.0
4;193;608;611;3;112;2.0
4;194;611;612;1;112;2.0
4;195;612;613;1;112;2.0
4;196;613;614;1;112;2.0
4;197;614;617;3;112;2.0
4;198;617;618;1;112;2.0
4;199;618;620;2;112;2.0
4;200;620;622;2;112;2.0
4;201;622;624;2;112;2.0
4;202;624;625;1;112;2.0
4;203;625;628;3;112;2.0
4;204;628;630;2;112;2.0
4;205;630;631;1;112;2.0
4;206;631;632;1;112;2.0
4;207;632;633;1;112;2.0
4;208;633;640;7;112;2.0
4;209;640;642;2;112;2.0
4;210;642;644;2;112;2.0
4;211;644;647;3;112;2.0
4;212;647;648;1;112;2.0
4;213;648;651;3;112;2.0
4;214;651;652;1;112;2.0
4;215;652;653;1;112;2.0
4;216;653;654;1;112;2.0
4;217;654;655;1;112;2.0
4;218;655;656;1;112;2.0
4;219;656;657;1;112;2.0
4;220;657;658;1;112;2.0
4;221;658;659;1;112;2.0
4;222;659;660;1;112;2.0
4;223;660;662;2;112;2.0
4;224;662;664;2;112;2.0
4;225;664;668;4;112;2.0
4;226;668;671;3;112;2.0
4;227;671;672;1;112;2.0
4;228;672;673;1;112;2.0
4;229;673;680;7;112;2.0
4;230;680;682;2;112;2.0
4;231;682;683;1;112;2.0
4;232;683;684;1;112;2.0
4;233;684;688;4;112;2.0
4;234;688;690;2;112;2.0
4;235;690;691;1;112;2.0
4;236;691;692;1;112;2.0
4;237;692;693;1;112;2.0
4;238;693;694;1;112;2.0
4;239;694;699;5;112;2.0
4;240;699;700;1;112;2.0
4;241;700;702;2;112;2.0
4;242;702;704;2;112;2.0
4;243;704;708;4;112;2.0
4;244;708;709;1;112;2.0
4;245;709;711;2;112;2.0
4;246;711;713;2;112;2.0
4;247;713;715;2;112;2.0
4;248;715;716;1;112;2.0
4;249;716;717;1;112;2.0
4;250;717;718;1;112;2.0
4;251;718;719;1;112;2.0
4;252;719;720;1;112;2.0
4;253;720;722;2;112;2.0
4;254;722;723;1;112;2.0
4;255;723;724;1;112;2.0
4;256;724;727;3;112;2.0
4;257;727;728;1;112;2.0
4;258;728;731;3;112;2.0
4;259;731;732;1;112;2.0
4;260;732;733;1;112;2.0
4;261;733;737;4;112;2.0
4;262;737;738;1;112;2.0
4;263;738;740;2;112;2.0
4;264;740;741;1;112;2.0
4;265;741;742;1;112;2.0
4;266;742;744;2;112;2.0
4;267;744;748;4;112;2.0
4;268;748;750;2;112;2.0
4;269;750;751;1;112;2.0
4;270;751;752;1;112;2.0
4;271;752;753;1;112;2.0
4;272;753;759;6;112;2.0
4;273;759;760;1;112;2.0
4;274;760;762;2;112;2.0
4;275;762;763;1;112;2.0
4;276;763;764;1;112;2.0
4;277;764;767;3;112;2.0
4;278;767;768;1;112;2.0
4;279;768;770;2;112;2.0
4;280;770;771;1;112;2.0
4;281;771;773;2;112;2.0
4;282;773;774;1;112;2.0
4;283;774;775;1;112;2.0
4;284;775;776;1;112;2.0
4;285;776;778;2;112;2.0
4;286;778;779;1;112;2.0
4;287;779;780;1;112;2.0
4;288;780;782;2;112;2.0
4;289;782;784;2;112;2.0
4;290;784;787;3;112;2.0
4;291;787;788;1;112;2.0
4;292;788;790;2;112;2.0
4;293;790;791;1;112;2.0
4;294;791;792;1;112;2.0
4;295;792;793;1;112;2.0
4;296;793;794;1;112;2.0
4;297;794;795;1;112;2.0
4;298;795;797;2;112;2.0
4;299;797;798;1;112;2.0
4;300;798;800;2;112;2.0
4;301;800;802;2;112;2.0
4;302;802;803;1;112;2.0
4;303;803;804;1;112;2.0
4;304;804;806;2;112;2.0
4;305;806;808;2;112;2.0
4;306;808;811;3;112;2.0
4;307;811;813;2;112;2.0
4;308;813;814;1;112;2.0
4;309;814;816;2;112;2.0
4;310;816;817;1;112;2.0
4;311;817;818;1;112;2.0
4;312;818;819;1;112;2.0
4;313;819;820;1;112;2.0
4;314;820;822;2;112;2.0
4;315;822;824;2;112;2.0
4;316;824;825;1;112;2.0
4;317;825;828;3;112;2.0
4;318;828;830;2;112;2.0
4;319;830;831;1;112;2.0
4;320;831;832;1;112;2.0
4;321;832;833;1;112;2.0
4;322;833;834;1;112;2.0
4;323;834;835;1;112;2.0
4;324;835;836;1;112;2.0
4;325;836;837;1;112;2.0
4;326;837;838;1;112;2.0
4;327;838;839;1;112;2.0
4;328;839;840;1;112;2.0
4;329;840;841;1;112;2.0
4;330;841;842;1;112;2.0
4;331;842;844;2;112;2.0
4;332;844;845;1;112;2.0
4;333;845;847;2;112;2.0
4;334;847;848;1;112;2.0
4;335;848;851;3;112;2.0
4;336;851;852;1;112;2.0
4;337;852;853;1;112;2.0
4;338;853;854;1;112;2.0
4;339;854;857;3;112;2.0
4;340;857;858;1;112;2.0
4;341;858;860;2;112;2.0
4;342;860;862;2;112;2.0
4;343;862;863;1;112;2.0
4;344;863;864;1;112;2.0
4;345;864;865;1;112;2.0
4;346;865;866;1;112;2.0
4;347;866;867;1;112;2.0
4;348;867;868;1;112;2.0
4;349;868;869;1;112;2.0
4;350;869;871;2;112;2.0
4;351;871;872;1;112;2.0
4;352;872;873;1;112;2.0
4;353;873;874;1;112;2.0
4;354;874;876;2;112;2.0
4;355;876;878;2;112;2.0
4;356;878;879;1;112;2.0
4;357;879;880;1;112;2.0
4;358;880;882;2;112;2.0
4;359;882;883;1;112;2.0
4;360;883;884;1;112;2.0
4;361;884;885;1;112;2.0
4;362;885;886;1;112;2.0
4;363;886;887;1;112;2.0
4;364;887;888;1;112;2.0
4;365;888;889;1;112;2.0
4;366;889;891;2;112;2.0
4;367;891;892;1;112;2.0
4;368;892;893;1;112;2.0
4;369;893;894;1;112;2.0
4;370;894;895;1;112;2.0
4;371;895;896;1;112;2.0
4;372;896;898;2;112;2.0
4;373;898;899;1;112;2.0
4;374;899;900;1;112;2.0
4;375;900;901;1;112;2.0
4;376;901;902;1;112;2.0
4;377;902;903;1;112;2.0
4;378;903;904;1;112;2.0
4;379;904;905;1;112;2.0
4;380;905;906;1;112;2.0
4;381;906;907;1;112;2.0
4;382;907;908;1;112;2.0
4;383;908;909;1;112;2.0
4;384;909;911;2;112;2.0
4;385;911;912;1;112;2.0
4;386;912;913;1;112;2.0
4;387;913;914;1;112;2.0
4;388;914;915;1;112;2.0
4;389;915;916;1;112;2.0
4;390;916;917;1;112;2.0
4;391;917;918;1;112;2.0
4;392;918;920;2;112;2.0
4;393;920;922;2;112;2.0
4;394;922;923;1;112;2.0
4;395;923;924;1;112;2.0
4;396;924;925;1;112;2.0
4;397;925;927;2;112;2.0
4;398;927;928;1;112;2.0
4;399;928;931;3;112;2.0
4;400;931;932;1;112;2.0
4;401;932;933;1;112;2.0
4;402;933;934;1;112;2.0
4;403;934;935;1;112;2.0
4;404;935;936;1;112;2.0
4;405;936;937;1;112;2.0
4;406;937;938;1;112;2.0
4;407;938;939;1;112;2.0
4;408;939;940;1;112;2.0
4;409;940;942;2;112;2.0
4;410;942;943;1;112;2.0
4;411;943;944;1;112;2.0
4;412;944;945;1;112;2.0
4;413;945;946;1;112;2.0
4;414;946;948;2;112;2.0
4;415;948;951;3;112;2.0
4;416;951;952;1;112;2.0
4;417;952;953;1;112;2.0
4;418;953;954;1;112;2.0
4;419;954;955;1;112;2.0
4;420;955;956;1;112;2.0
4;421;956;957;1;112;2.0
4;422;957;958;1;112;2.0
4;423;958;959;1;112;2.0
4;424;959;960;1;112;2.0
4;425;960;961;1;112;2.0
4;426;961;962;1;112;2.0
4;427;962;964;2;112;2.0
4;428;964;965;1;112;2.0
4;429;965;966;1;112;2.0
4;430;966;968;2;112;2.0
4;431;968;969;1;112;2.0
4;432;969;971;2;112;2.0
4;433;971;972;1;112;2.0
4;434;972;973;1;112;2.0
4;435;973;974;1;112;2.0
4;436;974;975;1;112;2.0
4;437;975;976;1;112;2.0
4;438;976;977;1;112;2.0
4;439;977;978;1;112;2.0
4;440;978;980;2;112;2.0
4;441;980;981;1;112;2.0
4;442;981;982;1;112;2.0
4;443;982;984;2;112;2.0
4;444;984;985;1;112;2.0
4;445;985;988;3;112;2.0
4;446;988;991;3;112;2.0
4;447;991;992;1;112;2.0
4;448;992;993;1;112;2.0
4;449;993;994;1;112;2.0
4;450;994;995;1;112;2.0
4;451;995;997;2;112;2.0
4;452;997;998;1;112;2.0
4;453;998;999;1;112;2.0
4;454;999;1000;1;112;2.0
4;455;1000;1002;2;112;2.0
4;456;1002;1003;1;112;2.0
4;457;1003;1004;1;112;2.0
4;458;1004;1005;1;112;2.0
4;459;1005;1006;1;112;2.0
4;460;1006;1007;1;112;2.0
4;461;1007;1008;1;112;2.0
4;462;1008;1010;2;112;2.0
4;463;1010;1011;1;112;2.0
4;464;1011;1012;1;112;2.0
4;465;1012;1013;1;112;2.0
4;466;1013;1014;1;112;2.0
4;467;1014;1016;2;112;2.0
4;468;1016;1017;1;112;2.0
4;469;1017;1018;1;112;2.0
4;470;1018;1019;1;112;2.0
4;471;1019;1020;1;112;2.0
4;472;1020;1021;1;112;2.0
4;473;1021;1022;1;112;2.0
4;474;1022;1025;3;112;2.0
4;475;1025;1027;2;112;2.0
4;476;1027;1028;1;112;2.0
4;477;1028;1030;2;112;2.0
4;478;1030;1031;1;112;2.0
4;479;1031;1032;1;112;2.0
4;480;1032;1033;1;112;2.0
4;481;1033;1034;1;112;2.0
4;482;1034;1036;2;112;2.0
4;483;1036;1037;1;112;2.0
4;484;1037;1038;1;112;2.0
4;485;1038;1040;2;112;2.0
4;486;1040;1042;2;112;2.0
4;487;1042;1043;1;112;2.0
4;488;1043;1045;2;112;2.0
4;489;1045;1047;2;112;2.0
4;490;1047;1048;1;112;2.0
4;491;1048;1049;1;112;2.0
4;492;1049;1051;2;112;2.0
4;493;1051;1052;1;112;2.0
4;494;1052;1053;1;112;2.0
4;495;1053;1054;1;112;2.0
4;496;1054;1055;1;112;2.0
4;497;1055;1057;2;112;2.0
4;498;1057;1059;2;112;2.0
4;499;1059;1060;1;112;2.0
4;500;1060;1063;3;112;2.0
4;501;1063;1064;1;112;2.0
4;502;1064;1065;1;112;2.0
4;503;1065;1066;1;112;2.0
4;504;1066;1067;1;112;2.0
4;505;1067;1071;4;112;2.0
4;506;1071;1072;1;112;2.0
4;507;1072;1073;1;112;2.0
4;508;1073;1075;2;112;2.0
4;509;1075;1076;1;112;2.0
4;510;1076;1077;1;112;2.0
4;511;1077;1078;1;112;2.0
4;512;1078;1079;1;112;2.0
4;513;1079;1080;1;112;2.0
4;514;1080;1083;3;112;2.0
4;515;1083;1084;1;112;2.0
4;516;1084;1085;1;112;2.0
4;517;1085;1086;1;112;2.0
4;518;1086;1087;1;112;2.0
4;519;1087;1088;1;112;2.0
4;520;1088;1091;3;112;2.0
4;521;1091;1092;1;112;2.0
4;522;1092;1093;1;112;2.0
4;523;1093;1094;1;112;2.0
4;524;1094;1095;1;112;2.0
4;525;1095;1097;2;112;2.0
4;526;1097;1098;1;112;2.0
4;527;1098;1099;1;112;2.0
4;528;1099;1101;2;112;2.0
4;529;1101;1102;1;112;2.0
4;530;1102;1105;3;112;2.0
4;531;1105;1106;1;112;2.0
4;532;1106;1108;2;112;2.0
4;533;1108;1109;1;112;2.0
4;534;1109;1110;1;112;2.0
4;535;1110;1111;1;112;2.0
4;536;1111;1113;2;112;2.0
4;537;1113;1117;4;112;2.0
4;538;1117;1120;3;112;2.0
4;539;1120;1121;1;112;2.0
4;540;1121;1123;2;112;2.0
4;541;1123;1124;1;112;2.0
4;542;1124;1129;5;112;2.0
4;543;1129;1132;3;112;2.0
4;544;1132;1133;1;112;2.0
4;545;1133;1134;1;112;2.0
4;546;1134;1135;1;112;2.0
4;547;1135;1139;4;112;2.0
4;548;1139;1140;1;112;2.0
4;549;1140;1141;1;112;2.0
4;550;1141;1143;2;112;2.0
4;551;1143;1144;1;112;2.0
4;552;1144;1148;4;112;2.0
4;553;1148;1150;2;112;2.0
4;554;1150;1152;2;112;2.0
4;555;1152;1153;1;112;2.0
4;556;1153;1155;2;112;2.0
4;557;1155;1156;1;112;2.0
4;558;1156;1159;3;112;2.0
4;559;1159;1161;2;112;2.0
4;560;1161;1162;1;112;2.0
4;561;1162;1165;3;112;2.0
4;562;1165;1166;1;112;2.0
4;563;1166;1170;4;112;2.0
4;564;1170;1171;1;112;2.0
4;565;1171;1173;2;112;2.0
4;566;1173;1178;5;112;2.0
4;567;1178;1179;1;112;2.0
4;568;1179;1180;1;112;2.0
4;569;1180;1181;1;112;2.0
4;570;1181;1185;4;112;2.0
4;571;1185;1190;5;112;2.0
4;572;1190;1192;2;112;2.0
4;573;1192;1196;4;112;2.0
4;574;1196;1198;2;112;2.0
4;575;1198;1199;1;112;2.0
4;576;1199;1200;1;112;2.0
4;577;1200;1201;1;112;2.0
4;578;1201;1203;2;112;2.0
4;579;1203;1204;1;112;2.0
4;580;1204;1205;1;112;2.0
4;581;1205;1207;2;112;2.0
4;582;1207;1208;1;112;2.0
4;583;1208;1210;2;112;2.0
4;584;1210;1213;3;112;2.0
4;585;1213;1218;5;112;2.0
4;586;1218;1219;1;112;2.0
4;587;1219;1221;2;112;2.0
4;588;1221;1225;4;112;2.0
4;589;1225;1226;1;112;2.0
4;590;1226;1230;4;112;2.0
4;591;1230;1231;1;112;2.0
4;592;1231;1235;4;112;2.0
4;593;1235;1238;3;112;2.0
4;594;1238;1239;1;112;2.0
4;595;1239;1243;4;112;2.0
4;596;1243;1251;8;112;2.0
4;597;1251;1254;3;112;2.0
4;598;1254;1255;1;112;2.0
4;599;1255;1256;1;112;2.0
4;600;1256;1257;1;112;2.0
4;601;1257;1259;2;112;2.0
4;602;1259;1263;4;112;2.0
4;603;1263;1264;1;112;2.0
4;604;1264;1265;1;112;2.0
4;605;1265;1268;3;112;2.0
4;606;1268;1269;1;112;2.0
4;607;1269;1270;1;112;2.0
4;608;1270;1272;2;112;2.0
4;609;1272;1273;1;112;2.0
4;610;1273;1275;2;112;2.0
4;611;1275;1276;1;112;2.0
4;612;1276;1280;4;112;2.0
4;613;1280;1281;1;112;2.0
4;614;1281;1282;1;112;2.0
4;615;1282;1283;1;112;2.0
4;616;1283;1284;1;112;2.0
4;617;1284;1288;4;112;2.0
4;618;1288;1289;1;112;2.0
4;619;1289;1290;1;112;2.0
4;620;1290;1295;5;112;2.0
4;621;1295;1300;5;112;2.0
4;622;1300;1301;1;112;2.0
4;623;1301;1305;4;112;2.0
4;624;1305;1306;1;112;2.0
4;625;1306;1308;2;112;2.0
4;626;1308;1313;5;112;2.0
4;627;1313;1314;1;112;2.0
4;628;1314;1315;1;112;2.0
4;629;1315;1319;4;112;2.0
4;630;1319;1320;1;112;2.0
4;631;1320;1322;2;112;2.0
4;632;1322;1323;1;112;2.0
4;633;1323;1325;2;112;2.0
4;634;1325;1331;6;112;2.0
4;635;1331;1333;2;112;2.0
4;636;1333;1334;1;112;2.0
4;637;1334;1338;4;112;2.0
4;638;1338;1339;1;112;2.0
4;639;1339;1340;1;112;2.0
4;640;1340;1344;4;112;2.0
4;641;1344;1345;1;112;2.0
4;642;1345;1346;1;112;2.0
4;643;1346;1350;4;112;2.0
4;644;1350;1351;1;112;2.0
4;645;1351;1353;2;112;2.0
4;646;1353;1356;3;112;2.0
4;647;1356;1357;1;112;2.0
4;648;1357;1359;2;112;2.0
4;649;1359;1363;4;112;2.0
4;650;1363;1366;3;112;2.0
4;651;1366;1367;1;112;2.0
4;652;1367;1368;1;112;2.0
4;653;1368;1369;1;112;2.0
4;654;1369;1373;4;112;2.0
4;655;1373;1378;5;112;2.0
4;656;1378;1380;2;112;2.0
4;657;1380;1381;1;112;2.0
4;658;1381;1383;2;112;2.0
4;659;1383;1384;1;112;2.0
4;660;1384;1386;2;112;2.0
4;661;1386;1390;4;112;2.0
4;662;1390;1396;6;112;2.0
4;663;1396;1411;15;112;2.0
4;664;1411;1426;15;112;2.0
4;665;1426;1441;15;112;2.0
4;666;1441;1456;15;112;2.0
4;667;1456;1471;15;112;2.0
4;668;1471;1486;15;112;2.0
4;669;1486;1501;15;112;2.0
4;670;1501;1516;15;112;2.0
4;671;1516;1531;15;112;2.0
4;672;1531;1546;15;112;2.0
4;673;1546;1561;15;112;2.0
4;674;1561;1576;15;112;2.0
4;675;1576;1591;15;112;2.0
4;676;1591;1606;15;112;2.0
4;677;1606;1621;15;112;2.0
4;678;1621;1636;15;112;2.0
4;679;1636;1651;15;112;2.0
4;680;1651;1666;15;112;2.0
4;681;1666;1680;14;112;2.0
5;0;243;281;38;25;2.0
5;1;281;323;42;25;2.0
5;2;323;328;5;25;2.0
5;3;328;329;1;25;2.0
5;4;329;330;1;25;2.0
5;5;330;331;1;25;2.0
5;6;331;332;1;25;2.0
5;7;332;333;1;25;2.0
5;8;333;334;1;25;2.0
5;9;334;335;1;25;2.0
5;10;335;336;1;25;2.0
5;11;336;338;2;25;2.0
5;12;338;339;1;25;2.0
5;13;339;340;1;25;2.0
5;14;340;341;1;25;2.0
5;15;341;342;1;25;2.0
5;16;342;343;1;25;2.0
5;17;343;345;2;25;2.0
5;18;345;347;2;25;2.0
5;19;347;349;2;25;2.0
5;20;349;350;1;25;2.0
5;21;350;351;1;25;2.0
5;22;351;354;3;25;2.0
5;23;354;355;1;25;2.0
5;24;355;356;1;25;2.0
5;25;356;357;1;25;2.0
5;26;357;358;1;25;2.0
5;27;358;359;1;25;2.0
5;28;359;360;1;25;2.0
5;29;360;361;1;25;2.0
5;30;361;362;1;25;2.0
5;31;362;364;2;25;2.0
5;32;364;366;2;25;2.0
5;33;366;368;2;25;2.0
5;34;368;369;1;25;2.0
5;35;369;376;7;25;2.0
5;36;376;378;2;25;2.0
5;37;378;379;1;25;2.0
5;38;379;380;1;25;2.0
5;39;380;381;1;25;2.0
5;40;381;382;1;25;2.0
5;41;382;383;1;25;2.0
5;42;383;384;1;25;2.0
5;43;384;386;2;25;2.0
5;44;386;387;1;25;2.0
5;45;387;388;1;25;2.0
5;46;388;389;1;25;2.0
5;47;389;390;1;25;2.0
5;48;390;391;1;25;2.0
5;49;391;393;2;25;2.0
5;50;393;394;1;25;2.0
5;51;394;395;1;25;2.0
5;52;395;396;1;25;2.0
5;53;396;400;4;25;2.0
5;54;400;401;1;25;2.0
5;55;401;402;1;25;2.0
5;56;402;403;1;25;2.0
5;57;403;404;1;25;2.0
5;58;404;405;1;25;2.0
5;59;405;406;1;25;2.0
5;60;406;408;2;25;2.0
5;61;408;409;1;25;2.0
5;62;409;410;1;25;2.0
5;63;410;411;1;25;2.0
5;64;411;413;2;25;2.0
5;65;413;414;1;25;2.0
5;66;414;415;1;25;2.0
5;67;415;416;1;25;2.0
5;68;416;417;1;25;2.0
5;69;417;418;1;25;2.0
5;70;418;419;1;25;2.0
5;71;419;420;1;25;2.0
5;72;420;421;1;25;2.0
5;73;421;422;1;25;2.0
5;74;422;424;2;25;2.0
5;75;424;426;2;25;2.0
5;76;426;427;1;25;2.0
5;77;427;428;1;25;2.0
5;78;428;429;1;25;2.0
5;79;429;431;2;25;2.0
5;80;431;432;1;25;2.0
5;81;432;433;1;25;2.0
5;82;433;434;1;25;2.0
5;83;434;435;1;25;2.0
5;84;435;436;1;25;2.0
5;85;436;438;2;25;2.0
5;86;438;439;1;25;2.0
5;87;439;440;1;25;2.0
5;88;440;441;1;25;2.0
5;89;441;443;2;25;2.0
5;90;443;444;1;25;2.0
5;91;444;446;2;25;2.0
5;92;446;447;1;25;2.0
5;93;447;448;1;25;2.0
5;94;448;449;1;25;2.0
5;95;449;450;1;25;2.0
5;96;450;451;1;25;2.0
5;97;451;453;2;25;2.0
5;98;453;454;1;25;2.0
5;99;454;456;2;25;2.0
5;100;456;457;1;25;2.0
5;101;457;458;1;25;2.0
5;102;458;459;1;25;2.0
5;103;459;460;1;25;2.0
5;104;460;461;1;25;2.0
5;105;461;462;1;25;2.0
5;106;462;463;1;25;2.0
5;107;463;464;1;25;2.0
5;108;464;465;1;25;2.0
5;109;465;466;1;25;2.0
5;110;466;467;1;25;2.0
5;111;467;468;1;25;2.0
5;112;468;469;1;25;2.0
5;113;469;470;1;25;2.0
5;114;470;471;1;25;2.0
5;115;471;474;3;25;2.0
5;116;474;476;2;25;2.0
5;117;476;477;1;25;2.0
5;118;477;478;1;25;2.0
5;119;478;479;1;25;2.0
5;120;479;480;1;25;2.0
5;121;480;481;1;25;2.0
5;122;481;482;1;25;2.0
5;123;482;483;1;25;2.0
5;124;483;484;1;25;2.0
5;125;484;486;2;25;2.0
5;126;486;487;1;25;2.0
5;127;487;488;1;25;2.0
5;128;488;489;1;25;2.0
5;129;489;491;2;25;2.0
5;130;491;494;3;25;2.0
5;131;494;495;1;25;2.0
5;132;495;496;1;25;2.0
5;133;496;498;2;25;2.0
5;134;498;500;2;25;2.0
5;135;500;501;1;25;2.0
5;136;501;502;1;25;2.0
5;137;502;504;2;25;2.0
5;138;504;506;2;25;2.0
5;139;506;509;3;25;2.0
5;140;509;510;1;25;2.0
5;141;510;511;1;25;2.0
5;142;511;513;2;25;2.0
5;143;513;514;1;25;2.0
5;144;514;516;2;25;2.0
5;145;516;517;1;25;2.0
5;146;517;518;1;25;2.0
5;147;518;520;2;25;2.0
5;148;520;523;3;25;2.0
5;149;523;524;1;25;2.0
5;150;524;526;2;25;2.0
5;151;526;529;3;25;2.0
5;152;529;530;1;25;2.0
5;153;530;531;1;25;2.0
5;154;531;534;3;25;2.0
5;155;534;536;2;25;2.0
5;156;536;539;3;25;2.0
5;157;539;540;1;25;2.0
5;158;540;541;1;25;2.0
5;159;541;543;2;25;2.0
5;160;543;544;1;25;2.0
5;161;544;546;2;25;2.0
5;162;546;547;1;25;2.0
5;163;547;548;1;25;2.0
5;164;548;549;1;25;2.0
5;165;549;551;2;25;2.0
5;166;551;553;2;25;2.0
5;167;553;556;3;25;2.0
5;168;556;558;2;25;2.0
5;169;558;559;1;25;2.0
5;170;559;560;1;25;2.0
5;171;560;561;1;25;2.0
5;172;561;564;3;25;2.0
5;173;564;566;2;25;2.0
5;174;566;569;3;25;2.0
5;175;569;570;1;25;2.0
5;176;570;571;1;25;2.0
5;177;571;573;2;25;2.0
5;178;573;576;3;25;2.0
5;179;576;579;3;25;2.0
5;180;579;580;1;25;2.0
5;181;580;581;1;25;2.0
5;182;581;582;1;25;2.0
5;183;582;584;2;25;2.0
5;184;584;586;2;25;2.0
5;185;586;587;1;25;2.0
5;186;587;589;2;25;2.0
5;187;589;590;1;25;2.0
5;188;590;591;1;25;2.0
5;189;591;594;3;25;2.0
5;190;594;596;2;25;2.0
5;191;596;598;2;25;2.0
5;192;598;600;2;25;2.0
5;193;600;601;1;25;2.0
5;194;601;604;3;25;2.0
5;195;604;606;2;25;2.0
5;196;606;609;3;25;2.0
5;197;609;610;1;25;2.0
5;198;610;614;4;25;2.0
5;199;614;616;2;25;2.0
5;200;616;618;2;25;2.0
5;201;618;620;2;25;2.0
5;202;620;621;1;25;2.0
5;203;621;622;1;25;2.0
5;204;622;624;2;25;2.0
5;205;624;626;2;25;2.0
5;206;626;627;1;25;2.0
5;207;627;628;1;25;2.0
5;208;628;629;1;25;2.0
5;209;629;630;1;25;2.0
5;210;630;631;1;25;2.0
5;211;631;636;5;25;2.0
5;212;636;640;4;25;2.0
5;213;640;641;1;25;2.0
5;214;641;644;3;25;2.0
5;215;644;646;2;25;2.0
5;216;646;648;2;25;2.0
5;217;648;649;1;25;2.0
5;218;649;652;3;25;2.0
5;219;652;654;2;25;2.0
5;220;654;655;1;25;2.0
5;221;655;656;1;25;2.0
5;222;656;657;1;25;2.0
5;223;657;658;1;25;2.0
5;224;658;659;1;25;2.0
5;225;659;660;1;25;2.0
5;226;660;661;1;25;2.0
5;227;661;664;3;25;2.0
5;228;664;666;2;25;2.0
5;229;666;669;3;25;2.0
5;230;669;670;1;25;2.0
5;231;670;671;1;25;2.0
5;232;671;676;5;25;2.0
5;233;676;680;4;25;2.0
5;234;680;681;1;25;2.0
5;235;681;684;3;25;2.0
5;236;684;686;2;25;2.0
5;237;686;689;3;25;2.0
5;238;689;690;1;25;2.0
5;239;690;691;1;25;2.0
5;240;691;692;1;25;2.0
5;241;692;696;4;25;2.0
5;242;696;699;3;25;2.0
5;243;699;700;1;25;2.0
5;244;700;701;1;25;2.0
5;245;701;703;2;25;2.0
5;246;703;704;1;25;2.0
5;247;704;706;2;25;2.0
5;248;706;709;3;25;2.0
5;249;709;711;2;25;2.0
5;250;711;714;3;25;2.0
5;251;714;715;1;25;2.0
5;252;715;716;1;25;2.0
5;253;716;718;2;25;2.0
5;254;718;720;2;25;2.0
5;255;720;721;1;25;2.0
5;256;721;722;1;25;2.0
5;257;722;724;2;25;2.0
5;258;724;726;2;25;2.0
5;259;726;727;1;25;2.0
5;260;727;729;2;25;2.0
5;261;729;730;1;25;2.0
5;262;730;734;4;25;2.0
5;263;734;736;2;25;2.0
5;264;736;739;3;25;2.0
5;265;739;740;1;25;2.0
5;266;740;741;1;25;2.0
5;267;741;744;3;25;2.0
5;268;744;745;1;25;2.0
5;269;745;746;1;25;2.0
5;270;746;747;1;25;2.0
5;271;747;748;1;25;2.0
5;272;748;749;1;25;2.0
5;273;749;750;1;25;2.0
5;274;750;751;1;25;2.0
5;275;751;756;5;25;2.0
5;276;756;759;3;25;2.0
5;277;759;760;1;25;2.0
5;278;760;761;1;25;2.0
5;279;761;764;3;25;2.0
5;280;764;765;1;25;2.0
5;281;765;766;1;25;2.0
5;282;766;767;1;25;2.0
5;283;767;769;2;25;2.0
5;284;769;772;3;25;2.0
5;285;772;773;1;25;2.0
5;286;773;774;1;25;2.0
5;287;774;775;1;25;2.0
5;288;775;776;1;25;2.0
5;289;776;778;2;25;2.0
5;290;778;780;2;25;2.0
5;291;780;781;1;25;2.0
5;292;781;784;3;25;2.0
5;293;784;786;2;25;2.0
5;294;786;787;1;25;2.0
5;295;787;789;2;25;2.0
5;296;789;790;1;25;2.0
5;297;790;794;4;25;2.0
5;298;794;796;2;25;2.0
5;299;796;797;1;25;2.0
5;300;797;798;1;25;2.0
5;301;798;799;1;25;2.0
5;302;799;800;1;25;2.0
5;303;800;801;1;25;2.0
5;304;801;802;1;25;2.0
5;305;802;803;1;25;2.0
5;306;803;804;1;25;2.0
5;307;804;805;1;25;2.0
5;308;805;806;1;25;2.0
5;309;806;809;3;25;2.0
5;310;809;811;2;25;2.0
5;311;811;814;3;25;2.0
5;312;814;816;2;25;2.0
5;313;816;817;1;25;2.0
5;314;817;818;1;25;2.0
5;315;818;819;1;25;2.0
5;316;819;820;1;25;2.0
5;317;820;821;1;25;2.0
5;318;821;824;3;25;2.0
5;319;824;826;2;25;2.0
5;320;826;828;2;25;2.0
5;321;828;829;1;25;2.0
5;322;829;830;1;25;2.0
5;323;830;831;1;25;2.0
5;324;831;833;2;25;2.0
5;325;833;834;1;25;2.0
5;326;834;835;1;25;2.0
5;327;835;836;1;25;2.0
5;328;836;837;1;25;2.0
5;329;837;838;1;25;2.0
5;330;838;839;1;25;2.0
5;331;839;840;1;25;2.0
5;332;840;841;1;25;2.0
5;333;841;844;3;25;2.0
5;334;844;846;2;25;2.0
5;335;846;847;1;25;2.0
5;336;847;848;1;25;2.0
5;337;848;849;1;25;2.0
5;338;849;850;1;25;2.0
5;339;850;851;1;25;2.0
5;340;851;852;1;25;2.0
5;341;852;853;1;25;2.0
5;342;853;854;1;25;2.0
5;343;854;856;2;25;2.0
5;344;856;857;1;25;2.0
5;345;857;858;1;25;2.0
5;346;858;860;2;25;2.0
5;347;860;861;1;25;2.0
5;348;861;862;1;25;2.0
5;349;862;864;2;25;2.0
5;350;864;865;1;25;2.0
5;351;865;866;1;25;2.0
5;352;866;868;2;25;2.0
5;353;868;869;1;25;2.0
5;354;869;870;1;25;2.0
5;355;870;871;1;25;2.0
5;356;871;873;2;25;2.0
5;357;873;874;1;25;2.0
5;358;874;876;2;25;2.0
5;359;876;878;2;25;2.0
5;360;878;879;1;25;2.0
5;361;879;880;1;25;2.0
5;362;880;881;1;25;2.0
5;363;881;882;1;25;2.0
5;364;882;884;2;25;2.0
5;365;884;885;1;25;2.0
5;366;885;886;1;25;2.0
5;367;886;887;1;25;2.0
5;368;887;888;1;25;2.0
5;369;888;889;1;25;2.0
5;370;889;890;1;25;2.0
5;371;890;891;1;25;2.0
5;372;891;892;1;25;2.0
5;373;892;894;2;25;2.0
5;374;894;896;2;25;2.0
5;375;896;898;2;25;2.0
5;376;898;899;1;25;2.0
5;377;899;900;1;25;2.0
5;378;900;901;1;25;2.0
5;379;901;902;1;25;2.0
5;380;902;903;1;25;2.0
5;381;903;904;1;25;2.0
5;382;904;905;1;25;2.0
5;383;905;906;1;25;2.0
5;384;906;908;2;25;2.0
5;385;908;909;1;25;2.0
5;386;909;910;1;25;2.0
5;387;910;911;1;25;2.0
5;388;911;914;3;25;2.0
5;389;914;916;2;25;2.0
5;390;916;917;1;25;2.0
5;391;917;918;1;25;2.0
5;392;918;919;1;25;2.0
5;393;919;920;1;25;2.0
5;394;920;921;1;25;2.0
5;395;921;922;1;25;2.0
5;396;922;924;2;25;2.0
5;397;924;925;1;25;2.0
5;398;925;926;1;25;2.0
5;399;926;928;2;25;2.0
5;400;928;929;1;25;2.0
5;401;929;930;1;25;2.0
5;402;930;931;1;25;2.0
5;403;931;934;3;25;2.0
5;404;934;935;1;25;2.0
5;405;935;936;1;25;2.0
5;406;936;937;1;25;2.0
5;407;937;939;2;25;2.0
5;408;939;940;1;25;2.0
5;409;940;941;1;25;2.0
5;410;941;944;3;25;2.0
5;411;944;945;1;25;2.0
5;412;945;946;1;25;2.0
5;413;946;948;2;25;2.0
5;414;948;949;1;25;2.0
5;415;949;951;2;25;2.0
5;416;951;952;1;25;2.0
5;417;952;954;2;25;2.0
5;418;954;955;1;25;2.0
5;419;955;956;1;25;2.0
5;420;956;957;1;25;2.0
5;421;957;958;1;25;2.0
5;422;958;959;1;25;2.0
5;423;959;960;1;25;2.0
5;424;960;961;1;25;2.0
5;425;961;963;2;25;2.0
5;426;963;964;1;25;2.0
5;427;964;965;1;25;2.0
5;428;965;966;1;25;2.0
5;429;966;967;1;25;2.0
5;430;967;968;1;25;2.0
5;431;968;969;1;25;2.0
5;432;969;970;1;25;2.0
5;433;970;971;1;25;2.0
5;434;971;972;1;25;2.0
5;435;972;974;2;25;2.0
5;436;974;975;1;25;2.0
5;437;975;976;1;25;2.0
5;438;976;977;1;25;2.0
5;439;977;978;1;25;2.0
5;440;978;979;1;25;2.0
5;441;979;980;1;25;2.0
5;442;980;981;1;25;2.0
5;443;981;984;3;25;2.0
5;444;984;985;1;25;2.0
5;445;985;986;1;25;2.0
5;446;986;988;2;25;2.0
5;447;988;989;1;25;2.0
5;448;989;990;1;25;2.0
5;449;990;991;1;25;2.0
5;450;991;994;3;25;2.0
5;451;994;996;2;25;2.0
5;452;996;997;1;25;2.0
5;453;997;999;2;25;2.0
5;454;999;1000;1;25;2.0
5;455;1000;1001;1;25;2.0
5;456;1001;1002;1;25;2.0
5;457;1002;1004;2;25;2.0
5;458;1004;1006;2;25;2.0
5;459;1006;1008;2;25;2.0
5;460;1008;1009;1;25;2.0
5;461;1009;1011;2;25;2.0
5;462;1011;1013;2;25;2.0
5;463;1013;1014;1;25;2.0
5;464;1014;1016;2;25;2.0
5;465;1016;1017;1;25;2.0
5;466;1017;1018;1;25;2.0
5;467;1018;1019;1;25;2.0
5;468;1019;1020;1;25;2.0
5;469;1020;1024;4;25;2.0
5;470;1024;1026;2;25;2.0
5;471;1026;1028;2;25;2.0
5;472;1028;1029;1;25;2.0
5;473;1029;1030;1;25;2.0
5;474;1030;1031;1;25;2.0
5;475;1031;1032;1;25;2.0
5;476;1032;1034;2;25;2.0
5;477;1034;1036;2;25;2.0
5;478;1036;1038;2;25;2.0
5;479;1038;1040;2;25;2.0
5;480;1040;1041;1;25;2.0
5;481;1041;1044;3;25;2.0
5;482;1044;1045;1;25;2.0
5;483;1045;1046;1;25;2.0
5;484;1046;1048;2;25;2.0
5;485;1048;1049;1;25;2.0
5;486;1049;1050;1;25;2.0
5;487;1050;1053;3;25;2.0
5;488;1053;1056;3;25;2.0
5;489;1056;1057;1;25;2.0
5;490;1057;1059;2;25;2.0
5;491;1059;1060;1;25;2.0
5;492;1060;1061;1;25;2.0
5;493;1061;1064;3;25;2.0
5;494;1064;1066;2;25;2.0
5;495;1066;1068;2;25;2.0
5;496;1068;1069;1;25;2.0
5;497;1069;1071;2;25;2.0
5;498;1071;1073;2;25;2.0
5;499;1073;1074;1;25;2.0
5;500;1074;1075;1;25;2.0
5;501;1075;1076;1;25;2.0
5;502;1076;1077;1;25;2.0
5;503;1077;1078;1;25;2.0
5;504;1078;1079;1;25;2.0
5;505;1079;1080;1;25;2.0
5;506;1080;1082;2;25;2.0
5;507;1082;1083;1;25;2.0
5;508;1083;1084;1;25;2.0
5;509;1084;1086;2;25;2.0
5;510;1086;1088;2;25;2.0
5;511;1088;1089;1;25;2.0
5;512;1089;1090;1;25;2.0
5;513;1090;1091;1;25;2.0
5;514;1091;1092;1;25;2.0
5;515;1092;1094;2;25;2.0
5;516;1094;1095;1;25;2.0
5;517;1095;1096;1;25;2.0
5;518;1096;1098;2;25;2.0
5;519;1098;1099;1;25;2.0
5;520;1099;1101;2;25;2.0
5;521;1101;1102;1;25;2.0
5;522;1102;1106;4;25;2.0
5;523;1106;1107;1;25;2.0
5;524;1107;1108;1;25;2.0
5;525;1108;1109;1;25;2.0
5;526;1109;1111;2;25;2.0
5;527;1111;1116;5;25;2.0
5;528;1116;1118;2;25;2.0
5;529;1118;1121;3;25;2.0
5;530;1121;1127;6;25;2.0
5;531;1127;1128;1;25;2.0
5;532;1128;1130;2;25;2.0
5;533;1130;1133;3;25;2.0
5;534;1133;1136;3;25;2.0
5;535;1136;1138;2;25;2.0
5;536;1138;1139;1;25;2.0
5;537;1139;1141;2;25;2.0
5;538;1141;1142;1;25;2.0
5;539;1142;1143;1;25;2.0
5;540;1143;1145;2;25;2.0
5;541;1145;1146;1;25;2.0
5;542;1146;1148;2;25;2.0
5;543;1148;1149;1;25;2.0
5;544;1149;1152;3;25;2.0
5;545;1152;1153;1;25;2.0
5;546;1153;1154;1;25;2.0
5;547;1154;1156;2;25;2.0
5;548;1156;1158;2;25;2.0
5;549;1158;1159;1;25;2.0
5;550;1159;1161;2;25;2.0
5;551;1161;1163;2;25;2.0
5;552;1163;1168;5;25;2.0
5;553;1168;1169;1;25;2.0
5;554;1169;1171;2;25;2.0
5;555;1171;1173;2;25;2.0
5;556;1173;1175;2;25;2.0
5;557;1175;1176;1;25;2.0
5;558;1176;1178;2;25;2.0
5;559;1178;1179;1;25;2.0
5;560;1179;1181;2;25;2.0
5;561;1181;1183;2;25;2.0
5;562;1183;1186;3;25;2.0
5;563;1186;1188;2;25;2.0
5;564;1188;1190;2;25;2.0
5;565;1190;1198;8;25;2.0
5;566;1198;1201;3;25;2.0
5;567;1201;1203;2;25;2.0
5;568;1203;1204;1;25;2.0
5;569;1204;1207;3;25;2.0
5;570;1207;1208;1;25;2.0
5;571;1208;1212;4;25;2.0
5;572;1212;1216;4;25;2.0
5;573;1216;1218;2;25;2.0
5;574;1218;1221;3;25;2.0
5;575;1221;1222;1;25;2.0
5;576;1222;1226;4;25;2.0
5;577;1226;1228;2;25;2.0
5;578;1228;1229;1;25;2.0
5;579;1229;1233;4;25;2.0
5;580;1233;1238;5;25;2.0
5;581;1238;1246;8;25;2.0
5;582;1246;1251;5;25;2.0
5;583;1251;1253;2;25;2.0
5;584;1253;1254;1;25;2.0
5;585;1254;1255;1;25;2.0
5;586;1255;1261;6;25;2.0
5;587;1261;1262;1;25;2.0
5;588;1262;1263;1;25;2.0
5;589;1263;1265;2;25;2.0
5;590;1265;1268;3;25;2.0
5;591;1268;1270;2;25;2.0
5;592;1270;1271;1;25;2.0
5;593;1271;1273;2;25;2.0
5;594;1273;1276;3;25;2.0
5;595;1276;1278;2;25;2.0
5;596;1278;1279;1;25;2.0
5;597;1279;1280;1;25;2.0
5;598;1280;1281;1;25;2.0
5;599;1281;1287;6;25;2.0
5;600;1287;1288;1;25;2.0
5;601;1288;1289;1;25;2.0
5;602;1289;1293;4;25;2.0
5;603;1293;1298;5;25;2.0
5;604;1298;1301;3;25;2.0
5;605;1301;1303;2;25;2.0
5;606;1303;1304;1;25;2.0
5;607;1304;1307;3;25;2.0
5;608;1307;1308;1;25;2.0
5;609;1308;1312;4;25;2.0
5;610;1312;1313;1;25;2.0
5;611;1313;1318;5;25;2.0
5;612;1318;1320;2;25;2.0
5;613;1320;1321;1;25;2.0
5;614;1321;1322;1;25;2.0
5;615;1322;1323;1;25;2.0
5;616;1323;1326;3;25;2.0
5;617;1326;1329;3;25;2.0
5;618;1329;1331;2;25;2.0
5;619;1331;1335;4;25;2.0
5;620;1335;1336;1;25;2.0
5;621;1336;1337;1;25;2.0
5;622;1337;1338;1;25;2.0
5;623;1338;1339;1;25;2.0
5;624;1339;1341;2;25;2.0
5;625;1341;1342;1;25;2.0
5;626;1342;1343;1;25;2.0
5;627;1343;1348;5;25;2.0
5;628;1348;1351;3;25;2.0
5;629;1351;1355;4;25;2.0
5;630;1355;1356;1;25;2.0
5;631;1356;1357;1;25;2.0
5;632;1357;1359;2;25;2.0
5;633;1359;1360;1;25;2.0
5;634;1360;1363;3;25;2.0
5;635;1363;1364;1;25;2.0
5;636;1364;1365;1;25;2.0
5;637;1365;1366;1;25;2.0
5;638;1366;1368;2;25;2.0
5;639;1368;1373;5;25;2.0
5;640;1373;1377;4;25;2.0
5;641;1377;1378;1;25;2.0
5;642;1378;1381;3;25;2.0
5;643;1381;1383;2;25;2.0
5;644;1383;1385;2;25;2.0
5;645;1385;1388;3;25;2.0
5;646;1388;1393;5;25;2.0
5;647;1393;1408;15;25;2.0
5;648;1408;1423;15;25;2.0
5;649;1423;1438;15;25;2.0
5;650;1438;1453;15;25;2.0
5;651;1453;1468;15;25;2.0
5;652;1468;1483;15;25;2.0
5;653;1483;1498;15;25;2.0
5;654;1498;1513;15;25;2.0
5;655;1513;1528;15;25;2.0
5;656;1528;1543;15;25;2.0
5;657;1543;1558;15;25;2.0
5;658;1558;1573;15;25;2.0
5;659;1573;1588;15;25;2.0
5;660;1588;1603;15;25;2.0
5;661;1603;1618;15;25;2.0
5;662;1618;1633;15;25;2.0
5;663;1633;1648;15;25;2.0
5;664;1648;1663;15;25;2.0
5;665;1663;1680;17;25;2.0
6;0;243;283;40;50;2.0
6;1;283;325;42;50;2.0
6;2;325;326;1;50;2.0
6;3;326;327;1;50;2.0
6;4;327;328;1;50;2.0
6;5;328;329;1;50;2.0
6;6;329;331;2;50;2.0
6;7;331;332;1;50;2.0
6;8;332;333;1;50;2.0
6;9;333;334;1;50;2.0
6;10;334;335;1;50;2.0
6;11;335;336;1;50;2.0
6;12;336;337;1;50;2.0
6;13;337;339;2;50;2.0
6;14;339;340;1;50;2.0
6;15;340;342;2;50;2.0
6;16;342;343;1;50;2.0
6;17;343;344;1;50;2.0
6;18;344;345;1;50;2.0
6;19;345;347;2;50;2.0
6;20;347;348;1;50;2.0
6;21;348;349;1;50;2.0
6;22;349;350;1;50;2.0
6;23;350;351;1;50;2.0
6;24;351;352;1;50;2.0
6;25;352;353;1;50;2.0
6;26;353;355;2;50;2.0
6;27;355;357;2;50;2.0
6;28;357;358;1;50;2.0
6;29;358;359;1;50;2.0
6;30;359;360;1;50;2.0
6;31;360;362;2;50;2.0
6;32;362;364;2;50;2.0
6;33;364;365;1;50;2.0
6;34;365;366;1;50;2.0
6;35;366;367;1;50;2.0
6;36;367;368;1;50;2.0
6;37;368;369;1;50;2.0
6;38;369;370;1;50;2.0
6;39;370;375;5;50;2.0
6;40;375;376;1;50;2.0
6;41;376;377;1;50;2.0
6;42;377;379;2;50;2.0
6;43;379;380;1;50;2.0
6;44;380;381;1;50;2.0
6;45;381;383;2;50;2.0
6;46;383;385;2;50;2.0
6;47;385;386;1;50;2.0
6;48;386;387;1;50;2.0
6;49;387;388;1;50;2.0
6;50;388;389;1;50;2.0
6;51;389;390;1;50;2.0
6;52;390;391;1;50;2.0
6;53;391;392;1;50;2.0
6;54;392;393;1;50;2.0
6;55;393;394;1;50;2.0
6;56;394;395;1;50;2.0
6;57;395;396;1;50;2.0
6;58;396;397;1;50;2.0
6;59;397;400;3;50;2.0
6;60;400;401;1;50;2.0
6;61;401;403;2;50;2.0
6;62;403;404;1;50;2.0
6;63;404;405;1;50;2.0
6;64;405;406;1;50;2.0
6;65;406;407;1;50;2.0
6;66;407;408;1;50;2.0
6;67;408;409;1;50;2.0
6;68;409;410;1;50;2.0
6;69;410;411;1;50;2.0
6;70;411;413;2;50;2.0
6;71;413;414;1;50;2.0
6;72;414;415;1;50;2.0
6;73;415;416;1;50;2.0
6;74;416;417;1;50;2.0
6;75;417;418;1;50;2.0
6;76;418;419;1;50;2.0
6;77;419;420;1;50;2.0
6;78;420;421;1;50;2.0
6;79;421;425;4;50;2.0
6;80;425;426;1;50;2.0
6;81;426;427;1;50;2.0
6;82;427;429;2;50;2.0
6;83;429;430;1;50;2.0
6;84;430;431;1;50;2.0
6;85;431;433;2;50;2.0
6;86;433;434;1;50;2.0
6;87;434;435;1;50;2.0
6;88;435;436;1;50;2.0
6;89;436;437;1;50;2.0
6;90;437;440;3;50;2.0
6;91;440;441;1;50;2.0
6;92;441;443;2;50;2.0
6;93;443;444;1;50;2.0
6;94;444;445;1;50;2.0
6;95;445;446;1;50;2.0
6;96;446;447;1;50;2.0
6;97;447;448;1;50;2.0
6;98;448;449;1;50;2.0
6;99;449;450;1;50;2.0
6;100;450;451;1;50;2.0
6;101;451;452;1;50;2.0
6;102;452;453;1;50;2.0
6;103;453;454;1;50;2.0
6;104;454;455;1;50;2.0
6;105;455;456;1;50;2.0
6;106;456;457;1;50;2.0
6;107;457;459;2;50;2.0
6;108;459;460;1;50;2.0
6;109;460;461;1;50;2.0
6;110;461;463;2;50;2.0
6;111;463;465;2;50;2.0
6;112;465;466;1;50;2.0
6;113;466;467;1;50;2.0
6;114;467;468;1;50;2.0
6;115;468;469;1;50;2.0
6;116;469;470;1;50;2.0
6;117;470;471;1;50;2.0
6;118;471;473;2;50;2.0
6;119;473;474;1;50;2.0
6;120;474;475;1;50;2.0
6;121;475;476;1;50;2.0
6;122;476;477;1;50;2.0
6;123;477;478;1;50;2.0
6;124;478;479;1;50;2.0
6;125;479;480;1;50;2.0
6;126;480;481;1;50;2.0
6;127;481;482;1;50;2.0
6;128;482;484;2;50;2.0
6;129;484;486;2;50;2.0
6;130;486;487;1;50;2.0
6;131;487;488;1;50;2.0
6;132;488;489;1;50;2.0
6;133;489;490;1;50;2.0
6;134;490;491;1;50;2.0
6;135;491;493;2;50;2.0
6;136;493;494;1;50;2.0
6;137;494;495;1;50;2.0
6;138;495;497;2;50;2.0
6;139;497;501;4;50;2.0
6;140;501;502;1;50;2.0
6;141;502;504;2;50;2.0
6;142;504;505;1;50;2.0
6;143;505;506;1;50;2.0
6;144;506;509;3;50;2.0
6;145;509;510;1;50;2.0
6;146;510;511;1;50;2.0
6;147;511;513;2;50;2.0
6;148;513;515;2;50;2.0
6;149;515;517;2;50;2.0
6;150;517;520;3;50;2.0
6;151;520;521;1;50;2.0
6;152;521;522;1;50;2.0
6;153;522;524;2;50;2.0
6;154;524;525;1;50;2.0
6;155;525;526;1;50;2.0
6;156;526;529;3;50;2.0
6;157;529;532;3;50;2.0
6;158;532;533;1;50;2.0
6;159;533;535;2;50;2.0
6;160;535;537;2;50;2.0
6;161;537;540;3;50;2.0
6;162;540;541;1;50;2.0
6;163;541;543;2;50;2.0
6;164;543;545;2;50;2.0
6;165;545;546;1;50;2.0
6;166;546;547;1;50;2.0
6;167;547;549;2;50;2.0
6;168;549;550;1;50;2.0
6;169;550;553;3;50;2.0
6;170;553;555;2;50;2.0
6;171;555;557;2;50;2.0
6;172;557;559;2;50;2.0
6;173;559;560;1;50;2.0
6;174;560;561;1;50;2.0
6;175;561;566;5;50;2.0
6;176;566;569;3;50;2.0
6;177;569;570;1;50;2.0
6;178;570;571;1;50;2.0
6;179;571;572;1;50;2.0
6;180;572;575;3;50;2.0
6;181;575;577;2;50;2.0
6;182;577;579;2;50;2.0
6;183;579;580;1;50;2.0
6;184;580;581;1;50;2.0
6;185;581;585;4;50;2.0
6;186;585;586;1;50;2.0
6;187;586;587;1;50;2.0
6;188;587;588;1;50;2.0
6;189;588;589;1;50;2.0
6;190;589;592;3;50;2.0
6;191;592;593;1;50;2.0
6;192;593;595;2;50;2.0
6;193;595;597;2;50;2.0
6;194;597;600;3;50;2.0
6;195;600;601;1;50;2.0
6;196;601;606;5;50;2.0
6;197;606;609;3;50;2.0
6;198;609;615;6;50;2.0
6;199;615;616;1;50;2.0
6;200;616;617;1;50;2.0
6;201;617;619;2;50;2.0
6;202;619;620;1;50;2.0
6;203;620;621;1;50;2.0
6;204;621;622;1;50;2.0
6;205;622;625;3;50;2.0
6;206;625;626;1;50;2.0
6;207;626;627;1;50;2.0
6;208;627;628;1;50;2.0
6;209;628;629;1;50;2.0
6;210;629;630;1;50;2.0
6;211;630;633;3;50;2.0
6;212;633;635;2;50;2.0
6;213;635;637;2;50;2.0
6;214;637;640;3;50;2.0
6;215;640;641;1;50;2.0
6;216;641;646;5;50;2.0
6;217;646;649;3;50;2.0
6;218;649;650;1;50;2.0
6;219;650;652;2;50;2.0
6;220;652;653;1;50;2.0
6;221;653;654;1;50;2.0
6;222;654;655;1;50;2.0
6;223;655;657;2;50;2.0
6;224;657;660;3;50;2.0
6;225;660;661;1;50;2.0
6;226;661;666;5;50;2.0
6;227;666;668;2;50;2.0
6;228;668;669;1;50;2.0
6;229;669;673;4;50;2.0
6;230;673;675;2;50;2.0
6;231;675;677;2;50;2.0
6;232;677;680;3;50;2.0
6;233;680;681;1;50;2.0
6;234;681;682;1;50;2.0
6;235;682;686;4;50;2.0
6;236;686;689;3;50;2.0
6;237;689;690;1;50;2.0
6;238;690;692;2;50;2.0
6;239;692;695;3;50;2.0
6;240;695;697;2;50;2.0
6;241;697;700;3;50;2.0
6;242;700;701;1;50;2.0
6;243;701;703;2;50;2.0
6;244;703;706;3;50;2.0
6;245;706;709;3;50;2.0
6;246;709;712;3;50;2.0
6;247;712;713;1;50;2.0
6;248;713;715;2;50;2.0
6;249;715;717;2;50;2.0
6;250;717;718;1;50;2.0
6;251;718;720;2;50;2.0
6;252;720;721;1;50;2.0
6;253;721;722;1;50;2.0
6;254;722;725;3;50;2.0
6;255;725;726;1;50;2.0
6;256;726;729;3;50;2.0
6;257;729;735;6;50;2.0
6;258;735;736;1;50;2.0
6;259;736;737;1;50;2.0
6;260;737;739;2;50;2.0
6;261;739;740;1;50;2.0
6;262;740;741;1;50;2.0
6;263;741;744;3;50;2.0
6;264;744;746;2;50;2.0
6;265;746;749;3;50;2.0
6;266;749;750;1;50;2.0
6;267;750;755;5;50;2.0
6;268;755;757;2;50;2.0
6;269;757;760;3;50;2.0
6;270;760;761;1;50;2.0
6;271;761;763;2;50;2.0
6;272;763;765;2;50;2.0
6;273;765;766;1;50;2.0
6;274;766;769;3;50;2.0
6;275;769;771;2;50;2.0
6;276;771;772;1;50;2.0
6;277;772;773;1;50;2.0
6;278;773;775;2;50;2.0
6;279;775;777;2;50;2.0
6;280;777;778;1;50;2.0
6;281;778;780;2;50;2.0
6;282;780;781;1;50;2.0
6;283;781;784;3;50;2.0
6;284;784;785;1;50;2.0
6;285;785;786;1;50;2.0
6;286;786;789;3;50;2.0
6;287;789;792;3;50;2.0
6;288;792;795;3;50;2.0
6;289;795;796;1;50;2.0
6;290;796;797;1;50;2.0
6;291;797;799;2;50;2.0
6;292;799;800;1;50;2.0
6;293;800;801;1;50;2.0
6;294;801;803;2;50;2.0
6;295;803;804;1;50;2.0
6;296;804;805;1;50;2.0
6;297;805;806;1;50;2.0
6;298;806;809;3;50;2.0
6;299;809;810;1;50;2.0
6;300;810;813;3;50;2.0
6;301;813;814;1;50;2.0
6;302;814;815;1;50;2.0
6;303;815;816;1;50;2.0
6;304;816;817;1;50;2.0
6;305;817;819;2;50;2.0
6;306;819;820;1;50;2.0
6;307;820;821;1;50;2.0
6;308;821;826;5;50;2.0
6;309;826;827;1;50;2.0
6;310;827;829;2;50;2.0
6;311;829;830;1;50;2.0
6;312;830;832;2;50;2.0
6;313;832;833;1;50;2.0
6;314;833;834;1;50;2.0
6;315;834;835;1;50;2.0
6;316;835;836;1;50;2.0
6;317;836;837;1;50;2.0
6;318;837;838;1;50;2.0
6;319;838;839;1;50;2.0
6;320;839;840;1;50;2.0
6;321;840;841;1;50;2.0
6;322;841;845;4;50;2.0
6;323;845;846;1;50;2.0
6;324;846;847;1;50;2.0
6;325;847;848;1;50;2.0
6;326;848;849;1;50;2.0
6;327;849;850;1;50;2.0
6;328;850;851;1;50;2.0
6;329;851;852;1;50;2.0
6;330;852;853;1;50;2.0
6;331;853;855;2;50;2.0
6;332;855;856;1;50;2.0
6;333;856;857;1;50;2.0
6;334;857;858;1;50;2.0
6;335;858;859;1;50;2.0
6;336;859;860;1;50;2.0
6;337;860;861;1;50;2.0
6;338;861;862;1;50;2.0
6;339;862;864;2;50;2.0
6;340;864;865;1;50;2.0
6;341;865;866;1;50;2.0
6;342;866;867;1;50;2.0
6;343;867;868;1;50;2.0
6;344;868;869;1;50;2.0
6;345;869;870;1;50;2.0
6;346;870;871;1;50;2.0
6;347;871;872;1;50;2.0
6;348;872;873;1;50;2.0
6;349;873;875;2;50;2.0
6;350;875;876;1;50;2.0
6;351;876;877;1;50;2.0
6;352;877;880;3;50;2.0
6;353;880;881;1;50;2.0
6;354;881;882;1;50;2.0
6;355;882;885;3;50;2.0
6;356;885;886;1;50;2.0
6;357;886;887;1;50;2.0
6;358;887;888;1;50;2.0
6;359;888;889;1;50;2.0
6;360;889;890;1;50;2.0
6;361;890;891;1;50;2.0
6;362;891;892;1;50;2.0
6;363;892;893;1;50;2.0
6;364;893;894;1;50;2.0
6;365;894;895;1;50;2.0
6;366;895;896;1;50;2.0
6;367;896;897;1;50;2.0
6;368;897;900;3;50;2.0
6;369;900;901;1;50;2.0
6;370;901;902;1;50;2.0
6;371;902;903;1;50;2.0
6;372;903;906;3;50;2.0
6;373;906;907;1;50;2.0
6;374;907;908;1;50;2.0
6;375;908;909;1;50;2.0
6;376;909;910;1;50;2.0
6;377;910;911;1;50;2.0
6;378;911;912;1;50;2.0
6;379;912;914;2;50;2.0
6;380;914;915;1;50;2.0
6;381;915;916;1;50;2.0
6;382;916;917;1;50;2.0
6;383;917;920;3;50;2.0
6;384;920;921;1;50;2.0
6;385;921;924;3;50;2.0
6;386;924;925;1;50;2.0
6;387;925;926;1;50;2.0
6;388;926;927;1;50;2.0
6;389;927;928;1;50;2.0
6;390;928;929;1;50;2.0
6;391;929;930;1;50;2.0
6;392;930;931;1;50;2.0
6;393;931;932;1;50;2.0
6;394;932;933;1;50;2.0
6;395;933;934;1;50;2.0
6;396;934;935;1;50;2.0
6;397;935;936;1;50;2.0
6;398;936;937;1;50;2.0
6;399;937;938;1;50;2.0
6;400;938;940;2;50;2.0
6;401;940;941;1;50;2.0
6;402;941;942;1;50;2.0
6;403;942;945;3;50;2.0
6;404;945;946;1;50;2.0
6;405;946;947;1;50;2.0
6;406;947;949;2;50;2.0
6;407;949;950;1;50;2.0
6;408;950;951;1;50;2.0
6;409;951;953;2;50;2.0
6;410;953;955;2;50;2.0
6;411;955;956;1;50;2.0
6;412;956;957;1;50;2.0
6;413;957;958;1;50;2.0
6;414;958;959;1;50;2.0
6;415;959;960;1;50;2.0
6;416;960;961;1;50;2.0
6;417;961;962;1;50;2.0
6;418;962;965;3;50;2.0
6;419;965;966;1;50;2.0
6;420;966;967;1;50;2.0
6;421;967;968;1;50;2.0
6;422;968;969;1;50;2.0
6;423;969;970;1;50;2.0
6;424;970;971;1;50;2.0
6;425;971;974;3;50;2.0
6;426;974;975;1;50;2.0
6;427;975;976;1;50;2.0
6;428;976;977;1;50;2.0
6;429;977;978;1;50;2.0
6;430;978;980;2;50;2.0
6;431;980;981;1;50;2.0
6;432;981;986;5;50;2.0
6;433;986;987;1;50;2.0
6;434;987;988;1;50;2.0
6;435;988;989;1;50;2.0
6;436;989;990;1;50;2.0
6;437;990;991;1;50;2.0
6;438;991;992;1;50;2.0
6;439;992;993;1;50;2.0
6;440;993;995;2;50;2.0
6;441;995;996;1;50;2.0
6;442;996;997;1;50;2.0
6;443;997;1000;3;50;2.0
6;444;1000;1001;1;50;2.0
6;445;1001;1002;1;50;2.0
6;446;1002;1004;2;50;2.0
6;447;1004;1005;1;50;2.0
6;448;1005;1006;1;50;2.0
6;449;1006;1007;1;50;2.0
6;450;1007;1008;1;50;2.0
6;451;1008;1009;1;50;2.0
6;452;1009;1010;1;50;2.0
6;453;1010;1011;1;50;2.0
6;454;1011;1012;1;50;2.0
6;455;1012;1014;2;50;2.0
6;456;1014;1015;1;50;2.0
6;457;1015;1016;1;50;2.0
6;458;1016;1017;1;50;2.0
6;459;1017;1019;2;50;2.0
6;460;1019;1020;1;50;2.0
6;461;1020;1021;1;50;2.0
6;462;1021;1023;2;50;2.0
6;463;1023;1025;2;50;2.0
6;464;1025;1027;2;50;2.0
6;465;1027;1028;1;50;2.0
6;466;1028;1029;1;50;2.0
6;467;1029;1030;1;50;2.0
6;468;1030;1031;1;50;2.0
6;469;1031;1032;1;50;2.0
6;470;1032;1033;1;50;2.0
6;471;1033;1034;1;50;2.0
6;472;1034;1035;1;50;2.0
6;473;1035;1036;1;50;2.0
6;474;1036;1037;1;50;2.0
6;475;1037;1040;3;50;2.0
6;476;1040;1043;3;50;2.0
6;477;1043;1044;1;50;2.0
6;478;1044;1045;1;50;2.0
6;479;1045;1046;1;50;2.0
6;480;1046;1047;1;50;2.0
6;481;1047;1048;1;50;2.0
6;482;1048;1049;1;50;2.0
6;483;1049;1055;6;50;2.0
6;484;1055;1057;2;50;2.0
6;485;1057;1060;3;50;2.0
6;486;1060;1061;1;50;2.0
6;487;1061;1062;1;50;2.0
6;488;1062;1064;2;50;2.0
6;489;1064;1065;1;50;2.0
6;490;1065;1067;2;50;2.0
6;491;1067;1069;2;50;2.0
6;492;1069;1070;1;50;2.0
6;493;1070;1072;2;50;2.0
6;494;1072;1074;2;50;2.0
6;495;1074;1075;1;50;2.0
6;496;1075;1076;1;50;2.0
6;497;1076;1077;1;50;2.0
6;498;1077;1080;3;50;2.0
6;499;1080;1083;3;50;2.0
6;500;1083;1085;2;50;2.0
6;501;1085;1087;2;50;2.0
6;502;1087;1089;2;50;2.0
6;503;1089;1091;2;50;2.0
6;504;1091;1094;3;50;2.0
6;505;1094;1095;1;50;2.0
6;506;1095;1096;1;50;2.0
6;507;1096;1098;2;50;2.0
6;508;1098;1100;2;50;2.0
6;509;1100;1101;1;50;2.0
6;510;1101;1104;3;50;2.0
6;511;1104;1105;1;50;2.0
6;512;1105;1106;1;50;2.0
6;513;1106;1107;1;50;2.0
6;514;1107;1108;1;50;2.0
6;515;1108;1110;2;50;2.0
6;516;1110;1111;1;50;2.0
6;517;1111;1115;4;50;2.0
6;518;1115;1118;3;50;2.0
6;519;1118;1120;2;50;2.0
6;520;1120;1121;1;50;2.0
6;521;1121;1126;5;50;2.0
6;522;1126;1127;1;50;2.0
6;523;1127;1129;2;50;2.0
6;524;1129;1130;1;50;2.0
6;525;1130;1131;1;50;2.0
6;526;1131;1133;2;50;2.0
6;527;1133;1134;1;50;2.0
6;528;1134;1135;1;50;2.0
6;529;1135;1138;3;50;2.0
6;530;1138;1139;1;50;2.0
6;531;1139;1141;2;50;2.0
6;532;1141;1142;1;50;2.0
6;533;1142;1144;2;50;2.0
6;534;1144;1146;2;50;2.0
6;535;1146;1148;2;50;2.0
6;536;1148;1150;2;50;2.0
6;537;1150;1151;1;50;2.0
6;538;1151;1152;1;50;2.0
6;539;1152;1153;1;50;2.0
6;540;1153;1155;2;50;2.0
6;541;1155;1157;2;50;2.0
6;542;1157;1158;1;50;2.0
6;543;1158;1161;3;50;2.0
6;544;1161;1163;2;50;2.0
6;545;1163;1168;5;50;2.0
6;546;1168;1171;3;50;2.0
6;547;1171;1175;4;50;2.0
6;548;1175;1177;2;50;2.0
6;549;1177;1178;1;50;2.0
6;550;1178;1181;3;50;2.0
6;551;1181;1183;2;50;2.0
6;552;1183;1188;5;50;2.0
6;553;1188;1189;1;50;2.0
6;554;1189;1196;7;50;2.0
6;555;1196;1197;1;50;2.0
6;556;1197;1198;1;50;2.0
6;557;1198;1200;2;50;2.0
6;558;1200;1203;3;50;2.0
6;559;1203;1204;1;50;2.0
6;560;1204;1206;2;50;2.0
6;561;1206;1210;4;50;2.0
6;562;1210;1211;1;50;2.0
6;563;1211;1217;6;50;2.0
6;564;1217;1219;2;50;2.0
6;565;1219;1220;1;50;2.0
6;566;1220;1221;1;50;2.0
6;567;1221;1223;2;50;2.0
6;568;1223;1224;1;50;2.0
6;569;1224;1228;4;50;2.0
6;570;1228;1231;3;50;2.0
6;571;1231;1233;2;50;2.0
6;572;1233;1235;2;50;2.0
6;573;1235;1237;2;50;2.0
6;574;1237;1245;8;50;2.0
6;575;1245;1248;3;50;2.0
6;576;1248;1253;5;50;2.0
6;577;1253;1255;2;50;2.0
6;578;1255;1256;1;50;2.0
6;579;1256;1257;1;50;2.0
6;580;1257;1259;2;50;2.0
6;581;1259;1262;3;50;2.0
6;582;1262;1264;2;50;2.0
6;583;1264;1266;2;50;2.0
6;584;1266;1268;2;50;2.0
6;585;1268;1269;1;50;2.0
6;586;1269;1270;1;50;2.0
6;587;1270;1271;1;50;2.0
6;588;1271;1273;2;50;2.0
6;589;1273;1278;5;50;2.0
6;590;1278;1281;3;50;2.0
6;591;1281;1282;1;50;2.0
6;592;1282;1283;1;50;2.0
6;593;1283;1286;3;50;2.0
6;594;1286;1287;1;50;2.0
6;595;1287;1291;4;50;2.0
6;596;1291;1296;5;50;2.0
6;597;1296;1297;1;50;2.0
6;598;1297;1298;1;50;2.0
6;599;1298;1303;5;50;2.0
6;600;1303;1305;2;50;2.0
6;601;1305;1309;4;50;2.0
6;602;1309;1311;2;50;2.0
6;603;1311;1312;1;50;2.0
6;604;1312;1313;1;50;2.0
6;605;1313;1314;1;50;2.0
6;606;1314;1318;4;50;2.0
6;607;1318;1319;1;50;2.0
6;608;1319;1320;1;50;2.0
6;609;1320;1323;3;50;2.0
6;610;1323;1325;2;50;2.0
6;611;1325;1328;3;50;2.0
6;612;1328;1329;1;50;2.0
6;613;1329;1333;4;50;2.0
6;614;1333;1335;2;50;2.0
6;615;1335;1336;1;50;2.0
6;616;1336;1337;1;50;2.0
6;617;1337;1338;1;50;2.0
6;618;1338;1341;3;50;2.0
6;619;1341;1343;2;50;2.0
6;620;1343;1345;2;50;2.0
6;621;1345;1348;3;50;2.0
6;622;1348;1355;7;50;2.0
6;623;1355;1357;2;50;2.0
6;624;1357;1360;3;50;2.0
6;625;1360;1363;3;50;2.0
6;626;1363;1364;1;50;2.0
6;627;1364;1365;1;50;2.0
6;628;1365;1366;1;50;2.0
6;629;1366;1371;5;50;2.0
6;630;1371;1378;7;50;2.0
6;631;1378;1379;1;50;2.0
6;632;1379;1380;1;50;2.0
6;633;1380;1382;2;50;2.0
6;634;1382;1386;4;50;2.0
6;635;1386;1388;2;50;2.0
6;636;1388;1395;7;50;2.0
6;637;1395;1410;15;50;2.0
6;638;1410;1425;15;50;2.0
6;639;1425;1440;15;50;2.0
6;640;1440;1455;15;50;2.0
6;641;1455;1470;15;50;2.0
6;642;1470;1485;15;50;2.0
6;643;1485;1500;15;50;2.0
6;644;1500;1515;15;50;2.0
6;645;1515;1530;15;50;2.0
6;646;1530;1545;15;50;2.0
6;647;1545;1560;15;50;2.0
6;648;1560;1575;15;50;2.0
6;649;1575;1590;15;50;2.0
6;650;1590;1605;15;50;2.0
6;651;1605;1620;15;50;2.0
6;652;1620;1635;15;50;2.0
6;653;1635;1650;15;50;2.0
6;654;1650;1665;15;50;2.0
6;655;1665;1680;15;50;2.0
7;0;243;283;40;119;2.0
7;1;283;325;42;119;2.0
7;2;325;326;1;119;2.0
7;3;326;327;1;119;2.0
7;4;327;328;1;119;2.0
7;5;328;330;2;119;2.0
7;6;330;332;2;119;2.0
7;7;332;333;1;119;2.0
7;8;333;334;1;119;2.0
7;9;334;335;1;119;2.0
7;10;335;336;1;119;2.0
7;11;336;337;1;119;2.0
7;12;337;338;1;119;2.0
7;13;338;341;3;119;2.0
7;14;341;343;2;119;2.0
7;15;343;345;2;119;2.0
7;16;345;346;1;119;2.0
7;17;346;347;1;119;2.0
7;18;347;348;1;119;2.0
7;19;348;350;2;119;2.0
7;20;350;351;1;119;2.0
7;21;351;352;1;119;2.0
7;22;352;353;1;119;2.0
7;23;353;355;2;119;2.0
7;24;355;356;1;119;2.0
7;25;356;357;1;119;2.0
7;26;357;360;3;119;2.0
7;27;360;361;1;119;2.0
7;28;361;362;1;119;2.0
7;29;362;365;3;119;2.0
7;30;365;366;1;119;2.0
7;31;366;367;1;119;2.0
7;32;367;368;1;119;2.0
7;33;368;369;1;119;2.0
7;34;369;370;1;119;2.0
7;35;370;371;1;119;2.0
7;36;371;374;3;119;2.0
7;37;374;375;1;119;2.0
7;38;375;376;1;119;2.0
7;39;376;378;2;119;2.0
7;40;378;379;1;119;2.0
7;41;379;380;1;119;2.0
7;42;380;381;1;119;2.0
7;43;381;382;1;119;2.0
7;44;382;384;2;119;2.0
7;45;384;385;1;119;2.0
7;46;385;386;1;119;2.0
7;47;386;387;1;119;2.0
7;48;387;388;1;119;2.0
7;49;388;390;2;119;2.0
7;50;390;391;1;119;2.0
7;51;391;392;1;119;2.0
7;52;392;393;1;119;2.0
7;53;393;394;1;119;2.0
7;54;394;395;1;119;2.0
7;55;395;396;1;119;2.0
7;56;396;397;1;119;2.0
7;57;397;398;1;119;2.0
7;58;398;401;3;119;2.0
7;59;401;402;1;119;2.0
7;60;402;404;2;119;2.0
7;61;404;405;1;119;2.0
7;62;405;407;2;119;2.0
7;63;407;408;1;119;2.0
7;64;408;409;1;119;2.0
7;65;409;411;2;119;2.0
7;66;411;412;1;119;2.0
7;67;412;413;1;119;2.0
7;68;413;414;1;119;2.0
7;69;414;415;1;119;2.0
7;70;415;416;1;119;2.0
7;71;416;417;1;119;2.0
7;72;417;418;1;119;2.0
7;73;418;419;1;119;2.0
7;74;419;420;1;119;2.0
7;75;420;421;1;119;2.0
7;76;421;422;1;119;2.0
7;77;422;424;2;119;2.0
7;78;424;425;1;119;2.0
7;79;425;426;1;119;2.0
7;80;426;427;1;119;2.0
7;81;427;428;1;119;2.0
7;82;428;429;1;119;2.0
7;83;429;431;2;119;2.0
7;84;431;432;1;119;2.0
7;85;432;434;2;119;2.0
7;86;434;435;1;119;2.0
7;87;435;436;1;119;2.0
7;88;436;438;2;119;2.0
7;89;438;440;2;119;2.0
7;90;440;441;1;119;2.0
7;91;441;442;1;119;2.0
7;92;442;444;2;119;2.0
7;93;444;445;1;119;2.0
7;94;445;446;1;119;2.0
7;95;446;447;1;119;2.0
7;96;447;448;1;119;2.0
7;97;448;449;1;119;2.0
7;98;449;450;1;119;2.0
7;99;450;451;1;119;2.0
7;100;451;452;1;119;2.0
7;101;452;453;1;119;2.0
7;102;453;454;1;119;2.0
7;103;454;455;1;119;2.0
7;104;455;456;1;119;2.0
7;105;456;458;2;119;2.0
7;106;458;460;2;119;2.0
7;107;460;462;2;119;2.0
7;108;462;463;1;119;2.0
7;109;463;464;1;119;2.0
7;110;464;465;1;119;2.0
7;111;465;466;1;119;2.0
7;112;466;467;1;119;2.0
7;113;467;468;1;119;2.0
7;114;468;471;3;119;2.0
7;115;471;472;1;119;2.0
7;116;472;473;1;119;2.0
7;117;473;474;1;119;2.0
7;118;474;475;1;119;2.0
7;119;475;476;1;119;2.0
7;120;476;477;1;119;2.0
7;121;477;478;1;119;2.0
7;122;478;479;1;119;2.0
7;123;479;480;1;119;2.0
7;124;480;481;1;119;2.0
7;125;481;482;1;119;2.0
7;126;482;484;2;119;2.0
7;127;484;487;3;119;2.0
7;128;487;488;1;119;2.0
7;129;488;489;1;119;2.0
7;130;489;491;2;119;2.0
7;131;491;492;1;119;2.0
7;132;492;494;2;119;2.0
7;133;494;495;1;119;2.0
7;134;495;498;3;119;2.0
7;135;498;502;4;119;2.0
7;136;502;503;1;119;2.0
7;137;503;504;1;119;2.0
7;138;504;505;1;119;2.0
7;139;505;507;2;119;2.0
7;140;507;511;4;119;2.0
7;141;511;512;1;119;2.0
7;142;512;513;1;119;2.0
7;143;513;514;1;119;2.0
7;144;514;515;1;119;2.0
7;145;515;516;1;119;2.0
7;146;516;517;1;119;2.0
7;147;517;518;1;119;2.0
7;148;518;520;2;119;2.0
7;149;520;521;1;119;2.0
7;150;521;522;1;119;2.0
7;151;522;524;2;119;2.0
7;152;524;525;1;119;2.0
7;153;525;526;1;119;2.0
7;154;526;527;1;119;2.0
7;155;527;530;3;119;2.0
7;156;530;531;1;119;2.0
7;157;531;533;2;119;2.0
7;158;533;536;3;119;2.0
7;159;536;537;1;119;2.0
7;160;537;538;1;119;2.0
7;161;538;539;1;119;2.0
7;162;539;542;3;119;2.0
7;163;542;543;1;119;2.0
7;164;543;544;1;119;2.0
7;165;544;546;2;119;2.0
7;166;546;547;1;119;2.0
7;167;547;549;2;119;2.0
7;168;549;550;1;119;2.0
7;169;550;554;4;119;2.0
7;170;554;555;1;119;2.0
7;171;555;556;1;119;2.0
7;172;556;557;1;119;2.0
7;173;557;558;1;119;2.0
7;174;558;562;4;119;2.0
7;175;562;564;2;119;2.0
7;176;564;567;3;119;2.0
7;177;567;571;4;119;2.0
7;178;571;572;1;119;2.0
7;179;572;573;1;119;2.0
7;180;573;576;3;119;2.0
7;181;576;577;1;119;2.0
7;182;577;578;1;119;2.0
7;183;578;580;2;119;2.0
7;184;580;582;2;119;2.0
7;185;582;584;2;119;2.0
7;186;584;585;1;119;2.0
7;187;585;587;2;119;2.0
7;188;587;589;2;119;2.0
7;189;589;590;1;119;2.0
7;190;590;591;1;119;2.0
7;191;591;593;2;119;2.0
7;192;593;595;2;119;2.0
7;193;595;596;1;119;2.0
7;194;596;598;2;119;2.0
7;195;598;602;4;119;2.0
7;196;602;604;2;119;2.0
7;197;604;607;3;119;2.0
7;198;607;616;9;119;2.0
7;199;616;618;2;119;2.0
7;200;618;619;1;119;2.0
7;201;619;622;3;119;2.0
7;202;622;624;2;119;2.0
7;203;624;625;1;119;2.0
7;204;625;626;1;119;2.0
7;205;626;627;1;119;2.0
7;206;627;629;2;119;2.0
7;207;629;630;1;119;2.0
7;208;630;631;1;119;2.0
7;209;631;634;3;119;2.0
7;210;634;636;2;119;2.0
7;211;636;638;2;119;2.0
7;212;638;642;4;119;2.0
7;213;642;644;2;119;2.0
7;214;644;647;3;119;2.0
7;215;647;651;4;119;2.0
7;216;651;655;4;119;2.0
7;217;655;656;1;119;2.0
7;218;656;657;1;119;2.0
7;219;657;658;1;119;2.0
7;220;658;659;1;119;2.0
7;221;659;662;3;119;2.0
7;222;662;664;2;119;2.0
7;223;664;667;3;119;2.0
7;224;667;670;3;119;2.0
7;225;670;674;4;119;2.0
7;226;674;676;2;119;2.0
7;227;676;678;2;119;2.0
7;228;678;682;4;119;2.0
7;229;682;684;2;119;2.0
7;230;684;687;3;119;2.0
7;231;687;691;4;119;2.0
7;232;691;692;1;119;2.0
7;233;692;695;3;119;2.0
7;234;695;696;1;119;2.0
7;235;696;698;2;119;2.0
7;236;698;699;1;119;2.0
7;237;699;700;1;119;2.0
7;238;700;702;2;119;2.0
7;239;702;704;2;119;2.0
7;240;704;707;3;119;2.0
7;241;707;711;4;119;2.0
7;242;711;713;2;119;2.0
7;243;713;715;2;119;2.0
7;244;715;716;1;119;2.0
7;245;716;718;2;119;2.0
7;246;718;719;1;119;2.0
7;247;719;720;1;119;2.0
7;248;720;722;2;119;2.0
7;249;722;724;2;119;2.0
7;250;724;725;1;119;2.0
7;251;725;727;2;119;2.0
7;252;727;736;9;119;2.0
7;253;736;737;1;119;2.0
7;254;737;738;1;119;2.0
7;255;738;739;1;119;2.0
7;256;739;742;3;119;2.0
7;257;742;744;2;119;2.0
7;258;744;745;1;119;2.0
7;259;745;747;2;119;2.0
7;260;747;749;2;119;2.0
7;261;749;750;1;119;2.0
7;262;750;751;1;119;2.0
7;263;751;756;5;119;2.0
7;264;756;758;2;119;2.0
7;265;758;759;1;119;2.0
7;266;759;760;1;119;2.0
7;267;760;762;2;119;2.0
7;268;762;764;2;119;2.0
7;269;764;765;1;119;2.0
7;270;765;767;2;119;2.0
7;271;767;771;4;119;2.0
7;272;771;772;1;119;2.0
7;273;772;774;2;119;2.0
7;274;774;775;1;119;2.0
7;275;775;776;1;119;2.0
7;276;776;778;2;119;2.0
7;277;778;782;4;119;2.0
7;278;782;784;2;119;2.0
7;279;784;787;3;119;2.0
7;280;787;792;5;119;2.0
7;281;792;794;2;119;2.0
7;282;794;795;1;119;2.0
7;283;795;796;1;119;2.0
7;284;796;798;2;119;2.0
7;285;798;799;1;119;2.0
7;286;799;801;2;119;2.0
7;287;801;802;1;119;2.0
7;288;802;804;2;119;2.0
7;289;804;805;1;119;2.0
7;290;805;806;1;119;2.0
7;291;806;807;1;119;2.0
7;292;807;811;4;119;2.0
7;293;811;812;1;119;2.0
7;294;812;814;2;119;2.0
7;295;814;815;1;119;2.0
7;296;815;816;1;119;2.0
7;297;816;817;1;119;2.0
7;298;817;818;1;119;2.0
7;299;818;819;1;119;2.0
7;300;819;820;1;119;2.0
7;301;820;822;2;119;2.0
7;302;822;824;2;119;2.0
7;303;824;827;3;119;2.0
7;304;827;828;1;119;2.0
7;305;828;829;1;119;2.0
7;306;829;831;2;119;2.0
7;307;831;832;1;119;2.0
7;308;832;833;1;119;2.0
7;309;833;834;1;119;2.0
7;310;834;835;1;119;2.0
7;311;835;836;1;119;2.0
7;312;836;837;1;119;2.0
7;313;837;838;1;119;2.0
7;314;838;840;2;119;2.0
7;315;840;842;2;119;2.0
7;316;842;844;2;119;2.0
7;317;844;845;1;119;2.0
7;318;845;846;1;119;2.0
7;319;846;847;1;119;2.0
7;320;847;848;1;119;2.0
7;321;848;849;1;119;2.0
7;322;849;853;4;119;2.0
7;323;853;854;1;119;2.0
7;324;854;855;1;119;2.0
7;325;855;856;1;119;2.0
7;326;856;858;2;119;2.0
7;327;858;859;1;119;2.0
7;328;859;860;1;119;2.0
7;329;860;862;2;119;2.0
7;330;862;864;2;119;2.0
7;331;864;865;1;119;2.0
7;332;865;867;2;119;2.0
7;333;867;868;1;119;2.0
7;334;868;870;2;119;2.0
7;335;870;871;1;119;2.0
7;336;871;872;1;119;2.0
7;337;872;873;1;119;2.0
7;338;873;874;1;119;2.0
7;339;874;876;2;119;2.0
7;340;876;878;2;119;2.0
7;341;878;879;1;119;2.0
7;342;879;880;1;119;2.0
7;343;880;882;2;119;2.0
7;344;882;883;1;119;2.0
7;345;883;884;1;119;2.0
7;346;884;885;1;119;2.0
7;347;885;886;1;119;2.0
7;348;886;887;1;119;2.0
7;349;887;888;1;119;2.0
7;350;888;891;3;119;2.0
7;351;891;892;1;119;2.0
7;352;892;893;1;119;2.0
7;353;893;894;1;119;2.0
7;354;894;895;1;119;2.0
7;355;895;896;1;119;2.0
7;356;896;898;2;119;2.0
7;357;898;900;2;119;2.0
7;358;900;902;2;119;2.0
7;359;902;903;1;119;2.0
7;360;903;904;1;119;2.0
7;361;904;906;2;119;2.0
7;362;906;907;1;119;2.0
7;363;907;908;1;119;2.0
7;364;908;909;1;119;2.0
7;365;909;911;2;119;2.0
7;366;911;912;1;119;2.0
7;367;912;914;2;119;2.0
7;368;914;915;1;119;2.0
7;369;915;916;1;119;2.0
7;370;916;917;1;119;2.0
7;371;917;918;1;119;2.0
7;372;918;921;3;119;2.0
7;373;921;922;1;119;2.0
7;374;922;924;2;119;2.0
7;375;924;925;1;119;2.0
7;376;925;926;1;119;2.0
7;377;926;927;1;119;2.0
7;378;927;928;1;119;2.0
7;379;928;930;2;119;2.0
7;380;930;931;1;119;2.0
7;381;931;932;1;119;2.0
7;382;932;933;1;119;2.0
7;383;933;934;1;119;2.0
7;384;934;936;2;119;2.0
7;385;936;937;1;119;2.0
7;386;937;938;1;119;2.0
7;387;938;939;1;119;2.0
7;388;939;940;1;119;2.0
7;389;940;942;2;119;2.0
7;390;942;943;1;119;2.0
7;391;943;944;1;119;2.0
7;392;944;946;2;119;2.0
7;393;946;947;1;119;2.0
7;394;947;948;1;119;2.0
7;395;948;951;3;119;2.0
7;396;951;952;1;119;2.0
7;397;952;954;2;119;2.0
7;398;954;955;1;119;2.0
7;399;955;956;1;119;2.0
7;400;956;957;1;119;2.0
7;401;957;958;1;119;2.0
7;402;958;960;2;119;2.0
7;403;960;962;2;119;2.0
7;404;962;964;2;119;2.0
7;405;964;966;2;119;2.0
7;406;966;967;1;119;2.0
7;407;967;968;1;119;2.0
7;408;968;969;1;119;2.0
7;409;969;971;2;119;2.0
7;410;971;972;1;119;2.0
7;411;972;974;2;119;2.0
7;412;974;975;1;119;2.0
7;413;975;976;1;119;2.0
7;414;976;977;1;119;2.0
7;415;977;978;1;119;2.0
7;416;978;981;3;119;2.0
7;417;981;982;1;119;2.0
7;418;982;984;2;119;2.0
7;419;984;987;3;119;2.0
7;420;987;988;1;119;2.0
7;421;988;992;4;119;2.0
7;422;992;993;1;119;2.0
7;423;993;994;1;119;2.0
7;424;994;995;1;119;2.0
7;425;995;996;1;119;2.0
7;426;996;997;1;119;2.0
7;427;997;998;1;119;2.0
7;428;998;999;1;119;2.0
7;429;999;1000;1;119;2.0
7;430;1000;1002;2;119;2.0
7;431;1002;1003;1;119;2.0
7;432;1003;1004;1;119;2.0
7;433;1004;1006;2;119;2.0
7;434;1006;1007;1;119;2.0
7;435;1007;1008;1;119;2.0
7;436;1008;1011;3;119;2.0
7;437;1011;1012;1;119;2.0
7;438;1012;1014;2;119;2.0
7;439;1014;1015;1;119;2.0
7;440;1015;1016;1;119;2.0
7;441;1016;1017;1;119;2.0
7;442;1017;1018;1;119;2.0
7;443;1018;1020;2;119;2.0
7;444;1020;1021;1;119;2.0
7;445;1021;1023;2;119;2.0
7;446;1023;1025;2;119;2.0
7;447;1025;1026;1;119;2.0
7;448;1026;1027;1;119;2.0
7;449;1027;1028;1;119;2.0
7;450;1028;1029;1;119;2.0
7;451;1029;1032;3;119;2.0
7;452;1032;1033;1;119;2.0
7;453;1033;1034;1;119;2.0
7;454;1034;1036;2;119;2.0
7;455;1036;1038;2;119;2.0
7;456;1038;1041;3;119;2.0
7;457;1041;1043;2;119;2.0
7;458;1043;1044;1;119;2.0
7;459;1044;1045;1;119;2.0
7;460;1045;1046;1;119;2.0
7;461;1046;1047;1;119;2.0
7;462;1047;1048;1;119;2.0
7;463;1048;1053;5;119;2.0
7;464;1053;1056;3;119;2.0
7;465;1056;1057;1;119;2.0
7;466;1057;1058;1;119;2.0
7;467;1058;1059;1;119;2.0
7;468;1059;1062;3;119;2.0
7;469;1062;1063;1;119;2.0
7;470;1063;1064;1;119;2.0
7;471;1064;1065;1;119;2.0
7;472;1065;1066;1;119;2.0
7;473;1066;1067;1;119;2.0
7;474;1067;1068;1;119;2.0
7;475;1068;1070;2;119;2.0
7;476;1070;1071;1;119;2.0
7;477;1071;1072;1;119;2.0
7;478;1072;1074;2;119;2.0
7;479;1074;1075;1;119;2.0
7;480;1075;1076;1;119;2.0
7;481;1076;1077;1;119;2.0
7;482;1077;1078;1;119;2.0
7;483;1078;1082;4;119;2.0
7;484;1082;1083;1;119;2.0
7;485;1083;1085;2;119;2.0
7;486;1085;1086;1;119;2.0
7;487;1086;1087;1;119;2.0
7;488;1087;1088;1;119;2.0
7;489;1088;1089;1;119;2.0
7;490;1089;1092;3;119;2.0
7;491;1092;1094;2;119;2.0
7;492;1094;1096;2;119;2.0
7;493;1096;1098;2;119;2.0
7;494;1098;1101;3;119;2.0
7;495;1101;1104;3;119;2.0
7;496;1104;1106;2;119;2.0
7;497;1106;1107;1;119;2.0
7;498;1107;1108;1;119;2.0
7;499;1108;1109;1;119;2.0
7;500;1109;1110;1;119;2.0
7;501;1110;1111;1;119;2.0
7;502;1111;1112;1;119;2.0
7;503;1112;1113;1;119;2.0
7;504;1113;1116;3;119;2.0
7;505;1116;1119;3;119;2.0
7;506;1119;1121;2;119;2.0
7;507;1121;1125;4;119;2.0
7;508;1125;1127;2;119;2.0
7;509;1127;1131;4;119;2.0
7;510;1131;1133;2;119;2.0
7;511;1133;1136;3;119;2.0
7;512;1136;1138;2;119;2.0
7;513;1138;1139;1;119;2.0
7;514;1139;1140;1;119;2.0
7;515;1140;1141;1;119;2.0
7;516;1141;1142;1;119;2.0
7;517;1142;1144;2;119;2.0
7;518;1144;1146;2;119;2.0
7;519;1146;1147;1;119;2.0
7;520;1147;1151;4;119;2.0
7;521;1151;1152;1;119;2.0
7;522;1152;1155;3;119;2.0
7;523;1155;1156;1;119;2.0
7;524;1156;1159;3;119;2.0
7;525;1159;1161;2;119;2.0
7;526;1161;1169;8;119;2.0
7;527;1169;1171;2;119;2.0
7;528;1171;1172;1;119;2.0
7;529;1172;1173;1;119;2.0
7;530;1173;1175;2;119;2.0
7;531;1175;1176;1;119;2.0
7;532;1176;1177;1;119;2.0
7;533;1177;1179;2;119;2.0
7;534;1179;1181;2;119;2.0
7;535;1181;1186;5;119;2.0
7;536;1186;1187;1;119;2.0
7;537;1187;1189;2;119;2.0
7;538;1189;1195;6;119;2.0
7;539;1195;1196;1;119;2.0
7;540;1196;1198;2;119;2.0
7;541;1198;1199;1;119;2.0
7;542;1199;1201;2;119;2.0
7;543;1201;1204;3;119;2.0
7;544;1204;1206;2;119;2.0
7;545;1206;1208;2;119;2.0
7;546;1208;1209;1;119;2.0
7;547;1209;1210;1;119;2.0
7;548;1210;1215;5;119;2.0
7;549;1215;1219;4;119;2.0
7;550;1219;1221;2;119;2.0
7;551;1221;1224;3;119;2.0
7;552;1224;1226;2;119;2.0
7;553;1226;1229;3;119;2.0
7;554;1229;1231;2;119;2.0
7;555;1231;1232;1;119;2.0
7;556;1232;1235;3;119;2.0
7;557;1235;1236;1;119;2.0
7;558;1236;1246;10;119;2.0
7;559;1246;1249;3;119;2.0
7;560;1249;1251;2;119;2.0
7;561;1251;1253;2;119;2.0
7;562;1253;1256;3;119;2.0
7;563;1256;1258;2;119;2.0
7;564;1258;1260;2;119;2.0
7;565;1260;1261;1;119;2.0
7;566;1261;1264;3;119;2.0
7;567;1264;1266;2;119;2.0
7;568;1266;1267;1;119;2.0
7;569;1267;1268;1;119;2.0
7;570;1268;1271;3;119;2.0
7;571;1271;1274;3;119;2.0
7;572;1274;1276;2;119;2.0
7;573;1276;1281;5;119;2.0
7;574;1281;1282;1;119;2.0
7;575;1282;1283;1;119;2.0
7;576;1283;1284;1;119;2.0
7;577;1284;1285;1;119;2.0
7;578;1285;1292;7;119;2.0
7;579;1292;1296;4;119;2.0
7;580;1296;1298;2;119;2.0
7;581;1298;1299;1;119;2.0
7;582;1299;1301;2;119;2.0
7;583;1301;1304;3;119;2.0
7;584;1304;1306;2;119;2.0
7;585;1306;1309;3;119;2.0
7;586;1309;1310;1;119;2.0
7;587;1310;1311;1;119;2.0
7;588;1311;1314;3;119;2.0
7;589;1314;1316;2;119;2.0
7;590;1316;1320;4;119;2.0
7;591;1320;1321;1;119;2.0
7;592;1321;1322;1;119;2.0
7;593;1322;1324;2;119;2.0
7;594;1324;1326;2;119;2.0
7;595;1326;1327;1;119;2.0
7;596;1327;1329;2;119;2.0
7;597;1329;1333;4;119;2.0
7;598;1333;1334;1;119;2.0
7;599;1334;1335;1;119;2.0
7;600;1335;1336;1;119;2.0
7;601;1336;1338;2;119;2.0
7;602;1338;1341;3;119;2.0
7;603;1341;1342;1;119;2.0
7;604;1342;1343;1;119;2.0
7;605;1343;1345;2;119;2.0
7;606;1345;1346;1;119;2.0
7;607;1346;1349;3;119;2.0
7;608;1349;1356;7;119;2.0
7;609;1356;1358;2;119;2.0
7;610;1358;1359;1;119;2.0
7;611;1359;1360;1;119;2.0
7;612;1360;1362;2;119;2.0
7;613;1362;1363;1;119;2.0
7;614;1363;1364;1;119;2.0
7;615;1364;1366;2;119;2.0
7;616;1366;1371;5;119;2.0
7;617;1371;1373;2;119;2.0
7;618;1373;1376;3;119;2.0
7;619;1376;1378;2;119;2.0
7;620;1378;1379;1;119;2.0
7;621;1379;1380;1;119;2.0
7;622;1380;1381;1;119;2.0
7;623;1381;1386;5;119;2.0
7;624;1386;1387;1;119;2.0
7;625;1387;1388;1;119;2.0
7;626;1388;1395;7;119;2.0
7;627;1395;1410;15;119;2.0
7;628;1410;1425;15;119;2.0
7;629;1425;1440;15;119;2.0
7;630;1440;1455;15;119;2.0
7;631;1455;1470;15;119;2.0
7;632;1470;1485;15;119;2.0
7;633;1485;1500;15;119;2.0
7;634;1500;1515;15;119;2.0
7;635;1515;1530;15;119;2.0
7;636;1530;1545;15;119;2.0
7;637;1545;1560;15;119;2.0
7;638;1560;1575;15;119;2.0
7;639;1575;1590;15;119;2.0
7;640;1590;1605;15;119;2.0
7;641;1605;1620;15;119;2.0
7;642;1620;1635;15;119;2.0
7;643;1635;1650;15;119;2.0
7;644;1650;1665;15;119;2.0
7;645;1665;1680;15;119;2.0
8;0;241;283;42;96;2.0
8;1;283;324;41;96;2.0
8;2;324;326;2;96;2.0
8;3;326;327;1;96;2.0
8;4;327;329;2;96;2.0
8;5;329;330;1;96;2.0
8;6;330;331;1;96;2.0
8;7;331;332;1;96;2.0
8;8;332;334;2;96;2.0
8;9;334;335;1;96;2.0
8;10;335;336;1;96;2.0
8;11;336;337;1;96;2.0
8;12;337;338;1;96;2.0
8;13;338;340;2;96;2.0
8;14;340;343;3;96;2.0
8;15;343;345;2;96;2.0
8;16;345;346;1;96;2.0
8;17;346;347;1;96;2.0
8;18;347;348;1;96;2.0
8;19;348;349;1;96;2.0
8;20;349;350;1;96;2.0
8;21;350;351;1;96;2.0
8;22;351;352;1;96;2.0
8;23;352;353;1;96;2.0
8;24;353;354;1;96;2.0
8;25;354;356;2;96;2.0
8;26;356;358;2;96;2.0
8;27;358;360;2;96;2.0
8;28;360;361;1;96;2.0
8;29;361;362;1;96;2.0
8;30;362;363;1;96;2.0
8;31;363;365;2;96;2.0
8;32;365;366;1;96;2.0
8;33;366;367;1;96;2.0
8;34;367;368;1;96;2.0
8;35;368;369;1;96;2.0
8;36;369;370;1;96;2.0
8;37;370;372;2;96;2.0
8;38;372;374;2;96;2.0
8;39;374;377;3;96;2.0
8;40;377;378;1;96;2.0
8;41;378;379;1;96;2.0
8;42;379;380;1;96;2.0
8;43;380;382;2;96;2.0
8;44;382;383;1;96;2.0
8;45;383;384;1;96;2.0
8;46;384;385;1;96;2.0
8;47;385;386;1;96;2.0
8;48;386;387;1;96;2.0
8;49;387;388;1;96;2.0
8;50;388;389;1;96;2.0
8;51;389;391;2;96;2.0
8;52;391;392;1;96;2.0
8;53;392;393;1;96;2.0
8;54;393;394;1;96;2.0
8;55;394;395;1;96;2.0
8;56;395;397;2;96;2.0
8;57;397;398;1;96;2.0
8;58;398;399;1;96;2.0
8;59;399;400;1;96;2.0
8;60;400;403;3;96;2.0
8;61;403;404;1;96;2.0
8;62;404;405;1;96;2.0
8;63;405;406;1;96;2.0
8;64;406;407;1;96;2.0
8;65;407;409;2;96;2.0
8;66;409;410;1;96;2.0
8;67;410;413;3;96;2.0
8;68;413;414;1;96;2.0
8;69;414;416;2;96;2.0
8;70;416;417;1;96;2.0
8;71;417;418;1;96;2.0
8;72;418;419;1;96;2.0
8;73;419;420;1;96;2.0
8;74;420;421;1;96;2.0
8;75;421;423;2;96;2.0
8;76;423;424;1;96;2.0
8;77;424;426;2;96;2.0
8;78;426;427;1;96;2.0
8;79;427;428;1;96;2.0
8;80;428;429;1;96;2.0
8;81;429;430;1;96;2.0
8;82;430;431;1;96;2.0
8;83;431;432;1;96;2.0
8;84;432;433;1;96;2.0
8;85;433;434;1;96;2.0
8;86;434;436;2;96;2.0
8;87;436;437;1;96;2.0
8;88;437;439;2;96;2.0
8;89;439;440;1;96;2.0
8;90;440;443;3;96;2.0
8;91;443;444;1;96;2.0
8;92;444;445;1;96;2.0
8;93;445;446;1;96;2.0
8;94;446;447;1;96;2.0
8;95;447;449;2;96;2.0
8;96;449;450;1;96;2.0
8;97;450;451;1;96;2.0
8;98;451;452;1;96;2.0
8;99;452;453;1;96;2.0
8;100;453;454;1;96;2.0
8;101;454;455;1;96;2.0
8;102;455;457;2;96;2.0
8;103;457;458;1;96;2.0
8;104;458;459;1;96;2.0
8;105;459;463;4;96;2.0
8;106;463;464;1;96;2.0
8;107;464;466;2;96;2.0
8;108;466;467;1;96;2.0
8;109;467;468;1;96;2.0
8;110;468;470;2;96;2.0
8;111;470;471;1;96;2.0
8;112;471;472;1;96;2.0
8;113;472;473;1;96;2.0
8;114;473;474;1;96;2.0
8;115;474;475;1;96;2.0
8;116;475;476;1;96;2.0
8;117;476;477;1;96;2.0
8;118;477;478;1;96;2.0
8;119;478;479;1;96;2.0
8;120;479;480;1;96;2.0
8;121;480;481;1;96;2.0
8;122;481;483;2;96;2.0
8;123;483;484;1;96;2.0
8;124;484;485;1;96;2.0
8;125;485;487;2;96;2.0
8;126;487;490;3;96;2.0
8;127;490;493;3;96;2.0
8;128;493;494;1;96;2.0
8;129;494;495;1;96;2.0
8;130;495;496;1;96;2.0
8;131;496;499;3;96;2.0
8;132;499;500;1;96;2.0
8;133;500;502;2;96;2.0
8;134;502;503;1;96;2.0
8;135;503;504;1;96;2.0
8;136;504;505;1;96;2.0
8;137;505;506;1;96;2.0
8;138;506;507;1;96;2.0
8;139;507;513;6;96;2.0
8;140;513;514;1;96;2.0
8;141;514;515;1;96;2.0
8;142;515;518;3;96;2.0
8;143;518;519;1;96;2.0
8;144;519;521;2;96;2.0
8;145;521;522;1;96;2.0
8;146;522;523;1;96;2.0
8;147;523;524;1;96;2.0
8;148;524;526;2;96;2.0
8;149;526;527;1;96;2.0
8;150;527;529;2;96;2.0
8;151;529;530;1;96;2.0
8;152;530;532;2;96;2.0
8;153;532;533;1;96;2.0
8;154;533;537;4;96;2.0
8;155;537;538;1;96;2.0
8;156;538;539;1;96;2.0
8;157;539;540;1;96;2.0
8;158;540;543;3;96;2.0
8;159;543;544;1;96;2.0
8;160;544;545;1;96;2.0
8;161;545;546;1;96;2.0
8;162;546;547;1;96;2.0
8;163;547;548;1;96;2.0
8;164;548;549;1;96;2.0
8;165;549;550;1;96;2.0
8;166;550;551;1;96;2.0
8;167;551;554;3;96;2.0
8;168;554;556;2;96;2.0
8;169;556;557;1;96;2.0
8;170;557;558;1;96;2.0
8;171;558;559;1;96;2.0
8;172;559;560;1;96;2.0
8;173;560;563;3;96;2.0
8;174;563;564;1;96;2.0
8;175;564;567;3;96;2.0
8;176;567;569;2;96;2.0
8;177;569;572;3;96;2.0
8;178;572;573;1;96;2.0
8;179;573;574;1;96;2.0
8;180;574;576;2;96;2.0
8;181;576;577;1;96;2.0
8;182;577;578;1;96;2.0
8;183;578;579;1;96;2.0
8;184;579;583;4;96;2.0
8;185;583;584;1;96;2.0
8;186;584;586;2;96;2.0
8;187;586;587;1;96;2.0
8;188;587;588;1;96;2.0
8;189;588;589;1;96;2.0
8;190;589;590;1;96;2.0
8;191;590;591;1;96;2.0
8;192;591;592;1;96;2.0
8;193;592;594;2;96;2.0
8;194;594;597;3;96;2.0
8;195;597;598;1;96;2.0
8;196;598;599;1;96;2.0
8;197;599;603;4;96;2.0
8;198;603;604;1;96;2.0
8;199;604;606;2;96;2.0
8;200;606;607;1;96;2.0
8;201;607;609;2;96;2.0
8;202;609;616;7;96;2.0
8;203;616;617;1;96;2.0
8;204;617;618;1;96;2.0
8;205;618;619;1;96;2.0
8;206;619;620;1;96;2.0
8;207;620;623;3;96;2.0
8;208;623;624;1;96;2.0
8;209;624;625;1;96;2.0
8;210;625;626;1;96;2.0
8;211;626;627;1;96;2.0
8;212;627;629;2;96;2.0
8;213;629;630;1;96;2.0
8;214;630;633;3;96;2.0
8;215;633;634;1;96;2.0
8;216;634;637;3;96;2.0
8;217;637;638;1;96;2.0
8;218;638;639;1;96;2.0
8;219;639;643;4;96;2.0
8;220;643;644;1;96;2.0
8;221;644;647;3;96;2.0
8;222;647;650;3;96;2.0
8;223;650;652;2;96;2.0
8;224;652;654;2;96;2.0
8;225;654;656;2;96;2.0
8;226;656;657;1;96;2.0
8;227;657;658;1;96;2.0
8;228;658;659;1;96;2.0
8;229;659;660;1;96;2.0
8;230;660;663;3;96;2.0
8;231;663;664;1;96;2.0
8;232;664;666;2;96;2.0
8;233;666;667;1;96;2.0
8;234;667;669;2;96;2.0
8;235;669;671;2;96;2.0
8;236;671;674;3;96;2.0
8;237;674;677;3;96;2.0
8;238;677;678;1;96;2.0
8;239;678;679;1;96;2.0
8;240;679;682;3;96;2.0
8;241;682;683;1;96;2.0
8;242;683;684;1;96;2.0
8;243;684;687;3;96;2.0
8;244;687;689;2;96;2.0
8;245;689;692;3;96;2.0
8;246;692;693;1;96;2.0
8;247;693;696;3;96;2.0
8;248;696;697;1;96;2.0
8;249;697;698;1;96;2.0
8;250;698;699;1;96;2.0
8;251;699;700;1;96;2.0
8;252;700;703;3;96;2.0
8;253;703;704;1;96;2.0
8;254;704;705;1;96;2.0
8;255;705;706;1;96;2.0
8;256;706;707;1;96;2.0
8;257;707;710;3;96;2.0
8;258;710;712;2;96;2.0
8;259;712;714;2;96;2.0
8;260;714;717;3;96;2.0
8;261;717;718;1;96;2.0
8;262;718;719;1;96;2.0
8;263;719;721;2;96;2.0
8;264;721;723;2;96;2.0
8;265;723;724;1;96;2.0
8;266;724;725;1;96;2.0
8;267;725;726;1;96;2.0
8;268;726;727;1;96;2.0
8;269;727;728;1;96;2.0
8;270;728;729;1;96;2.0
8;271;729;736;7;96;2.0
8;272;736;737;1;96;2.0
8;273;737;738;1;96;2.0
8;274;738;739;1;96;2.0
8;275;739;743;4;96;2.0
8;276;743;744;1;96;2.0
8;277;744;747;3;96;2.0
8;278;747;749;2;96;2.0
8;279;749;750;1;96;2.0
8;280;750;753;3;96;2.0
8;281;753;757;4;96;2.0
8;282;757;758;1;96;2.0
8;283;758;759;1;96;2.0
8;284;759;760;1;96;2.0
8;285;760;763;3;96;2.0
8;286;763;764;1;96;2.0
8;287;764;766;2;96;2.0
8;288;766;767;1;96;2.0
8;289;767;768;1;96;2.0
8;290;768;770;2;96;2.0
8;291;770;772;2;96;2.0
8;292;772;773;1;96;2.0
8;293;773;774;1;96;2.0
8;294;774;775;1;96;2.0
8;295;775;776;1;96;2.0
8;296;776;777;1;96;2.0
8;297;777;778;1;96;2.0
8;298;778;779;1;96;2.0
8;299;779;783;4;96;2.0
8;300;783;784;1;96;2.0
8;301;784;785;1;96;2.0
8;302;785;787;2;96;2.0
8;303;787;788;1;96;2.0
8;304;788;789;1;96;2.0
8;305;789;792;3;96;2.0
8;306;792;794;2;96;2.0
8;307;794;795;1;96;2.0
8;308;795;796;1;96;2.0
8;309;796;797;1;96;2.0
8;310;797;798;1;96;2.0
8;311;798;799;1;96;2.0
8;312;799;800;1;96;2.0
8;313;800;801;1;96;2.0
8;314;801;803;2;96;2.0
8;315;803;804;1;96;2.0
8;316;804;805;1;96;2.0
8;317;805;806;1;96;2.0
8;318;806;807;1;96;2.0
8;319;807;810;3;96;2.0
8;320;810;811;1;96;2.0
8;321;811;813;2;96;2.0
8;322;813;814;1;96;2.0
8;323;814;815;1;96;2.0
8;324;815;817;2;96;2.0
8;325;817;818;1;96;2.0
8;326;818;819;1;96;2.0
8;327;819;820;1;96;2.0
8;328;820;822;2;96;2.0
8;329;822;823;1;96;2.0
8;330;823;824;1;96;2.0
8;331;824;827;3;96;2.0
8;332;827;829;2;96;2.0
8;333;829;830;1;96;2.0
8;334;830;832;2;96;2.0
8;335;832;833;1;96;2.0
8;336;833;834;1;96;2.0
8;337;834;835;1;96;2.0
8;338;835;836;1;96;2.0
8;339;836;837;1;96;2.0
8;340;837;838;1;96;2.0
8;341;838;839;1;96;2.0
8;342;839;841;2;96;2.0
8;343;841;843;2;96;2.0
8;344;843;844;1;96;2.0
8;345;844;845;1;96;2.0
8;346;845;847;2;96;2.0
8;347;847;848;1;96;2.0
8;348;848;849;1;96;2.0
8;349;849;850;1;96;2.0
8;350;850;853;3;96;2.0
8;351;853;854;1;96;2.0
8;352;854;856;2;96;2.0
8;353;856;857;1;96;2.0
8;354;857;858;1;96;2.0
8;355;858;859;1;96;2.0
8;356;859;860;1;96;2.0
8;357;860;861;1;96;2.0
8;358;861;863;2;96;2.0
8;359;863;864;1;96;2.0
8;360;864;865;1;96;2.0
8;361;865;866;1;96;2.0
8;362;866;867;1;96;2.0
8;363;867;869;2;96;2.0
8;364;869;870;1;96;2.0
8;365;870;871;1;96;2.0
8;366;871;872;1;96;2.0
8;367;872;873;1;96;2.0
8;368;873;874;1;96;2.0
8;369;874;876;2;96;2.0
8;370;876;877;1;96;2.0
8;371;877;878;1;96;2.0
8;372;878;879;1;96;2.0
8;373;879;880;1;96;2.0
8;374;880;883;3;96;2.0
8;375;883;884;1;96;2.0
8;376;884;886;2;96;2.0
8;377;886;887;1;96;2.0
8;378;887;888;1;96;2.0
8;379;888;889;1;96;2.0
8;380;889;890;1;96;2.0
8;381;890;891;1;96;2.0
8;382;891;892;1;96;2.0
8;383;892;893;1;96;2.0
8;384;893;894;1;96;2.0
8;385;894;896;2;96;2.0
8;386;896;897;1;96;2.0
8;387;897;898;1;96;2.0
8;388;898;899;1;96;2.0
8;389;899;900;1;96;2.0
8;390;900;901;1;96;2.0
8;391;901;902;1;96;2.0
8;392;902;903;1;96;2.0
8;393;903;904;1;96;2.0
8;394;904;905;1;96;2.0
8;395;905;907;2;96;2.0
8;396;907;908;1;96;2.0
8;397;908;909;1;96;2.0
8;398;909;910;1;96;2.0
8;399;910;911;1;96;2.0
8;400;911;912;1;96;2.0
8;401;912;913;1;96;2.0
8;402;913;914;1;96;2.0
8;403;914;916;2;96;2.0
8;404;916;917;1;96;2.0
8;405;917;918;1;96;2.0
8;406;918;919;1;96;2.0
8;407;919;920;1;96;2.0
8;408;920;921;1;96;2.0
8;409;921;923;2;96;2.0
8;410;923;924;1;96;2.0
8;411;924;926;2;96;2.0
8;412;926;927;1;96;2.0
8;413;927;929;2;96;2.0
8;414;929;930;1;96;2.0
8;415;930;931;1;96;2.0
8;416;931;932;1;96;2.0
8;417;932;933;1;96;2.0
8;418;933;934;1;96;2.0
8;419;934;937;3;96;2.0
8;420;937;938;1;96;2.0
8;421;938;939;1;96;2.0
8;422;939;940;1;96;2.0
8;423;940;941;1;96;2.0
8;424;941;943;2;96;2.0
8;425;943;944;1;96;2.0
8;426;944;945;1;96;2.0
8;427;945;946;1;96;2.0
8;428;946;947;1;96;2.0
8;429;947;948;1;96;2.0
8;430;948;950;2;96;2.0
8;431;950;953;3;96;2.0
8;432;953;954;1;96;2.0
8;433;954;956;2;96;2.0
8;434;956;957;1;96;2.0
8;435;957;958;1;96;2.0
8;436;958;959;1;96;2.0
8;437;959;960;1;96;2.0
8;438;960;962;2;96;2.0
8;439;962;963;1;96;2.0
8;440;963;964;1;96;2.0
8;441;964;965;1;96;2.0
8;442;965;967;2;96;2.0
8;443;967;968;1;96;2.0
8;444;968;969;1;96;2.0
8;445;969;970;1;96;2.0
8;446;970;971;1;96;2.0
8;447;971;973;2;96;2.0
8;448;973;974;1;96;2.0
8;449;974;976;2;96;2.0
8;450;976;977;1;96;2.0
8;451;977;978;1;96;2.0
8;452;978;979;1;96;2.0
8;453;979;980;1;96;2.0
8;454;980;981;1;96;2.0
8;455;981;982;1;96;2.0
8;456;982;983;1;96;2.0
8;457;983;984;1;96;2.0
8;458;984;987;3;96;2.0
8;459;987;989;2;96;2.0
8;460;989;990;1;96;2.0
8;461;990;993;3;96;2.0
8;462;993;994;1;96;2.0
8;463;994;996;2;96;2.0
8;464;996;997;1;96;2.0
8;465;997;998;1;96;2.0
8;466;998;999;1;96;2.0
8;467;999;1000;1;96;2.0
8;468;1000;1001;1;96;2.0
8;469;1001;1003;2;96;2.0
8;470;1003;1004;1;96;2.0
8;471;1004;1005;1;96;2.0
8;472;1005;1007;2;96;2.0
8;473;1007;1008;1;96;2.0
8;474;1008;1010;2;96;2.0
8;475;1010;1012;2;96;2.0
8;476;1012;1014;2;96;2.0
8;477;1014;1015;1;96;2.0
8;478;1015;1016;1;96;2.0
8;479;1016;1018;2;96;2.0
8;480;1018;1019;1;96;2.0
8;481;1019;1020;1;96;2.0
8;482;1020;1021;1;96;2.0
8;483;1021;1022;1;96;2.0
8;484;1022;1024;2;96;2.0
8;485;1024;1025;1;96;2.0
8;486;1025;1026;1;96;2.0
8;487;1026;1027;1;96;2.0
8;488;1027;1029;2;96;2.0
8;489;1029;1030;1;96;2.0
8;490;1030;1031;1;96;2.0
8;491;1031;1033;2;96;2.0
8;492;1033;1037;4;96;2.0
8;493;1037;1038;1;96;2.0
8;494;1038;1039;1;96;2.0
8;495;1039;1042;3;96;2.0
8;496;1042;1044;2;96;2.0
8;497;1044;1045;1;96;2.0
8;498;1045;1046;1;96;2.0
8;499;1046;1047;1;96;2.0
8;500;1047;1048;1;96;2.0
8;501;1048;1049;1;96;2.0
8;502;1049;1050;1;96;2.0
8;503;1050;1052;2;96;2.0
8;504;1052;1056;4;96;2.0
8;505;1056;1058;2;96;2.0
8;506;1058;1059;1;96;2.0
8;507;1059;1061;2;96;2.0
8;508;1061;1062;1;96;2.0
8;509;1062;1063;1;96;2.0
8;510;1063;1064;1;96;2.0
8;511;1064;1065;1;96;2.0
8;512;1065;1067;2;96;2.0
8;513;1067;1068;1;96;2.0
8;514;1068;1069;1;96;2.0
8;515;1069;1070;1;96;2.0
8;516;1070;1071;1;96;2.0
8;517;1071;1072;1;96;2.0
8;518;1072;1074;2;96;2.0
8;519;1074;1077;3;96;2.0
8;520;1077;1078;1;96;2.0
8;521;1078;1079;1;96;2.0
8;522;1079;1082;3;96;2.0
8;523;1082;1083;1;96;2.0
8;524;1083;1084;1;96;2.0
8;525;1084;1085;1;96;2.0
8;526;1085;1086;1;96;2.0
8;527;1086;1087;1;96;2.0
8;528;1087;1088;1;96;2.0
8;529;1088;1089;1;96;2.0
8;530;1089;1090;1;96;2.0
8;531;1090;1093;3;96;2.0
8;532;1093;1094;1;96;2.0
8;533;1094;1095;1;96;2.0
8;534;1095;1096;1;96;2.0
8;535;1096;1097;1;96;2.0
8;536;1097;1098;1;96;2.0
8;537;1098;1099;1;96;2.0
8;538;1099;1101;2;96;2.0
8;539;1101;1102;1;96;2.0
8;540;1102;1104;2;96;2.0
8;541;1104;1107;3;96;2.0
8;542;1107;1108;1;96;2.0
8;543;1108;1109;1;96;2.0
8;544;1109;1110;1;96;2.0
8;545;1110;1111;1;96;2.0
8;546;1111;1112;1;96;2.0
8;547;1112;1113;1;96;2.0
8;548;1113;1116;3;96;2.0
8;549;1116;1118;2;96;2.0
8;550;1118;1119;1;96;2.0
8;551;1119;1120;1;96;2.0
8;552;1120;1122;2;96;2.0
8;553;1122;1124;2;96;2.0
8;554;1124;1126;2;96;2.0
8;555;1126;1129;3;96;2.0
8;556;1129;1131;2;96;2.0
8;557;1131;1132;1;96;2.0
8;558;1132;1134;2;96;2.0
8;559;1134;1137;3;96;2.0
8;560;1137;1138;1;96;2.0
8;561;1138;1139;1;96;2.0
8;562;1139;1140;1;96;2.0
8;563;1140;1141;1;96;2.0
8;564;1141;1142;1;96;2.0
8;565;1142;1143;1;96;2.0
8;566;1143;1144;1;96;2.0
8;567;1144;1146;2;96;2.0
8;568;1146;1148;2;96;2.0
8;569;1148;1151;3;96;2.0
8;570;1151;1152;1;96;2.0
8;571;1152;1153;1;96;2.0
8;572;1153;1154;1;96;2.0
8;573;1154;1156;2;96;2.0
8;574;1156;1158;2;96;2.0
8;575;1158;1160;2;96;2.0
8;576;1160;1161;1;96;2.0
8;577;1161;1169;8;96;2.0
8;578;1169;1171;2;96;2.0
8;579;1171;1172;1;96;2.0
8;580;1172;1174;2;96;2.0
8;581;1174;1177;3;96;2.0
8;582;1177;1178;1;96;2.0
8;583;1178;1180;2;96;2.0
8;584;1180;1181;1;96;2.0
8;585;1181;1182;1;96;2.0
8;586;1182;1185;3;96;2.0
8;587;1185;1186;1;96;2.0
8;588;1186;1190;4;96;2.0
8;589;1190;1194;4;96;2.0
8;590;1194;1196;2;96;2.0
8;591;1196;1200;4;96;2.0
8;592;1200;1201;1;96;2.0
8;593;1201;1202;1;96;2.0
8;594;1202;1203;1;96;2.0
8;595;1203;1206;3;96;2.0
8;596;1206;1208;2;96;2.0
8;597;1208;1209;1;96;2.0
8;598;1209;1211;2;96;2.0
8;599;1211;1214;3;96;2.0
8;600;1214;1218;4;96;2.0
8;601;1218;1222;4;96;2.0
8;602;1222;1223;1;96;2.0
8;603;1223;1224;1;96;2.0
8;604;1224;1225;1;96;2.0
8;605;1225;1226;1;96;2.0
8;606;1226;1228;2;96;2.0
8;607;1228;1231;3;96;2.0
8;608;1231;1232;1;96;2.0
8;609;1232;1234;2;96;2.0
8;610;1234;1237;3;96;2.0
8;611;1237;1248;11;96;2.0
8;612;1248;1250;2;96;2.0
8;613;1250;1251;1;96;2.0
8;614;1251;1252;1;96;2.0
8;615;1252;1253;1;96;2.0
8;616;1253;1257;4;96;2.0
8;617;1257;1259;2;96;2.0
8;618;1259;1262;3;96;2.0
8;619;1262;1263;1;96;2.0
8;620;1263;1264;1;96;2.0
8;621;1264;1265;1;96;2.0
8;622;1265;1266;1;96;2.0
8;623;1266;1268;2;96;2.0
8;624;1268;1269;1;96;2.0
8;625;1269;1271;2;96;2.0
8;626;1271;1272;1;96;2.0
8;627;1272;1273;1;96;2.0
8;628;1273;1275;2;96;2.0
8;629;1275;1276;1;96;2.0
8;630;1276;1281;5;96;2.0
8;631;1281;1282;1;96;2.0
8;632;1282;1283;1;96;2.0
8;633;1283;1284;1;96;2.0
8;634;1284;1292;8;96;2.0
8;635;1292;1297;5;96;2.0
8;636;1297;1300;3;96;2.0
8;637;1300;1301;1;96;2.0
8;638;1301;1306;5;96;2.0
8;639;1306;1307;1;96;2.0
8;640;1307;1308;1;96;2.0
8;641;1308;1309;1;96;2.0
8;642;1309;1311;2;96;2.0
8;643;1311;1313;2;96;2.0
8;644;1313;1315;2;96;2.0
8;645;1315;1321;6;96;2.0
8;646;1321;1322;1;96;2.0
8;647;1322;1323;1;96;2.0
8;648;1323;1324;1;96;2.0
8;649;1324;1326;2;96;2.0
8;650;1326;1328;2;96;2.0
8;651;1328;1330;2;96;2.0
8;652;1330;1333;3;96;2.0
8;653;1333;1334;1;96;2.0
8;654;1334;1338;4;96;2.0
8;655;1338;1339;1;96;2.0
8;656;1339;1341;2;96;2.0
8;657;1341;1342;1;96;2.0
8;658;1342;1343;1;96;2.0
8;659;1343;1345;2;96;2.0
8;660;1345;1346;1;96;2.0
8;661;1346;1350;4;96;2.0
8;662;1350;1358;8;96;2.0
8;663;1358;1361;3;96;2.0
8;664;1361;1362;1;96;2.0
8;665;1362;1364;2;96;2.0
8;666;1364;1365;1;96;2.0
8;667;1365;1366;1;96;2.0
8;668;1366;1367;1;96;2.0
8;669;1367;1371;4;96;2.0
8;670;1371;1374;3;96;2.0
8;671;1374;1375;1;96;2.0
8;672;1375;1377;2;96;2.0
8;673;1377;1379;2;96;2.0
8;674;1379;1380;1;96;2.0
8;675;1380;1383;3;96;2.0
8;676;1383;1386;3;96;2.0
8;677;1386;1387;1;96;2.0
8;678;1387;1388;1;96;2.0
8;679;1388;1395;7;96;2.0
8;680;1395;1410;15;96;2.0
8;681;1410;1425;15;96;2.0
8;682;1425;1440;15;96;2.0
8;683;1440;1455;15;96;2.0
8;684;1455;1470;15;96;2.0
8;685;1470;1485;15;96;2.0
8;686;1485;1500;15;96;2.0
8;687;1500;1515;15;96;2.0
8;688;1515;1530;15;96;2.0
8;689;1530;1545;15;96;2.0
8;690;1545;1560;15;96;2.0
8;691;1560;1575;15;96;2.0
8;692;1575;1590;15;96;2.0
8;693;1590;1605;15;96;2.0
8;694;1605;1620;15;96;2.0
8;695;1620;1635;15;96;2.0
8;696;1635;1650;15;96;2.0
8;697;1650;1665;15;96;2.0
8;698;1665;1680;15;96;2.0
9;0;240;282;42;28;2.0
9;1;282;325;43;28;2.0
9;2;325;326;1;28;2.0
9;3;326;329;3;28;2.0
9;4;329;330;1;28;2.0
9;5;330;331;1;28;2.0
9;6;331;333;2;28;2.0
9;7;333;334;1;28;2.0
9;8;334;336;2;28;2.0
9;9;336;337;1;28;2.0
9;10;337;338;1;28;2.0
9;11;338;339;1;28;2.0
9;12;339;342;3;28;2.0
9;13;342;344;2;28;2.0
9;14;344;345;1;28;2.0
9;15;345;346;1;28;2.0
9;16;346;348;2;28;2.0
9;17;348;349;1;28;2.0
9;18;349;351;2;28;2.0
9;19;351;352;1;28;2.0
9;20;352;353;1;28;2.0
9;21;353;354;1;28;2.0
9;22;354;355;1;28;2.0
9;23;355;356;1;28;2.0
9;24;356;357;1;28;2.0
9;25;357;358;1;28;2.0
9;26;358;360;2;28;2.0
9;27;360;361;1;28;2.0
9;28;361;362;1;28;2.0
9;29;362;365;3;28;2.0
9;30;365;366;1;28;2.0
9;31;366;367;1;28;2.0
9;32;367;368;1;28;2.0
9;33;368;369;1;28;2.0
9;34;369;371;2;28;2.0
9;35;371;375;4;28;2.0
9;36;375;377;2;28;2.0
9;37;377;378;1;28;2.0
9;38;378;379;1;28;2.0
9;39;379;380;1;28;2.0
9;40;380;381;1;28;2.0
9;41;381;382;1;28;2.0
9;42;382;383;1;28;2.0
9;43;383;384;1;28;2.0
9;44;384;385;1;28;2.0
9;45;385;387;2;28;2.0
9;46;387;388;1;28;2.0
9;47;388;391;3;28;2.0
9;48;391;392;1;28;2.0
9;49;392;393;1;28;2.0
9;50;393;394;1;28;2.0
9;51;394;395;1;28;2.0
9;52;395;396;1;28;2.0
9;53;396;397;1;28;2.0
9;54;397;398;1;28;2.0
9;55;398;399;1;28;2.0
9;56;399;401;2;28;2.0
9;57;401;403;2;28;2.0
9;58;403;404;1;28;2.0
9;59;404;405;1;28;2.0
9;60;405;406;1;28;2.0
9;61;406;408;2;28;2.0
9;62;408;409;1;28;2.0
9;63;409;412;3;28;2.0
9;64;412;413;1;28;2.0
9;65;413;415;2;28;2.0
9;66;415;416;1;28;2.0
9;67;416;417;1;28;2.0
9;68;417;418;1;28;2.0
9;69;418;419;1;28;2.0
9;70;419;420;1;28;2.0
9;71;420;421;1;28;2.0
9;72;421;422;1;28;2.0
9;73;422;423;1;28;2.0
9;74;423;425;2;28;2.0
9;75;425;427;2;28;2.0
9;76;427;428;1;28;2.0
9;77;428;429;1;28;2.0
9;78;429;431;2;28;2.0
9;79;431;432;1;28;2.0
9;80;432;433;1;28;2.0
9;81;433;435;2;28;2.0
9;82;435;436;1;28;2.0
9;83;436;438;2;28;2.0
9;84;438;439;1;28;2.0
9;85;439;442;3;28;2.0
9;86;442;443;1;28;2.0
9;87;443;444;1;28;2.0
9;88;444;445;1;28;2.0
9;89;445;446;1;28;2.0
9;90;446;447;1;28;2.0
9;91;447;448;1;28;2.0
9;92;448;450;2;28;2.0
9;93;450;451;1;28;2.0
9;94;451;452;1;28;2.0
9;95;452;453;1;28;2.0
9;96;453;454;1;28;2.0
9;97;454;455;1;28;2.0
9;98;455;457;2;28;2.0
9;99;457;458;1;28;2.0
9;100;458;459;1;28;2.0
9;101;459;462;3;28;2.0
9;102;462;463;1;28;2.0
9;103;463;465;2;28;2.0
9;104;465;466;1;28;2.0
9;105;466;467;1;28;2.0
9;106;467;468;1;28;2.0
9;107;468;469;1;28;2.0
9;108;469;471;2;28;2.0
9;109;471;472;1;28;2.0
9;110;472;473;1;28;2.0
9;111;473;475;2;28;2.0
9;112;475;476;1;28;2.0
9;113;476;478;2;28;2.0
9;114;478;479;1;28;2.0
9;115;479;480;1;28;2.0
9;116;480;481;1;28;2.0
9;117;481;482;1;28;2.0
9;118;482;483;1;28;2.0
9;119;483;484;1;28;2.0
9;120;484;485;1;28;2.0
9;121;485;488;3;28;2.0
9;122;488;489;1;28;2.0
9;123;489;492;3;28;2.0
9;124;492;493;1;28;2.0
9;125;493;494;1;28;2.0
9;126;494;495;1;28;2.0
9;127;495;496;1;28;2.0
9;128;496;498;2;28;2.0
9;129;498;499;1;28;2.0
9;130;499;501;2;28;2.0
9;131;501;503;2;28;2.0
9;132;503;504;1;28;2.0
9;133;504;505;1;28;2.0
9;134;505;508;3;28;2.0
9;135;508;512;4;28;2.0
9;136;512;513;1;28;2.0
9;137;513;514;1;28;2.0
9;138;514;515;1;28;2.0
9;139;515;517;2;28;2.0
9;140;517;518;1;28;2.0
9;141;518;519;1;28;2.0
9;142;519;520;1;28;2.0
9;143;520;521;1;28;2.0
9;144;521;522;1;28;2.0
9;145;522;523;1;28;2.0
9;146;523;525;2;28;2.0
9;147;525;528;3;28;2.0
9;148;528;529;1;28;2.0
9;149;529;531;2;28;2.0
9;150;531;532;1;28;2.0
9;151;532;533;1;28;2.0
9;152;533;537;4;28;2.0
9;153;537;538;1;28;2.0
9;154;538;539;1;28;2.0
9;155;539;540;1;28;2.0
9;156;540;543;3;28;2.0
9;157;543;544;1;28;2.0
9;158;544;545;1;28;2.0
9;159;545;547;2;28;2.0
9;160;547;548;1;28;2.0
9;161;548;549;1;28;2.0
9;162;549;550;1;28;2.0
9;163;550;553;3;28;2.0
9;164;553;555;2;28;2.0
9;165;555;556;1;28;2.0
9;166;556;557;1;28;2.0
9;167;557;558;1;28;2.0
9;168;558;559;1;28;2.0
9;169;559;563;4;28;2.0
9;170;563;565;2;28;2.0
9;171;565;568;3;28;2.0
9;172;568;569;1;28;2.0
9;173;569;572;3;28;2.0
9;174;572;574;2;28;2.0
9;175;574;576;2;28;2.0
9;176;576;577;1;28;2.0
9;177;577;578;1;28;2.0
9;178;578;579;1;28;2.0
9;179;579;583;4;28;2.0
9;180;583;585;2;28;2.0
9;181;585;588;3;28;2.0
9;182;588;590;2;28;2.0
9;183;590;591;1;28;2.0
9;184;591;592;1;28;2.0
9;185;592;593;1;28;2.0
9;186;593;595;2;28;2.0
9;187;595;597;2;28;2.0
9;188;597;598;1;28;2.0
9;189;598;599;1;28;2.0
9;190;599;603;4;28;2.0
9;191;603;605;2;28;2.0
9;192;605;607;2;28;2.0
9;193;607;608;1;28;2.0
9;194;608;609;1;28;2.0
9;195;609;615;6;28;2.0
9;196;615;617;2;28;2.0
9;197;617;618;1;28;2.0
9;198;618;619;1;28;2.0
9;199;619;623;4;28;2.0
9;200;623;625;2;28;2.0
9;201;625;627;2;28;2.0
9;202;627;628;1;28;2.0
9;203;628;629;1;28;2.0
9;204;629;632;3;28;2.0
9;205;632;633;1;28;2.0
9;206;633;637;4;28;2.0
9;207;637;638;1;28;2.0
9;208;638;639;1;28;2.0
9;209;639;643;4;28;2.0
9;210;643;645;2;28;2.0
9;211;645;648;3;28;2.0
9;212;648;651;3;28;2.0
9;213;651;652;1;28;2.0
9;214;652;653;1;28;2.0
9;215;653;655;2;28;2.0
9;216;655;656;1;28;2.0
9;217;656;657;1;28;2.0
9;218;657;658;1;28;2.0
9;219;658;659;1;28;2.0
9;220;659;660;1;28;2.0
9;221;660;663;3;28;2.0
9;222;663;665;2;28;2.0
9;223;665;666;1;28;2.0
9;224;666;668;2;28;2.0
9;225;668;669;1;28;2.0
9;226;669;671;2;28;2.0
9;227;671;673;2;28;2.0
9;228;673;677;4;28;2.0
9;229;677;678;1;28;2.0
9;230;678;679;1;28;2.0
9;231;679;681;2;28;2.0
9;232;681;683;2;28;2.0
9;233;683;685;2;28;2.0
9;234;685;688;3;28;2.0
9;235;688;689;1;28;2.0
9;236;689;692;3;28;2.0
9;237;692;693;1;28;2.0
9;238;693;695;2;28;2.0
9;239;695;697;2;28;2.0
9;240;697;698;1;28;2.0
9;241;698;699;1;28;2.0
9;242;699;700;1;28;2.0
9;243;700;703;3;28;2.0
9;244;703;704;1;28;2.0
9;245;704;705;1;28;2.0
9;246;705;707;2;28;2.0
9;247;707;708;1;28;2.0
9;248;708;712;4;28;2.0
9;249;712;713;1;28;2.0
9;250;713;715;2;28;2.0
9;251;715;717;2;28;2.0
9;252;717;718;1;28;2.0
9;253;718;719;1;28;2.0
9;254;719;721;2;28;2.0
9;255;721;723;2;28;2.0
9;256;723;725;2;28;2.0
9;257;725;728;3;28;2.0
9;258;728;729;1;28;2.0
9;259;729;735;6;28;2.0
9;260;735;736;1;28;2.0
9;261;736;737;1;28;2.0
9;262;737;738;1;28;2.0
9;263;738;739;1;28;2.0
9;264;739;743;4;28;2.0
9;265;743;745;2;28;2.0
9;266;745;746;1;28;2.0
9;267;746;748;2;28;2.0
9;268;748;749;1;28;2.0
9;269;749;752;3;28;2.0
9;270;752;757;5;28;2.0
9;271;757;758;1;28;2.0
9;272;758;759;1;28;2.0
9;273;759;760;1;28;2.0
9;274;760;763;3;28;2.0
9;275;763;765;2;28;2.0
9;276;765;766;1;28;2.0
9;277;766;768;2;28;2.0
9;278;768;772;4;28;2.0
9;279;772;773;1;28;2.0
9;280;773;774;1;28;2.0
9;281;774;775;1;28;2.0
9;282;775;777;2;28;2.0
9;283;777;778;1;28;2.0
9;284;778;779;1;28;2.0
9;285;779;783;4;28;2.0
9;286;783;784;1;28;2.0
9;287;784;785;1;28;2.0
9;288;785;788;3;28;2.0
9;289;788;789;1;28;2.0
9;290;789;792;3;28;2.0
9;291;792;793;1;28;2.0
9;292;793;795;2;28;2.0
9;293;795;797;2;28;2.0
9;294;797;798;1;28;2.0
9;295;798;799;1;28;2.0
9;296;799;800;1;28;2.0
9;297;800;801;1;28;2.0
9;298;801;803;2;28;2.0
9;299;803;804;1;28;2.0
9;300;804;805;1;28;2.0
9;301;805;806;1;28;2.0
9;302;806;808;2;28;2.0
9;303;808;812;4;28;2.0
9;304;812;814;2;28;2.0
9;305;814;815;1;28;2.0
9;306;815;817;2;28;2.0
9;307;817;818;1;28;2.0
9;308;818;819;1;28;2.0
9;309;819;820;1;28;2.0
9;310;820;821;1;28;2.0
9;311;821;823;2;28;2.0
9;312;823;825;2;28;2.0
9;313;825;828;3;28;2.0
9;314;828;829;1;28;2.0
9;315;829;830;1;28;2.0
9;316;830;832;2;28;2.0
9;317;832;833;1;28;2.0
9;318;833;834;1;28;2.0
9;319;834;835;1;28;2.0
9;320;835;836;1;28;2.0
9;321;836;837;1;28;2.0
9;322;837;838;1;28;2.0
9;323;838;839;1;28;2.0
9;324;839;841;2;28;2.0
9;325;841;843;2;28;2.0
9;326;843;845;2;28;2.0
9;327;845;847;2;28;2.0
9;328;847;848;1;28;2.0
9;329;848;849;1;28;2.0
9;330;849;850;1;28;2.0
9;331;850;852;2;28;2.0
9;332;852;854;2;28;2.0
9;333;854;855;1;28;2.0
9;334;855;857;2;28;2.0
9;335;857;858;1;28;2.0
9;336;858;859;1;28;2.0
9;337;859;861;2;28;2.0
9;338;861;862;1;28;2.0
9;339;862;863;1;28;2.0
9;340;863;865;2;28;2.0
9;341;865;866;1;28;2.0
9;342;866;868;2;28;2.0
9;343;868;869;1;28;2.0
9;344;869;870;1;28;2.0
9;345;870;871;1;28;2.0
9;346;871;872;1;28;2.0
9;347;872;873;1;28;2.0
9;348;873;875;2;28;2.0
9;349;875;876;1;28;2.0
9;350;876;877;1;28;2.0
9;351;877;878;1;28;2.0
9;352;878;879;1;28;2.0
9;353;879;880;1;28;2.0
9;354;880;883;3;28;2.0
9;355;883;885;2;28;2.0
9;356;885;887;2;28;2.0
9;357;887;888;1;28;2.0
9;358;888;889;1;28;2.0
9;359;889;892;3;28;2.0
9;360;892;893;1;28;2.0
9;361;893;895;2;28;2.0
9;362;895;897;2;28;2.0
9;363;897;898;1;28;2.0
9;364;898;899;1;28;2.0
9;365;899;901;2;28;2.0
9;366;901;902;1;28;2.0
9;367;902;903;1;28;2.0
9;368;903;905;2;28;2.0
9;369;905;907;2;28;2.0
9;370;907;908;1;28;2.0
9;371;908;909;1;28;2.0
9;372;909;910;1;28;2.0
9;373;910;911;1;28;2.0
9;374;911;912;1;28;2.0
9;375;912;913;1;28;2.0
9;376;913;915;2;28;2.0
9;377;915;917;2;28;2.0
9;378;917;918;1;28;2.0
9;379;918;919;1;28;2.0
9;380;919;920;1;28;2.0
9;381;920;922;2;28;2.0
9;382;922;923;1;28;2.0
9;383;923;925;2;28;2.0
9;384;925;926;1;28;2.0
9;385;926;928;2;28;2.0
9;386;928;929;1;28;2.0
9;387;929;931;2;28;2.0
9;388;931;932;1;28;2.0
9;389;932;933;1;28;2.0
9;390;933;935;2;28;2.0
9;391;935;937;2;28;2.0
9;392;937;938;1;28;2.0
9;393;938;939;1;28;2.0
9;394;939;940;1;28;2.0
9;395;940;942;2;28;2.0
9;396;942;943;1;28;2.0
9;397;943;945;2;28;2.0
9;398;945;947;2;28;2.0
9;399;947;948;1;28;2.0
9;400;948;949;1;28;2.0
9;401;949;952;3;28;2.0
9;402;952;953;1;28;2.0
9;403;953;955;2;28;2.0
9;404;955;956;1;28;2.0
9;405;956;957;1;28;2.0
9;406;957;958;1;28;2.0
9;407;958;959;1;28;2.0
9;408;959;962;3;28;2.0
9;409;962;963;1;28;2.0
9;410;963;965;2;28;2.0
9;411;965;966;1;28;2.0
9;412;966;967;1;28;2.0
9;413;967;968;1;28;2.0
9;414;968;969;1;28;2.0
9;415;969;970;1;28;2.0
9;416;970;972;2;28;2.0
9;417;972;973;1;28;2.0
9;418;973;975;2;28;2.0
9;419;975;977;2;28;2.0
9;420;977;978;1;28;2.0
9;421;978;979;1;28;2.0
9;422;979;980;1;28;2.0
9;423;980;981;1;28;2.0
9;424;981;983;2;28;2.0
9;425;983;985;2;28;2.0
9;426;985;988;3;28;2.0
9;427;988;989;1;28;2.0
9;428;989;992;3;28;2.0
9;429;992;993;1;28;2.0
9;430;993;995;2;28;2.0
9;431;995;997;2;28;2.0
9;432;997;998;1;28;2.0
9;433;998;999;1;28;2.0
9;434;999;1000;1;28;2.0
9;435;1000;1002;2;28;2.0
9;436;1002;1003;1;28;2.0
9;437;1003;1005;2;28;2.0
9;438;1005;1007;2;28;2.0
9;439;1007;1008;1;28;2.0
9;440;1008;1009;1;28;2.0
9;441;1009;1011;2;28;2.0
9;442;1011;1012;1;28;2.0
9;443;1012;1014;2;28;2.0
9;444;1014;1015;1;28;2.0
9;445;1015;1017;2;28;2.0
9;446;1017;1018;1;28;2.0
9;447;1018;1019;1;28;2.0
9;448;1019;1020;1;28;2.0
9;449;1020;1021;1;28;2.0
9;450;1021;1023;2;28;2.0
9;451;1023;1026;3;28;2.0
9;452;1026;1027;1;28;2.0
9;453;1027;1028;1;28;2.0
9;454;1028;1029;1;28;2.0
9;455;1029;1030;1;28;2.0
9;456;1030;1032;2;28;2.0
9;457;1032;1033;1;28;2.0
9;458;1033;1037;4;28;2.0
9;459;1037;1038;1;28;2.0
9;460;1038;1039;1;28;2.0
9;461;1039;1041;2;28;2.0
9;462;1041;1043;2;28;2.0
9;463;1043;1044;1;28;2.0
9;464;1044;1045;1;28;2.0
9;465;1045;1047;2;28;2.0
9;466;1047;1048;1;28;2.0
9;467;1048;1049;1;28;2.0
9;468;1049;1053;4;28;2.0
9;469;1053;1055;2;28;2.0
9;470;1055;1057;2;28;2.0
9;471;1057;1058;1;28;2.0
9;472;1058;1059;1;28;2.0
9;473;1059;1060;1;28;2.0
9;474;1060;1062;2;28;2.0
9;475;1062;1063;1;28;2.0
9;476;1063;1065;2;28;2.0
9;477;1065;1067;2;28;2.0
9;478;1067;1068;1;28;2.0
9;479;1068;1069;1;28;2.0
9;480;1069;1071;2;28;2.0
9;481;1071;1075;4;28;2.0
9;482;1075;1076;1;28;2.0
9;483;1076;1077;1;28;2.0
9;484;1077;1078;1;28;2.0
9;485;1078;1079;1;28;2.0
9;486;1079;1083;4;28;2.0
9;487;1083;1084;1;28;2.0
9;488;1084;1085;1;28;2.0
9;489;1085;1087;2;28;2.0
9;490;1087;1088;1;28;2.0
9;491;1088;1089;1;28;2.0
9;492;1089;1090;1;28;2.0
9;493;1090;1093;3;28;2.0
9;494;1093;1094;1;28;2.0
9;495;1094;1095;1;28;2.0
9;496;1095;1097;2;28;2.0
9;497;1097;1098;1;28;2.0
9;498;1098;1100;2;28;2.0
9;499;1100;1101;1;28;2.0
9;500;1101;1103;2;28;2.0
9;501;1103;1105;2;28;2.0
9;502;1105;1107;2;28;2.0
9;503;1107;1108;1;28;2.0
9;504;1108;1109;1;28;2.0
9;505;1109;1110;1;28;2.0
9;506;1110;1111;1;28;2.0
9;507;1111;1112;1;28;2.0
9;508;1112;1113;1;28;2.0
9;509;1113;1117;4;28;2.0
9;510;1117;1120;3;28;2.0
9;511;1120;1121;1;28;2.0
9;512;1121;1125;4;28;2.0
9;513;1125;1128;3;28;2.0
9;514;1128;1132;4;28;2.0
9;515;1132;1134;2;28;2.0
9;516;1134;1137;3;28;2.0
9;517;1137;1139;2;28;2.0
9;518;1139;1140;1;28;2.0
9;519;1140;1141;1;28;2.0
9;520;1141;1142;1;28;2.0
9;521;1142;1145;3;28;2.0
9;522;1145;1147;2;28;2.0
9;523;1147;1150;3;28;2.0
9;524;1150;1152;2;28;2.0
9;525;1152;1153;1;28;2.0
9;526;1153;1155;2;28;2.0
9;527;1155;1157;2;28;2.0
9;528;1157;1160;3;28;2.0
9;529;1160;1162;2;28;2.0
9;530;1162;1170;8;28;2.0
9;531;1170;1171;1;28;2.0
9;532;1171;1174;3;28;2.0
9;533;1174;1175;1;28;2.0
9;534;1175;1176;1;28;2.0
9;535;1176;1177;1;28;2.0
9;536;1177;1178;1;28;2.0
9;537;1178;1180;2;28;2.0
9;538;1180;1181;1;28;2.0
9;539;1181;1182;1;28;2.0
9;540;1182;1186;4;28;2.0
9;541;1186;1188;2;28;2.0
9;542;1188;1189;1;28;2.0
9;543;1189;1195;6;28;2.0
9;544;1195;1197;2;28;2.0
9;545;1197;1199;2;28;2.0
9;546;1199;1200;1;28;2.0
9;547;1200;1202;2;28;2.0
9;548;1202;1205;3;28;2.0
9;549;1205;1209;4;28;2.0
9;550;1209;1210;1;28;2.0
9;551;1210;1215;5;28;2.0
9;552;1215;1217;2;28;2.0
9;553;1217;1221;4;28;2.0
9;554;1221;1222;1;28;2.0
9;555;1222;1223;1;28;2.0
9;556;1223;1225;2;28;2.0
9;557;1225;1226;1;28;2.0
9;558;1226;1227;1;28;2.0
9;559;1227;1228;1;28;2.0
9;560;1228;1230;2;28;2.0
9;561;1230;1231;1;28;2.0
9;562;1231;1232;1;28;2.0
9;563;1232;1235;3;28;2.0
9;564;1235;1237;2;28;2.0
9;565;1237;1247;10;28;2.0
9;566;1247;1250;3;28;2.0
9;567;1250;1252;2;28;2.0
9;568;1252;1253;1;28;2.0
9;569;1253;1256;3;28;2.0
9;570;1256;1258;2;28;2.0
9;571;1258;1260;2;28;2.0
9;572;1260;1262;2;28;2.0
9;573;1262;1263;1;28;2.0
9;574;1263;1266;3;28;2.0
9;575;1266;1267;1;28;2.0
9;576;1267;1268;1;28;2.0
9;577;1268;1269;1;28;2.0
9;578;1269;1271;2;28;2.0
9;579;1271;1272;1;28;2.0
9;580;1272;1275;3;28;2.0
9;581;1275;1277;2;28;2.0
9;582;1277;1280;3;28;2.0
9;583;1280;1281;1;28;2.0
9;584;1281;1282;1;28;2.0
9;585;1282;1284;2;28;2.0
9;586;1284;1285;1;28;2.0
9;587;1285;1291;6;28;2.0
9;588;1291;1296;5;28;2.0
9;589;1296;1299;3;28;2.0
9;590;1299;1300;1;28;2.0
9;591;1300;1302;2;28;2.0
9;592;1302;1305;3;28;2.0
9;593;1305;1307;2;28;2.0
9;594;1307;1309;2;28;2.0
9;595;1309;1310;1;28;2.0
9;596;1310;1312;2;28;2.0
9;597;1312;1316;4;28;2.0
9;598;1316;1321;5;28;2.0
9;599;1321;1322;1;28;2.0
9;600;1322;1323;1;28;2.0
9;601;1323;1326;3;28;2.0
9;602;1326;1327;1;28;2.0
9;603;1327;1330;3;28;2.0
9;604;1330;1332;2;28;2.0
9;605;1332;1334;2;28;2.0
9;606;1334;1335;1;28;2.0
9;607;1335;1337;2;28;2.0
9;608;1337;1338;1;28;2.0
9;609;1338;1341;3;28;2.0
9;610;1341;1342;1;28;2.0
9;611;1342;1344;2;28;2.0
9;612;1344;1345;1;28;2.0
9;613;1345;1347;2;28;2.0
9;614;1347;1350;3;28;2.0
9;615;1350;1357;7;28;2.0
9;616;1357;1360;3;28;2.0
9;617;1360;1362;2;28;2.0
9;618;1362;1363;1;28;2.0
9;619;1363;1364;1;28;2.0
9;620;1364;1365;1;28;2.0
9;621;1365;1366;1;28;2.0
9;622;1366;1371;5;28;2.0
9;623;1371;1374;3;28;2.0
9;624;1374;1376;2;28;2.0
9;625;1376;1378;2;28;2.0
9;626;1378;1379;1;28;2.0
9;627;1379;1380;1;28;2.0
9;628;1380;1382;2;28;2.0
9;629;1382;1385;3;28;2.0
9;630;1385;1386;1;28;2.0
9;631;1386;1387;1;28;2.0
9;632;1387;1394;7;28;2.0
9;633;1394;1409;15;28;2.0
9;634;1409;1424;15;28;2.0
9;635;1424;1439;15;28;2.0
9;636;1439;1454;15;28;2.0
9;637;1454;1469;15;28;2.0
9;638;1469;1484;15;28;2.0
9;639;1484;1499;15;28;2.0
9;640;1499;1514;15;28;2.0
9;641;1514;1529;15;28;2.0
9;642;1529;1544;15;28;2.0
9;643;1544;1559;15;28;2.0
9;644;1559;1574;15;28;2.0
9;645;1574;1589;15;28;2.0
9;646;1589;1604;15;28;2.0
9;647;1604;1619;15;28;2.0
9;648;1619;1634;15;28;2.0
9;649;1634;1649;15;28;2.0
9;650;1649;1664;15;28;2.0
9;651;1664;1679;15;28;2.0
9;652;1679;1680;1;28;2.0
10;0;240;282;42;28;2.0
10;1;282;325;43;28;2.0
10;2;325;326;1;28;2.0
10;3;326;329;3;28;2.0
10;4;329;330;1;28;2.0
10;5;330;331;1;28;2.0
10;6;331;333;2;28;2.0
10;7;333;334;1;28;2.0
10;8;334;336;2;28;2.0
10;9;336;337;1;28;2.0
10;10;337;338;1;28;2.0
10;11;338;339;1;28;2.0
10;12;339;342;3;28;2.0
10;13;342;344;2;28;2.0
10;14;344;345;1;28;2.0
10;15;345;346;1;28;2.0
10;16;346;348;2;28;2.0
10;17;348;349;1;28;2.0
10;18;349;351;2;28;2.0
10;19;351;352;1;28;2.0
10;20;352;353;1;28;2.0
10;21;353;354;1;28;2.0
10;22;354;355;1;28;2.0
10;23;355;356;1;28;2.0
10;24;356;357;1;28;2.0
10;25;357;358;1;28;2.0
10;26;358;360;2;28;2.0
10;27;360;361;1;28;2.0
10;28;361;362;1;28;2.0
10;29;362;365;3;28;2.0
10;30;365;366;1;28;2.0
10;31;366;367;1;28;2.0
10;32;367;368;1;28;2.0
10;33;368;369;1;28;2.0
10;34;369;371;2;28;2.0
10;35;371;375;4;28;2.0
10;36;375;377;2;28;2.0
10;37;377;378;1;28;2.0
10;38;378;379;1;28;2.0
10;39;379;380;1;28;2.0
10;40;380;381;1;28;2.0
10;41;381;382;1;28;2.0
10;42;382;383;1;28;2.0
10;43;383;384;1;28;2.0
10;44;384;385;1;28;2.0
10;45;385;387;2;28;2.0
10;46;387;388;1;28;2.0
10;47;388;391;3;28;2.0
10;48;391;392;1;28;2.0
10;49;392;393;1;28;2.0
10;50;393;394;1;28;2.0
10;51;394;395;1;28;2.0
10;52;395;396;1;28;2.0
10;53;396;397;1;28;2.0
10;54;397;398;1;28;2.0
10;55;398;399;1;28;2.0
10;56;399;401;2;28;2.0
10;57;401;403;2;28;2.0
10;58;403;404;1;28;2.0
10;59;404;405;1;28;2.0
10;60;405;406;1;28;2.0
10;61;406;408;2;28;2.0
10;62;408;409;1;28;2.0
10;63;409;412;3;28;2.0
10;64;412;413;1;28;2.0
10;65;413;415;2;28;2.0
10;66;415;416;1;28;2.0
10;67;416;417;1;28;2.0
10;68;417;418;1;28;2.0
10;69;418;419;1;28;2.0
10;70;419;420;1;28;2.0
10;71;420;421;1;28;2.0
10;72;421;422;1;28;2.0
10;73;422;423;1;28;2.0
10;74;423;425;2;28;2.0
10;75;425;427;2;28;2.0
10;76;427;428;1;28;2.0
10;77;428;429;1;28;2.0
10;78;429;431;2;28;2.0
10;79;431;432;1;28;2.0
10;80;432;433;1;28;2.0
10;81;433;435;2;28;2.0
10;82;435;436;1;28;2.0
10;83;436;438;2;28;2.0
10;84;438;439;1;28;2.0
10;85;439;442;3;28;2.0
10;86;442;443;1;28;2.0
10;87;443;444;1;28;2.0
10;88;444;445;1;28;2.0
10;89;445;446;1;28;2.0
10;90;446;447;1;28;2.0
10;91;447;448;1;28;2.0
10;92;448;450;2;28;2.0
10;93;450;451;1;28;2.0
10;94;451;452;1;28;2.0
10;95;452;453;1;28;2.0
10;96;453;454;1;28;2.0
10;97;454;455;1;28;2.0
10;98;455;457;2;28;2.0
10;99;457;458;1;28;2.0
10;100;458;459;1;28;2.0
10;101;459;462;3;28;2.0
10;102;462;463;1;28;2.0
10;103;463;465;2;28;2.0
10;104;465;466;1;28;2.0
10;105;466;467;1;28;2.0
10;106;467;468;1;28;2.0
10;107;468;469;1;28;2.0
10;108;469;471;2;28;2.0
10;109;471;472;1;28;2.0
10;110;472;473;1;28;2.0
10;111;473;475;2;28;2.0
10;112;475;476;1;28;2.0
10;113;476;478;2;28;2.0
10;114;478;479;1;28;2.0
10;115;479;480;1;28;2.0
10;116;480;481;1;28;2.0
10;117;481;482;1;28;2.0
10;118;482;483;1;28;2.0
10;119;483;484;1;28;2.0
10;120;484;485;1;28;2.0
10;121;485;488;3;28;2.0
10;122;488;489;1;28;2.0
10;123;489;492;3;28;2.0
10;124;492;493;1;28;2.0
10;125;493;494;1;28;2.0
10;126;494;495;1;28;2.0
10;127;495;496;1;28;2.0
10;128;496;498;2;28;2.0
10;129;498;499;1;28;2.0
10;130;499;501;2;28;2.0
10;131;501;503;2;28;2.0
10;132;503;504;1;28;2.0
10;133;504;505;1;28;2.0
10;134;505;508;3;28;2.0
10;135;508;512;4;28;2.0
10;136;512;513;1;28;2.0
10;137;513;514;1;28;2.0
10;138;514;515;1;28;2.0
10;139;515;517;2;28;2.0
10;140;517;518;1;28;2.0
10;141;518;519;1;28;2.0
10;142;519;520;1;28;2.0
10;143;520;521;1;28;2.0
10;144;521;522;1;28;2.0
10;145;522;523;1;28;2.0
10;146;523;525;2;28;2.0
10;147;525;528;3;28;2.0
10;148;528;529;1;28;2.0
10;149;529;531;2;28;2.0
10;150;531;532;1;28;2.0
10;151;532;533;1;28;2.0
10;152;533;537;4;28;2.0
10;153;537;538;1;28;2.0
10;154;538;539;1;28;2.0
10;155;539;540;1;28;2.0
10;156;540;543;3;28;2.0
10;157;543;544;1;28;2.0
10;158;544;545;1;28;2.0
10;159;545;547;2;28;2.0
10;160;547;548;1;28;2.0
10;161;548;549;1;28;2.0
10;162;549;550;1;28;2.0
10;163;550;553;3;28;2.0
10;164;553;555;2;28;2.0
10;165;555;556;1;28;2.0
10;166;556;557;1;28;2.0
10;167;557;558;1;28;2.0
10;168;558;559;1;28;2.0
10;169;559;563;4;28;2.0
10;170;563;565;2;28;2.0
10;171;565;568;3;28;2.0
10;172;568;569;1;28;2.0
10;173;569;572;3;28;2.0
10;174;572;574;2;28;2.0
10;175;574;576;2;28;2.0
10;176;576;577;1;28;2.0
10;177;577;578;1;28;2.0
10;178;578;579;1;28;2.0
10;179;579;583;4;28;2.0
10;180;583;585;2;28;2.0
10;181;585;588;3;28;2.0
10;182;588;590;2;28;2.0
10;183;590;591;1;28;2.0
10;184;591;592;1;28;2.0
10;185;592;593;1;28;2.0
10;186;593;595;2;28;2.0
10;187;595;597;2;28;2.0
10;188;597;598;1;28;2.0
10;189;598;599;1;28;2.0
10;190;599;603;4;28;2.0
10;191;603;605;2;28;2.0
10;192;605;607;2;28;2.0
10;193;607;608;1;28;2.0
10;194;608;609;1;28;2.0
10;195;609;615;6;28;2.0
10;196;615;617;2;28;2.0
10;197;617;618;1;28;2.0
10;198;618;619;1;28;2.0
10;199;619;623;4;28;2.0
10;200;623;625;2;28;2.0
10;201;625;627;2;28;2.0
10;202;627;628;1;28;2.0
10;203;628;629;1;28;2.0
10;204;629;632;3;28;2.0
10;205;632;633;1;28;2.0
10;206;633;637;4;28;2.0
10;207;637;638;1;28;2.0
10;208;638;639;1;28;2.0
10;209;639;643;4;28;2.0
10;210;643;645;2;28;2.0
10;211;645;648;3;28;2.0
10;212;648;651;3;28;2.0
10;213;651;652;1;28;2.0
10;214;652;653;1;28;2.0
10;215;653;655;2;28;2.0
10;216;655;656;1;28;2.0
10;217;656;657;1;28;2.0
10;218;657;658;1;28;2.0
10;219;658;659;1;28;2.0
10;220;659;660;1;28;2.0
10;221;660;663;3;28;2.0
10;222;663;665;2;28;2.0
10;223;665;666;1;28;2.0
10;224;666;668;2;28;2.0
10;225;668;669;1;28;2.0
10;226;669;671;2;28;2.0
10;227;671;673;2;28;2.0
10;228;673;677;4;28;2.0
10;229;677;678;1;28;2.0
10;230;678;679;1;28;2.0
10;231;679;681;2;28;2.0
10;232;681;683;2;28;2.0
10;233;683;685;2;28;2.0
10;234;685;688;3;28;2.0
10;235;688;689;1;28;2.0
10;236;689;692;3;28;2.0
10;237;692;693;1;28;2.0
10;238;693;695;2;28;2.0
10;239;695;697;2;28;2.0
10;240;697;698;1;28;2.0
10;241;698;699;1;28;2.0
10;242;699;700;1;28;2.0
10;243;700;703;3;28;2.0
10;244;703;704;1;28;2.0
10;245;704;705;1;28;2.0
10;246;705;707;2;28;2.0
10;247;707;708;1;28;2.0
10;248;708;712;4;28;2.0
10;249;712;713;1;28;2.0
10;250;713;715;2;28;2.0
10;251;715;717;2;28;2.0
10;252;717;718;1;28;2.0
10;253;718;719;1;28;2.0
10;254;719;721;2;28;2.0
10;255;721;723;2;28;2.0
10;256;723;725;2;28;2.0
10;257;725;728;3;28;2.0
10;258;728;729;1;28;2.0
10;259;729;735;6;28;2.0
10;260;735;736;1;28;2.0
10;261;736;737;1;28;2.0
10;262;737;738;1;28;2.0
10;263;738;739;1;28;2.0
10;264;739;743;4;28;2.0
10;265;743;745;2;28;2.0
10;266;745;746;1;28;2.0
10;267;746;748;2;28;2.0
10;268;748;749;1;28;2.0
10;269;749;752;3;28;2.0
10;270;752;757;5;28;2.0
10;271;757;758;1;28;2.0
10;272;758;759;1;28;2.0
10;273;759;760;1;28;2.0
10;274;760;763;3;28;2.0
10;275;763;765;2;28;2.0
10;276;765;766;1;28;2.0
10;277;766;768;2;28;2.0
10;278;768;772;4;28;2.0
10;279;772;773;1;28;2.0
10;280;773;774;1;28;2.0
10;281;774;775;1;28;2.0
10;282;775;777;2;28;2.0
10;283;777;778;1;28;2.0
10;284;778;779;1;28;2.0
10;285;779;783;4;28;2.0
10;286;783;784;1;28;2.0
10;287;784;785;1;28;2.0
10;288;785;788;3;28;2.0
10;289;788;789;1;28;2.0
10;290;789;792;3;28;2.0
10;291;792;793;1;28;2.0
10;292;793;795;2;28;2.0
10;293;795;797;2;28;2.0
10;294;797;798;1;28;2.0
10;295;798;799;1;28;2.0
10;296;799;800;1;28;2.0
10;297;800;801;1;28;2.0
10;298;801;803;2;28;2.0
10;299;803;804;1;28;2.0
10;300;804;805;1;28;2.0
10;301;805;806;1;28;2.0
10;302;806;808;2;28;2.0
10;303;808;812;4;28;2.0
10;304;812;814;2;28;2.0
10;305;814;815;1;28;2.0
10;306;815;817;2;28;2.0
10;307;817;818;1;28;2.0
10;308;818;819;1;28;2.0
10;309;819;820;1;28;2.0
10;310;820;821;1;28;2.0
10;311;821;823;2;28;2.0
10;312;823;825;2;28;2.0
10;313;825;828;3;28;2.0
10;314;828;829;1;28;2.0
10;315;829;830;1;28;2.0
10;316;830;832;2;28;2.0
10;317;832;833;1;28;2.0
10;318;833;834;1;28;2.0
10;319;834;835;1;28;2.0
10;320;835;836;1;28;2.0
10;321;836;837;1;28;2.0
10;322;837;838;1;28;2.0
10;323;838;839;1;28;2.0
10;324;839;841;2;28;2.0
10;325;841;843;2;28;2.0
10;326;843;845;2;28;2.0
10;327;845;847;2;28;2.0
10;328;847;848;1;28;2.0
10;329;848;849;1;28;2.0
10;330;849;850;1;28;2.0
10;331;850;852;2;28;2.0
10;332;852;854;2;28;2.0
10;333;854;855;1;28;2.0
10;334;855;857;2;28;2.0
10;335;857;858;1;28;2.0
10;336;858;859;1;28;2.0
10;337;859;861;2;28;2.0
10;338;861;862;1;28;2.0
10;339;862;863;1;28;2.0
10;340;863;865;2;28;2.0
10;341;865;866;1;28;2.0
10;342;866;868;2;28;2.0
10;343;868;869;1;28;2.0
10;344;869;870;1;28;2.0
10;345;870;871;1;28;2.0
10;346;871;872;1;28;2.0
10;347;872;873;1;28;2.0
10;348;873;875;2;28;2.0
10;349;875;876;1;28;2.0
10;350;876;877;1;28;2.0
10;351;877;878;1;28;2.0
10;352;878;879;1;28;2.0
10;353;879;880;1;28;2.0
10;354;880;883;3;28;2.0
10;355;883;885;2;28;2.0
10;356;885;887;2;28;2.0
10;357;887;888;1;28;2.0
10;358;888;889;1;28;2.0
10;359;889;892;3;28;2.0
10;360;892;893;1;28;2.0
10;361;893;895;2;28;2.0
10;362;895;897;2;28;2.0
10;363;897;898;1;28;2.0
10;364;898;899;1;28;2.0
10;365;899;901;2;28;2.0
10;366;901;902;1;28;2.0
10;367;902;903;1;28;2.0
10;368;903;905;2;28;2.0
10;369;905;907;2;28;2.0
10;370;907;908;1;28;2.0
10;371;908;909;1;28;2.0
10;372;909;910;1;28;2.0
10;373;910;911;1;28;2.0
10;374;911;912;1;28;2.0
10;375;912;913;1;28;2.0
10;376;913;915;2;28;2.0
10;377;915;917;2;28;2.0
10;378;917;918;1;28;2.0
10;379;918;919;1;28;2.0
10;380;919;920;1;28;2.0
10;381;920;922;2;28;2.0
10;382;922;923;1;28;2.0
10;383;923;925;2;28;2.0
10;384;925;926;1;28;2.0
10;385;926;928;2;28;2.0
10;386;928;929;1;28;2.0
10;387;929;931;2;28;2.0
10;388;931;932;1;28;2.0
10;389;932;933;1;28;2.0
10;390;933;935;2;28;2.0
10;391;935;937;2;28;2.0
10;392;937;938;1;28;2.0
10;393;938;939;1;28;2.0
10;394;939;940;1;28;2.0
10;395;940;942;2;28;2.0
10;396;942;943;1;28;2.0
10;397;943;945;2;28;2.0
10;398;945;947;2;28;2.0
10;399;947;948;1;28;2.0
10;400;948;949;1;28;2.0
10;401;949;952;3;28;2.0
10;402;952;953;1;28;2.0
10;403;953;955;2;28;2.0
10;404;955;956;1;28;2.0
10;405;956;957;1;28;2.0
10;406;957;958;1;28;2.0
10;407;958;959;1;28;2.0
10;408;959;962;3;28;2.0
10;409;962;963;1;28;2.0
10;410;963;965;2;28;2.0
10;411;965;966;1;28;2.0
10;412;966;967;1;28;2.0
10;413;967;968;1;28;2.0
10;414;968;969;1;28;2.0
10;415;969;970;1;28;2.0
10;416;970;972;2;28;2.0
10;417;972;973;1;28;2.0
10;418;973;975;2;28;2.0
10;419;975;977;2;28;2.0
10;420;977;978;1;28;2.0
10;421;978;979;1;28;2.0
10;422;979;980;1;28;2.0
10;423;980;981;1;28;2.0
10;424;981;983;2;28;2.0
10;425;983;985;2;28;2.0
10;426;985;988;3;28;2.0
10;427;988;989;1;28;2.0
10;428;989;992;3;28;2.0
10;429;992;993;1;28;2.0
10;430;993;995;2;28;2.0
10;431;995;997;2;28;2.0
10;432;997;998;1;28;2.0
10;433;998;999;1;28;2.0
10;434;999;1000;1;28;2.0
10;435;1000;1002;2;28;2.0
10;436;1002;1003;1;28;2.0
10;437;1003;1005;2;28;2.0
10;438;1005;1007;2;28;2.0
10;439;1007;1008;1;28;2.0
10;440;1008;1009;1;28;2.0
10;441;1009;1011;2;28;2.0
10;442;1011;1012;1;28;2.0
10;443;1012;1014;2;28;2.0
10;444;1014;1015;1;28;2.0
10;445;1015;1017;2;28;2.0
10;446;1017;1018;1;28;2.0
10;447;1018;1019;1;28;2.0
10;448;1019;1020;1;28;2.0
10;449;1020;1021;1;28;2.0
10;450;1021;1023;2;28;2.0
10;451;1023;1026;3;28;2.0
10;452;1026;1027;1;28;2.0
10;453;1027;1028;1;28;2.0
10;454;1028;1029;1;28;2.0
10;455;1029;1030;1;28;2.0
10;456;1030;1032;2;28;2.0
10;457;1032;1033;1;28;2.0
10;458;1033;1037;4;28;2.0
10;459;1037;1038;1;28;2.0
10;460;1038;1039;1;28;2.0
10;461;1039;1041;2;28;2.0
10;462;1041;1043;2;28;2.0
10;463;1043;1044;1;28;2.0
10;464;1044;1045;1;28;2.0
10;465;1045;1047;2;28;2.0
10;466;1047;1048;1;28;2.0
10;467;1048;1049;1;28;2.0
10;468;1049;1053;4;28;2.0
10;469;1053;1055;2;28;2.0
10;470;1055;1057;2;28;2.0
10;471;1057;1058;1;28;2.0
10;472;1058;1059;1;28;2.0
10;473;1059;1060;1;28;2.0
10;474;1060;1062;2;28;2.0
10;475;1062;1063;1;28;2.0
10;476;1063;1065;2;28;2.0
10;477;1065;1067;2;28;2.0
10;478;1067;1068;1;28;2.0
10;479;1068;1069;1;28;2.0
10;480;1069;1071;2;28;2.0
10;481;1071;1075;4;28;2.0
10;482;1075;1076;1;28;2.0
10;483;1076;1077;1;28;2.0
10;484;1077;1078;1;28;2.0
10;485;1078;1079;1;28;2.0
10;486;1079;1083;4;28;2.0
10;487;1083;1084;1;28;2.0
10;488;1084;1085;1;28;2.0
10;489;1085;1087;2;28;2.0
10;490;1087;1088;1;28;2.0
10;491;1088;1089;1;28;2.0
10;492;1089;1090;1;28;2.0
10;493;1090;1093;3;28;2.0
10;494;1093;1094;1;28;2.0
10;495;1094;1095;1;28;2.0
10;496;1095;1097;2;28;2.0
10;497;1097;1098;1;28;2.0
10;498;1098;1100;2;28;2.0
10;499;1100;1101;1;28;2.0
10;500;1101;1103;2;28;2.0
10;501;1103;1105;2;28;2.0
10;502;1105;1107;2;28;2.0
10;503;1107;1108;1;28;2.0
10;504;1108;1109;1;28;2.0
10;505;1109;1110;1;28;2.0
10;506;1110;1111;1;28;2.0
10;507;1111;1112;1;28;2.0
10;508;1112;1113;1;28;2.0
10;509;1113;1117;4;28;2.0
10;510;1117;1120;3;28;2.0
10;511;1120;1121;1;28;2.0
10;512;1121;1125;4;28;2.0
10;513;1125;1128;3;28;2.0
10;514;1128;1132;4;28;2.0
10;515;1132;1134;2;28;2.0
10;516;1134;1137;3;28;2.0
10;517;1137;1139;2;28;2.0
10;518;1139;1140;1;28;2.0
10;519;1140;1141;1;28;2.0
10;520;1141;1142;1;28;2.0
10;521;1142;1145;3;28;2.0
10;522;1145;1147;2;28;2.0
10;523;1147;1150;3;28;2.0
10;524;1150;1152;2;28;2.0
10;525;1152;1153;1;28;2.0
10;526;1153;1155;2;28;2.0
10;527;1155;1157;2;28;2.0
10;528;1157;1160;3;28;2.0
10;529;1160;1162;2;28;2.0
10;530;1162;1170;8;28;2.0
10;531;1170;1171;1;28;2.0
10;532;1171;1174;3;28;2.0
10;533;1174;1175;1;28;2.0
10;534;1175;1176;1;28;2.0
10;535;1176;1177;1;28;2.0
10;536;1177;1178;1;28;2.0
10;537;1178;1180;2;28;2.0
10;538;1180;1181;1;28;2.0
10;539;1181;1182;1;28;2.0
10;540;1182;1186;4;28;2.0
10;541;1186;1188;2;28;2.0
10;542;1188;1189;1;28;2.0
10;543;1189;1195;6;28;2.0
10;544;1195;1197;2;28;2.0
10;545;1197;1199;2;28;2.0
10;546;1199;1200;1;28;2.0
10;547;1200;1202;2;28;2.0
10;548;1202;1205;3;28;2.0
10;549;1205;1209;4;28;2.0
10;550;1209;1210;1;28;2.0
10;551;1210;1215;5;28;2.0
10;552;1215;1217;2;28;2.0
10;553;1217;1221;4;28;2.0
10;554;1221;1222;1;28;2.0
10;555;1222;1223;1;28;2.0
10;556;1223;1225;2;28;2.0
10;557;1225;1226;1;28;2.0
10;558;1226;1227;1;28;2.0
10;559;1227;1228;1;28;2.0
10;560;1228;1230;2;28;2.0
10;561;1230;1231;1;28;2.0
10;562;1231;1232;1;28;2.0
10;563;1232;1235;3;28;2.0
10;564;1235;1237;2;28;2.0
10;565;1237;1247;10;28;2.0
10;566;1247;1250;3;28;2.0
10;567;1250;1252;2;28;2.0
10;568;1252;1253;1;28;2.0
10;569;1253;1256;3;28;2.0
10;570;1256;1258;2;28;2.0
10;571;1258;1260;2;28;2.0
10;572;1260;1262;2;28;2.0
10;573;1262;1263;1;28;2.0
10;574;1263;1266;3;28;2.0
10;575;1266;1267;1;28;2.0
10;576;1267;1268;1;28;2.0
10;577;1268;1269;1;28;2.0
10;578;1269;1271;2;28;2.0
10;579;1271;1272;1;28;2.0
10;580;1272;1275;3;28;2.0
10;581;1275;1277;2;28;2.0
10;582;1277;1280;3;28;2.0
10;583;1280;1281;1;28;2.0
10;584;1281;1282;1;28;2.0
10;585;1282;1284;2;28;2.0
10;586;1284;1285;1;28;2.0
10;587;1285;1291;6;28;2.0
10;588;1291;1296;5;28;2.0
10;589;1296;1299;3;28;2.0
10;590;1299;1300;1;28;2.0
10;591;1300;1302;2;28;2.0
10;592;1302;1305;3;28;2.0
10;593;1305;1307;2;28;2.0
10;594;1307;1309;2;28;2.0
10;595;1309;1310;1;28;2.0
10;596;1310;1312;2;28;2.0
10;597;1312;1316;4;28;2.0
10;598;1316;1321;5;28;2.0
10;599;1321;1322;1;28;2.0
10;600;1322;1323;1;28;2.0
10;601;1323;1326;3;28;2.0
10;602;1326;1327;1;28;2.0
10;603;1327;1330;3;28;2.0
10;604;1330;1332;2;28;2.0
10;605;1332;1334;2;28;2.0
10;606;1334;1335;1;28;2.0
10;607;1335;1337;2;28;2.0
10;608;1337;1338;1;28;2.0
10;609;1338;1341;3;28;2.0
10;610;1341;1342;1;28;2.0
10;611;1342;1344;2;28;2.0
10;612;1344;1345;1;28;2.0
10;613;1345;1347;2;28;2.0
10;614;1347;1350;3;28;2.0
10;615;1350;1357;7;28;2.0
10;616;1357;1360;3;28;2.0
10;617;1360;1362;2;28;2.0
10;618;1362;1363;1;28;2.0
10;619;1363;1364;1;28;2.0
10;620;1364;1365;1;28;2.0
10;621;1365;1366;1;28;2.0
10;622;1366;1371;5;28;2.0
10;623;1371;1374;3;28;2.0
10;624;1374;1376;2;28;2.0
10;625;1376;1378;2;28;2.0
10;626;1378;1379;1;28;2.0
10;627;1379;1380;1;28;2.0
10;628;1380;1382;2;28;2.0
10;629;1382;1385;3;28;2.0
10;630;1385;1386;1;28;2.0
10;631;1386;1387;1;28;2.0
10;632;1387;1394;7;28;2.0
10;633;1394;1409;15;28;2.0
10;634;1409;1424;15;28;2.0
10;635;1424;1439;15;28;2.0
10;636;1439;1454;15;28;2.0
10;637;1454;1469;15;28;2.0
10;638;1469;1484;15;28;2.0
10;639;1484;1499;15;28;2.0
10;640;1499;1514;15;28;2.0
10;641;1514;1529;15;28;2.0
10;642;1529;1544;15;28;2.0
10;643;1544;1559;15;28;2.0
10;644;1559;1574;15;28;2.0
10;645;1574;1589;15;28;2.0
10;646;1589;1604;15;28;2.0
10;647;1604;1619;15;28;2.0
10;648;1619;1634;15;28;2.0
10;649;1634;1649;15;28;2.0
10;650;1649;1664;15;28;2.0
10;651;1664;1679;15;28;2.0
10;652;1679;1680;1;28;2.0
11;0;240;282;42;28;0.83
11;1;282;325;43;28;0.83
11;2;325;326;1;28;0.83
11;3;326;329;3;28;0.83
11;4;329;330;1;28;0.83
11;5;330;331;1;28;0.83
11;6;331;333;2;28;0.83
11;7;333;334;1;28;0.83
11;8;334;336;2;28;0.83
11;9;336;337;1;28;0.83
11;10;337;338;1;28;0.83
11;11;338;339;1;28;0.83
11;12;339;342;3;28;0.83
11;13;342;344;2;28;0.83
11;14;344;345;1;28;0.83
11;15;345;346;1;28;0.83
11;16;346;348;2;28;0.83
11;17;348;349;1;28;0.83
11;18;349;351;2;28;0.83
11;19;351;352;1;28;0.83
11;20;352;353;1;28;0.83
11;21;353;354;1;28;0.83
11;22;354;355;1;28;0.83
11;23;355;356;1;28;0.83
11;24;356;357;1;28;0.83
11;25;357;358;1;28;0.83
11;26;358;360;2;28;0.83
11;27;360;361;1;28;0.83
11;28;361;362;1;28;0.83
11;29;362;365;3;28;0.83
11;30;365;366;1;28;0.83
11;31;366;367;1;28;0.83
11;32;367;368;1;28;0.83
11;33;368;369;1;28;0.83
11;34;369;371;2;28;0.83
11;35;371;375;4;28;0.83
11;36;375;377;2;28;0.83
11;37;377;378;1;28;0.83
11;38;378;379;1;28;0.83
11;39;379;380;1;28;0.83
11;40;380;381;1;28;0.83
11;41;381;382;1;28;0.83
11;42;382;383;1;28;0.83
11;43;383;384;1;28;0.83
11;44;384;385;1;28;0.83
11;45;385;387;2;28;0.83
11;46;387;388;1;28;0.83
11;47;388;391;3;28;0.83
11;48;391;392;1;28;0.83
11;49;392;393;1;28;0.83
11;50;393;394;1;28;0.83
11;51;394;395;1;28;0.83
11;52;395;396;1;28;0.83
11;53;396;397;1;28;0.83
11;54;397;398;1;28;0.83
11;55;398;399;1;28;0.83
11;56;399;401;2;28;0.83
11;57;401;403;2;28;0.83
11;58;403;404;1;28;0.83
11;59;404;405;1;28;0.83
11;60;405;406;1;28;0.83
11;61;406;408;2;28;0.83
11;62;408;409;1;28;0.83
11;63;409;412;3;28;0.83
11;64;412;413;1;28;0.83
11;65;413;415;2;28;0.83
11;66;415;416;1;28;0.83
11;67;416;417;1;28;0.83
11;68;417;418;1;28;0.83
11;69;418;419;1;28;0.83
11;70;419;420;1;28;0.83
11;71;420;421;1;28;0.83
11;72;421;422;1;28;0.83
11;73;422;423;1;28;0.83
11;74;423;425;2;28;0.83
11;75;425;427;2;28;0.83
11;76;427;428;1;28;0.83
11;77;428;429;1;28;0.83
11;78;429;431;2;28;0.83
11;79;431;432;1;28;0.83
11;80;432;433;1;28;0.83
11;81;433;435;2;28;0.83
11;82;435;436;1;28;0.83
11;83;436;438;2;28;0.83
11;84;438;439;1;28;0.83
11;85;439;442;3;28;0.83
11;86;442;443;1;28;0.83
11;87;443;444;1;28;0.83
11;88;444;445;1;28;0.83
11;89;445;446;1;28;0.83
11;90;446;447;1;28;0.83
11;91;447;448;1;28;0.83
11;92;448;450;2;28;0.83
11;93;450;451;1;28;0.83
11;94;451;452;1;28;0.83
11;95;452;453;1;28;0.83
11;96;453;454;1;28;0.83
11;97;454;455;1;28;0.83
11;98;455;457;2;28;0.83
11;99;457;458;1;28;0.83
11;100;458;459;1;28;0.83
11;101;459;462;3;28;0.83
11;102;462;463;1;28;0.83
11;103;463;465;2;28;0.83
11;104;465;466;1;28;0.83
11;105;466;467;1;28;0.83
11;106;467;468;1;28;0.83
11;107;468;469;1;28;0.83
11;108;469;471;2;28;0.83
11;109;471;472;1;28;0.83
11;110;472;473;1;28;0.83
11;111;473;475;2;28;0.83
11;112;475;476;1;28;0.83
11;113;476;478;2;28;0.83
11;114;478;479;1;28;0.83
11;115;479;480;1;28;0.83
11;116;480;481;1;28;0.83
11;117;481;482;1;28;0.83
11;118;482;483;1;28;0.83
11;119;483;484;1;28;0.83
11;120;484;485;1;28;0.83
11;121;485;488;3;28;0.83
11;122;488;489;1;28;0.83
11;123;489;492;3;28;0.83
11;124;492;493;1;28;0.83
11;125;493;494;1;28;0.83
11;126;494;495;1;28;0.83
11;127;495;496;1;28;0.83
11;128;496;498;2;28;0.83
11;129;498;499;1;28;0.83
11;130;499;501;2;28;0.83
11;131;501;503;2;28;0.83
11;132;503;504;1;28;0.83
11;133;504;505;1;28;0.83
11;134;505;508;3;28;0.83
11;135;508;512;4;28;0.83
11;136;512;513;1;28;0.83
11;137;513;514;1;28;0.83
11;138;514;515;1;28;0.83
11;139;515;517;2;28;0.83
11;140;517;518;1;28;0.83
11;141;518;519;1;28;0.83
11;142;519;520;1;28;0.83
11;143;520;521;1;28;0.83
11;144;521;522;1;28;0.83
11;145;522;523;1;28;0.83
11;146;523;525;2;28;0.83
11;147;525;528;3;28;0.83
11;148;528;529;1;28;0.83
11;149;529;531;2;28;0.83
11;150;531;532;1;28;0.83
11;151;532;533;1;28;0.83
11;152;533;537;4;28;0.83
11;153;537;538;1;28;0.83
11;154;538;539;1;28;0.83
11;155;539;540;1;28;0.83
11;156;540;543;3;28;0.83
11;157;543;544;1;28;0.83
11;158;544;545;1;28;0.83
11;159;545;547;2;28;0.83
11;160;547;548;1;28;0.83
11;161;548;549;1;28;0.83
11;162;549;550;1;28;0.83
11;163;550;553;3;28;0.83
11;164;553;555;2;28;0.83
11;165;555;556;1;28;0.83
11;166;556;557;1;28;0.83
11;167;557;558;1;28;0.83
11;168;558;559;1;28;0.83
11;169;559;563;4;28;0.83
11;170;563;565;2;28;0.83
11;171;565;568;3;28;0.83
11;172;568;569;1;28;0.83
11;173;569;572;3;28;0.83
11;174;572;574;2;28;0.83
11;175;574;576;2;28;0.83
11;176;576;577;1;28;0.83
11;177;577;578;1;28;0.83
11;178;578;579;1;28;0.83
11;179;579;583;4;28;0.83
11;180;583;585;2;28;0.83
11;181;585;588;3;28;0.83
11;182;588;590;2;28;0.83
11;183;590;591;1;28;0.83
11;184;591;592;1;28;0.83
11;185;592;593;1;28;0.83
11;186;593;595;2;28;0.83
11;187;595;597;2;28;0.83
11;188;597;598;1;28;0.83
11;189;598;599;1;28;0.83
11;190;599;603;4;28;0.83
11;191;603;605;2;28;0.83
11;192;605;607;2;28;0.83
11;193;607;608;1;28;0.83
11;194;608;609;1;28;0.83
11;195;609;615;6;28;0.83
11;196;615;617;2;28;0.83
11;197;617;618;1;28;0.83
11;198;618;619;1;28;0.83
11;199;619;623;4;28;0.83
11;200;623;625;2;28;0.83
11;201;625;627;2;28;0.83
11;202;627;628;1;28;0.83
11;203;628;629;1;28;0.83
11;204;629;632;3;28;0.83
11;205;632;633;1;28;0.83
11;206;633;637;4;28;0.83
11;207;637;638;1;28;0.83
11;208;638;639;1;28;0.83
11;209;639;643;4;28;0.83
11;210;643;645;2;28;0.83
11;211;645;648;3;28;0.83
11;212;648;651;3;28;0.83
11;213;651;652;1;28;0.83
11;214;652;653;1;28;0.83
11;215;653;655;2;28;0.83
11;216;655;656;1;28;0.83
11;217;656;657;1;28;0.83
11;218;657;658;1;28;0.83
11;219;658;659;1;28;0.83
11;220;659;660;1;28;0.83
11;221;660;663;3;28;0.83
11;222;663;665;2;28;0.83
11;223;665;666;1;28;0.83
11;224;666;668;2;28;0.83
11;225;668;669;1;28;0.83
11;226;669;671;2;28;0.83
11;227;671;673;2;28;0.83
11;228;673;677;4;28;0.83
11;229;677;678;1;28;0.83
11;230;678;679;1;28;0.83
11;231;679;681;2;28;0.83
11;232;681;683;2;28;0.83
11;233;683;685;2;28;0.83
11;234;685;688;3;28;0.83
11;235;688;689;1;28;0.83
11;236;689;692;3;28;0.83
11;237;692;693;1;28;0.83
11;238;693;695;2;28;0.83
11;239;695;697;2;28;0.83
11;240;697;698;1;28;0.83
11;241;698;699;1;28;0.83
11;242;699;700;1;28;0.83
11;243;700;703;3;28;0.83
11;244;703;704;1;28;0.83
11;245;704;705;1;28;0.83
11;246;705;707;2;28;0.83
11;247;707;708;1;28;0.83
11;248;708;712;4;28;0.83
11;249;712;713;1;28;0.83
11;250;713;715;2;28;0.83
11;251;715;717;2;28;0.83
11;252;717;718;1;28;0.83
11;253;718;719;1;28;0.83
11;254;719;721;2;28;0.83
11;255;721;723;2;28;0.83
11;256;723;725;2;28;0.83
11;257;725;728;3;28;0.83
11;258;728;729;1;28;0.83
11;259;729;735;6;28;0.83
11;260;735;736;1;28;0.83
11;261;736;737;1;28;0.83
11;262;737;738;1;28;0.83
11;263;738;739;1;28;0.83
11;264;739;743;4;28;0.83
11;265;743;745;2;28;0.83
11;266;745;746;1;28;0.83
11;267;746;748;2;28;0.83
11;268;748;749;1;28;0.83
11;269;749;752;3;28;0.83
11;270;752;757;5;28;0.83
11;271;757;758;1;28;0.83
11;272;758;759;1;28;0.83
11;273;759;760;1;28;0.83
11;274;760;763;3;28;0.83
11;275;763;765;2;28;0.83
11;276;765;766;1;28;0.83
11;277;766;768;2;28;0.83
11;278;768;772;4;28;0.83
11;279;772;773;1;28;0.83
11;280;773;774;1;28;0.83
11;281;774;775;1;28;0.83
11;282;775;777;2;28;0.83
11;283;777;778;1;28;0.83
11;284;778;779;1;28;0.83
11;285;779;783;4;28;0.83
11;286;783;784;1;28;0.83
11;287;784;785;1;28;0.83
11;288;785;788;3;28;0.83
11;289;788;789;1;28;0.83
11;290;789;792;3;28;0.83
11;291;792;793;1;28;0.83
11;292;793;795;2;28;0.83
11;293;795;797;2;28;0.83
11;294;797;798;1;28;0.83
11;295;798;799;1;28;0.83
11;296;799;800;1;28;0.83
11;297;800;801;1;28;0.83
11;298;801;803;2;28;0.83
11;299;803;804;1;28;0.83
11;300;804;805;1;28;0.83
11;301;805;806;1;28;0.83
11;302;806;808;2;28;0.83
11;303;808;812;4;28;0.83
11;304;812;814;2;28;0.83
11;305;814;815;1;28;0.83
11;306;815;817;2;28;0.83
11;307;817;818;1;28;0.83
11;308;818;819;1;28;0.83
11;309;819;820;1;28;0.83
11;310;820;821;1;28;0.83
11;311;821;823;2;28;0.83
11;312;823;825;2;28;0.83
11;313;825;828;3;28;0.83
11;314;828;829;1;28;0.83
11;315;829;830;1;28;0.83
11;316;830;832;2;28;0.83
11;317;832;833;1;28;0.83
11;318;833;834;1;28;0.83
11;319;834;835;1;28;0.83
11;320;835;836;1;28;0.83
11;321;836;837;1;28;0.83
11;322;837;838;1;28;0.83
11;323;838;839;1;28;0.83
11;324;839;841;2;28;0.83
11;325;841;843;2;28;0.83
11;326;843;845;2;28;0.83
11;327;845;847;2;28;0.83
11;328;847;848;1;28;0.83
11;329;848;849;1;28;0.83
11;330;849;850;1;28;0.83
11;331;850;852;2;28;0.83
11;332;852;854;2;28;0.83
11;333;854;855;1;28;0.83
11;334;855;857;2;28;0.83
11;335;857;858;1;28;0.83
11;336;858;859;1;28;0.83
11;337;859;861;2;28;0.83
11;338;861;862;1;28;0.83
11;339;862;863;1;28;0.83
11;340;863;865;2;28;0.83
11;341;865;866;1;28;0.83
11;342;866;868;2;28;0.83
11;343;868;869;1;28;0.83
11;344;869;870;1;28;0.83
11;345;870;871;1;28;0.83
11;346;871;872;1;28;0.83
11;347;872;873;1;28;0.83
11;348;873;875;2;28;0.83
11;349;875;876;1;28;0.83
11;350;876;877;1;28;0.83
11;351;877;878;1;28;0.83
11;352;878;879;1;28;0.83
11;353;879;880;1;28;0.83
11;354;880;883;3;28;0.83
11;355;883;885;2;28;0.83
11;356;885;887;2;28;0.83
11;357;887;888;1;28;0.83
11;358;888;889;1;28;0.83
11;359;889;892;3;28;0.83
11;360;892;893;1;28;0.83
11;361;893;895;2;28;0.83
11;362;895;897;2;28;0.83
11;363;897;898;1;28;0.83
11;364;898;899;1;28;0.83
11;365;899;901;2;28;0.83
11;366;901;902;1;28;0.83
11;367;902;903;1;28;0.83
11;368;903;905;2;28;0.83
11;369;905;907;2;28;0.83
11;370;907;908;1;28;0.83
11;371;908;909;1;28;0.83
11;372;909;910;1;28;0.83
11;373;910;911;1;28;0.83
11;374;911;912;1;28;0.83
11;375;912;913;1;28;0.83
11;376;913;915;2;28;0.83
11;377;915;917;2;28;0.83
11;378;917;918;1;28;0.83
11;379;918;919;1;28;0.83
11;380;919;920;1;28;0.83
11;381;920;922;2;28;0.83
11;382;922;923;1;28;0.83
11;383;923;925;2;28;0.83
11;384;925;926;1;28;0.83
11;385;926;928;2;28;0.83
11;386;928;929;1;28;0.83
11;387;929;931;2;28;0.83
11;388;931;932;1;28;0.83
11;389;932;933;1;28;0.83
11;390;933;935;2;28;0.83
11;391;935;937;2;28;0.83
11;392;937;938;1;28;0.83
11;393;938;939;1;28;0.83
11;394;939;940;1;28;0.83
11;395;940;942;2;28;0.83
11;396;942;943;1;28;0.83
11;397;943;945;2;28;0.83
11;398;945;947;2;28;0.83
11;399;947;948;1;28;0.83
11;400;948;949;1;28;0.83
11;401;949;952;3;28;0.83
11;402;952;953;1;28;0.83
11;403;953;955;2;28;0.83
11;404;955;956;1;28;0.83
11;405;956;957;1;28;0.83
11;406;957;958;1;28;0.83
11;407;958;959;1;28;0.83
11;408;959;962;3;28;0.83
11;409;962;963;1;28;0.83
11;410;963;965;2;28;0.83
11;411;965;966;1;28;0.83
11;412;966;967;1;28;0.83
11;413;967;968;1;28;0.83
11;414;968;969;1;28;0.83
11;415;969;970;1;28;0.83
11;416;970;972;2;28;0.83
11;417;972;973;1;28;0.83
11;418;973;975;2;28;0.83
11;419;975;977;2;28;0.83
11;420;977;978;1;28;0.83
11;421;978;979;1;28;0.83
11;422;979;980;1;28;0.83
11;423;980;981;1;28;0.83
11;424;981;983;2;28;0.83
11;425;983;985;2;28;0.83
11;426;985;988;3;28;0.83
11;427;988;989;1;28;0.83
11;428;989;992;3;28;0.83
11;429;992;993;1;28;0.83
11;430;993;995;2;28;0.83
11;431;995;997;2;28;0.83
11;432;997;998;1;28;0.83
11;433;998;999;1;28;0.83
11;434;999;1000;1;28;0.83
11;435;1000;1002;2;28;0.83
11;436;1002;1003;1;28;0.83
11;437;1003;1005;2;28;0.83
11;438;1005;1007;2;28;0.83
11;439;1007;1008;1;28;0.83
11;440;1008;1009;1;28;0.83
11;441;1009;1011;2;28;0.83
11;442;1011;1012;1;28;0.83
11;443;1012;1014;2;28;0.83
11;444;1014;1015;1;28;0.83
11;445;1015;1017;2;28;0.83
11;446;1017;1018;1;28;0.83
11;447;1018;1019;1;28;0.83
11;448;1019;1020;1;28;0.83
11;449;1020;1021;1;28;0.83
11;450;1021;1023;2;28;0.83
11;451;1023;1026;3;28;0.83
11;452;1026;1027;1;28;0.83
11;453;1027;1028;1;28;0.83
11;454;1028;1029;1;28;0.83
11;455;1029;1030;1;28;0.83
11;456;1030;1032;2;28;0.83
11;457;1032;1033;1;28;0.83
11;458;1033;1037;4;28;0.83
11;459;1037;1038;1;28;0.83
11;460;1038;1039;1;28;0.83
11;461;1039;1041;2;28;0.83
11;462;1041;1043;2;28;0.83
11;463;1043;1044;1;28;0.83
11;464;1044;1045;1;28;0.83
11;465;1045;1047;2;28;0.83
11;466;1047;1048;1;28;0.83
11;467;1048;1049;1;28;0.83
11;468;1049;1053;4;28;0.83
11;469;1053;1055;2;28;0.83
11;470;1055;1057;2;28;0.83
11;471;1057;1058;1;28;0.83
11;472;1058;1059;1;28;0.83
11;473;1059;1060;1;28;0.83
11;474;1060;1062;2;28;0.83
11;475;1062;1063;1;28;0.83
11;476;1063;1065;2;28;0.83
11;477;1065;1067;2;28;0.83
11;478;1067;1068;1;28;0.83
11;479;1068;1069;1;28;0.83
11;480;1069;1071;2;28;0.83
11;481;1071;1075;4;28;0.83
11;482;1075;1076;1;28;0.83
11;483;1076;1077;1;28;0.83
11;484;1077;1078;1;28;0.83
11;485;1078;1079;1;28;0.83
11;486;1079;1083;4;28;0.83
11;487;1083;1084;1;28;0.83
11;488;1084;1085;1;28;0.83
11;489;1085;1087;2;28;0.83
11;490;1087;1088;1;28;0.83
11;491;1088;1089;1;28;0.83
11;492;1089;1090;1;28;0.83
11;493;1090;1093;3;28;0.83
11;494;1093;1094;1;28;0.83
11;495;1094;1095;1;28;0.83
11;496;1095;1097;2;28;0.83
11;497;1097;1098;1;28;0.83
11;498;1098;1100;2;28;0.83
11;499;1100;1101;1;28;0.83
11;500;1101;1103;2;28;0.83
11;501;1103;1105;2;28;0.83
11;502;1105;1107;2;28;0.83
11;503;1107;1108;1;28;0.83
11;504;1108;1109;1;28;0.83
11;505;1109;1110;1;28;0.83
11;506;1110;1111;1;28;0.83
11;507;1111;1112;1;28;0.83
11;508;1112;1113;1;28;0.83
11;509;1113;1117;4;28;0.83
11;510;1117;1120;3;28;0.83
11;511;1120;1121;1;28;0.83
11;512;1121;1125;4;28;0.83
11;513;1125;1128;3;28;0.83
11;514;1128;1132;4;28;0.83
11;515;1132;1134;2;28;0.83
11;516;1134;1137;3;28;0.83
11;517;1137;1139;2;28;0.83
11;518;1139;1140;1;28;0.83
11;519;1140;1141;1;28;0.83
11;520;1141;1142;1;28;0.83
11;521;1142;1145;3;28;0.83
11;522;1145;1147;2;28;0.83
11;523;1147;1150;3;28;0.83
11;524;1150;1152;2;28;0.83
11;525;1152;1153;1;28;0.83
11;526;1153;1155;2;28;0.83
11;527;1155;1157;2;28;0.83
11;528;1157;1160;3;28;0.83
11;529;1160;1162;2;28;0.83
11;530;1162;1170;8;28;0.83
11;531;1170;1171;1;28;0.83
11;532;1171;1174;3;28;0.83
11;533;1174;1175;1;28;0.83
11;534;1175;1176;1;28;0.83
11;535;1176;1177;1;28;0.83
11;536;1177;1178;1;28;0.83
11;537;1178;1180;2;28;0.83
11;538;1180;1181;1;28;0.83
11;539;1181;1182;1;28;0.83
11;540;1182;1186;4;28;0.83
11;541;1186;1188;2;28;0.83
11;542;1188;1189;1;28;0.83
11;543;1189;1195;6;28;0.83
11;544;1195;1197;2;28;0.83
11;545;1197;1199;2;28;0.83
11;546;1199;1200;1;28;0.83
11;547;1200;1202;2;28;0.83
11;548;1202;1205;3;28;0.83
11;549;1205;1209;4;28;0.83
11;550;1209;1210;1;28;0.83
11;551;1210;1215;5;28;0.83
11;552;1215;1217;2;28;0.83
11;553;1217;1221;4;28;0.83
11;554;1221;1222;1;28;0.83
11;555;1222;1223;1;28;0.83
11;556;1223;1225;2;28;0.83
11;557;1225;1226;1;28;0.83
11;558;1226;1227;1;28;0.83
11;559;1227;1228;1;28;0.83
11;560;1228;1230;2;28;0.83
11;561;1230;1231;1;28;0.83
11;562;1231;1232;1;28;0.83
11;563;1232;1235;3;28;0.83
11;564;1235;1237;2;28;0.83
11;565;1237;1247;10;28;0.83
11;566;1247;1250;3;28;0.83
11;567;1250;1252;2;28;0.83
11;568;1252;1253;1;28;0.83
11;569;1253;1256;3;28;0.83
11;570;1256;1258;2;28;0.83
11;571;1258;1260;2;28;0.83
11;572;1260;1262;2;28;0.83
11;573;1262;1263;1;28;0.83
11;574;1263;1266;3;28;0.83
11;575;1266;1267;1;28;0.83
11;576;1267;1268;1;28;0.83
11;577;1268;1269;1;28;0.83
11;578;1269;1271;2;28;0.83
11;579;1271;1272;1;28;0.83
11;580;1272;1275;3;28;0.83
11;581;1275;1277;2;28;0.83
11;582;1277;1280;3;28;0.83
11;583;1280;1281;1;28;0.83
11;584;1281;1282;1;28;0.83
11;585;1282;1284;2;28;0.83
11;586;1284;1285;1;28;0.83
11;587;1285;1291;6;28;0.83
11;588;1291;1296;5;28;0.83
11;589;1296;1299;3;28;0.83
11;590;1299;1300;1;28;0.83
11;591;1300;1302;2;28;0.83
11;592;1302;1305;3;28;0.83
11;593;1305;1307;2;28;0.83
11;594;1307;1309;2;28;0.83
11;595;1309;1310;1;28;0.83
11;596;1310;1312;2;28;0.83
11;597;1312;1316;4;28;0.83
11;598;1316;1321;5;28;0.83
11;599;1321;1322;1;28;0.83
11;600;1322;1323;1;28;0.83
11;601;1323;1326;3;28;0.83
11;602;1326;1327;1;28;0.83
11;603;1327;1330;3;28;0.83
11;604;1330;1332;2;28;0.83
11;605;1332;1334;2;28;0.83
11;606;1334;1335;1;28;0.83
11;607;1335;1337;2;28;0.83
11;608;1337;1338;1;28;0.83
11;609;1338;1341;3;28;0.83
11;610;1341;1342;1;28;0.83
11;611;1342;1344;2;28;0.83
11;612;1344;1345;1;28;0.83
11;613;1345;1347;2;28;0.83
11;614;1347;1350;3;28;0.83
11;615;1350;1357;7;28;0.83
11;616;1357;1360;3;28;0.83
11;617;1360;1362;2;28;0.83
11;618;1362;1363;1;28;0.83
11;619;1363;1364;1;28;0.83
11;620;1364;1365;1;28;0.83
11;621;1365;1366;1;28;0.83
11;622;1366;1371;5;28;0.83
11;623;1371;1374;3;28;0.83
11;624;1374;1376;2;28;0.83
11;625;1376;1378;2;28;0.83
11;626;1378;1379;1;28;0.83
11;627;1379;1380;1;28;0.83
11;628;1380;1382;2;28;0.83
11;629;1382;1385;3;28;0.83
11;630;1385;1386;1;28;0.83
11;631;1386;1387;1;28;0.83
11;632;1387;1394;7;28;0.83
11;633;1394;1409;15;28;0.83
11;634;1409;1424;15;28;0.83
11;635;1424;1439;15;28;0.83
11;636;1439;1454;15;28;0.83
11;637;1454;1469;15;28;0.83
11;638;1469;1484;15;28;0.83
11;639;1484;1499;15;28;0.83
11;640;1499;1514;15;28;0.83
11;641;1514;1529;15;28;0.83
11;642;1529;1544;15;28;0.83
11;643;1544;1559;15;28;0.83
11;644;1559;1574;15;28;0.83
11;645;1574;1589;15;28;0.83
11;646;1589;1604;15;28;0.83
11;647;1604;1619;15;28;0.83
11;648;1619;1634;15;28;0.83
11;649;1634;1649;15;28;0.83
11;650;1649;1664;15;28;0.83
11;651;1664;1679;15;28;0.83
11;652;1679;1680;1;28;0.83
12;0;240;282;42;28;0.83
12;1;282;325;43;28;0.83
12;2;325;326;1;28;0.83
12;3;326;329;3;28;0.83
12;4;329;330;1;28;0.83
12;5;330;331;1;28;0.83
12;6;331;333;2;28;0.83
12;7;333;334;1;28;0.83
12;8;334;336;2;28;0.83
12;9;336;337;1;28;0.83
12;10;337;338;1;28;0.83
12;11;338;339;1;28;0.83
12;12;339;342;3;28;0.83
12;13;342;344;2;28;0.83
12;14;344;345;1;28;0.83
12;15;345;346;1;28;0.83
12;16;346;348;2;28;0.83
12;17;348;349;1;28;0.83
12;18;349;351;2;28;0.83
12;19;351;352;1;28;0.83
12;20;352;353;1;28;0.83
12;21;353;354;1;28;0.83
12;22;354;355;1;28;0.83
12;23;355;356;1;28;0.83
12;24;356;357;1;28;0.83
12;25;357;358;1;28;0.83
12;26;358;360;2;28;0.83
12;27;360;361;1;28;0.83
12;28;361;362;1;28;0.83
12;29;362;365;3;28;0.83
12;30;365;366;1;28;0.83
12;31;366;367;1;28;0.83
12;32;367;368;1;28;0.83
12;33;368;369;1;28;0.83
12;34;369;371;2;28;0.83
12;35;371;375;4;28;0.83
12;36;375;377;2;28;0.83
12;37;377;378;1;28;0.83
12;38;378;379;1;28;0.83
12;39;379;380;1;28;0.83
12;40;380;381;1;28;0.83
12;41;381;382;1;28;0.83
12;42;382;383;1;28;0.83
12;43;383;384;1;28;0.83
12;44;384;385;1;28;0.83
12;45;385;387;2;28;0.83
12;46;387;388;1;28;0.83
12;47;388;391;3;28;0.83
12;48;391;392;1;28;0.83
12;49;392;393;1;28;0.83
12;50;393;394;1;28;0.83
12;51;394;395;1;28;0.83
12;52;395;396;1;28;0.83
12;53;396;397;1;28;0.83
12;54;397;398;1;28;0.83
12;55;398;399;1;28;0.83
12;56;399;401;2;28;0.83
12;57;401;403;2;28;0.83
12;58;403;404;1;28;0.83
12;59;404;405;1;28;0.83
12;60;405;406;1;28;0.83
12;61;406;408;2;28;0.83
12;62;408;409;1;28;0.83
12;63;409;412;3;28;0.83
12;64;412;413;1;28;0.83
12;65;413;415;2;28;0.83
12;66;415;416;1;28;0.83
12;67;416;417;1;28;0.83
12;68;417;418;1;28;0.83
12;69;418;419;1;28;0.83
12;70;419;420;1;28;0.83
12;71;420;421;1;28;0.83
12;72;421;422;1;28;0.83
12;73;422;423;1;28;0.83
12;74;423;425;2;28;0.83
12;75;425;427;2;28;0.83
12;76;427;428;1;28;0.83
12;77;428;429;1;28;0.83
12;78;429;431;2;28;0.83
12;79;431;432;1;28;0.83
12;80;432;433;1;28;0.83
12;81;433;435;2;28;0.83
12;82;435;436;1;28;0.83
12;83;436;438;2;28;0.83
12;84;438;439;1;28;0.83
12;85;439;442;3;28;0.83
12;86;442;443;1;28;0.83
12;87;443;444;1;28;0.83
12;88;444;445;1;28;0.83
12;89;445;446;1;28;0.83
12;90;446;447;1;28;0.83
12;91;447;448;1;28;0.83
12;92;448;450;2;28;0.83
12;93;450;451;1;28;0.83
12;94;451;452;1;28;0.83
12;95;452;453;1;28;0.83
12;96;453;454;1;28;0.83
12;97;454;455;1;28;0.83
12;98;455;457;2;28;0.83
12;99;457;458;1;28;0.83
12;100;458;459;1;28;0.83
12;101;459;462;3;28;0.83
12;102;462;463;1;28;0.83
12;103;463;465;2;28;0.83
12;104;465;466;1;28;0.83
12;105;466;467;1;28;0.83
12;106;467;468;1;28;0.83
12;107;468;469;1;28;0.83
12;108;469;471;2;28;0.83
12;109;471;472;1;28;0.83
12;110;472;473;1;28;0.83
12;111;473;475;2;28;0.83
12;112;475;476;1;28;0.83
12;113;476;478;2;28;0.83
12;114;478;479;1;28;0.83
12;115;479;480;1;28;0.83
12;116;480;481;1;28;0.83
12;117;481;482;1;28;0.83
12;118;482;483;1;28;0.83
12;119;483;484;1;28;0.83
12;120;484;485;1;28;0.83
12;121;485;488;3;28;0.83
12;122;488;489;1;28;0.83
12;123;489;492;3;28;0.83
12;124;492;493;1;28;0.83
12;125;493;494;1;28;0.83
12;126;494;495;1;28;0.83
12;127;495;496;1;28;0.83
12;128;496;498;2;28;0.83
12;129;498;499;1;28;0.83
12;130;499;501;2;28;0.83
12;131;501;503;2;28;0.83
12;132;503;504;1;28;0.83
12;133;504;505;1;28;0.83
12;134;505;508;3;28;0.83
12;135;508;512;4;28;0.83
12;136;512;513;1;28;0.83
12;137;513;514;1;28;0.83
12;138;514;515;1;28;0.83
12;139;515;517;2;28;0.83
12;140;517;518;1;28;0.83
12;141;518;519;1;28;0.83
12;142;519;520;1;28;0.83
12;143;520;521;1;28;0.83
12;144;521;522;1;28;0.83
12;145;522;523;1;28;0.83
12;146;523;525;2;28;0.83
12;147;525;528;3;28;0.83
12;148;528;529;1;28;0.83
12;149;529;531;2;28;0.83
12;150;531;532;1;28;0.83
12;151;532;533;1;28;0.83
12;152;533;537;4;28;0.83
12;153;537;538;1;28;0.83
12;154;538;539;1;28;0.83
12;155;539;540;1;28;0.83
12;156;540;543;3;28;0.83
12;157;543;544;1;28;0.83
12;158;544;545;1;28;0.83
12;159;545;547;2;28;0.83
12;160;547;548;1;28;0.83
12;161;548;549;1;28;0.83
12;162;549;550;1;28;0.83
12;163;550;553;3;28;0.83
12;164;553;555;2;28;0.83
12;165;555;556;1;28;0.83
12;166;556;557;1;28;0.83
12;167;557;558;1;28;0.83
12;168;558;559;1;28;0.83
12;169;559;563;4;28;0.83
12;170;563;565;2;28;0.83
12;171;565;568;3;28;0.83
12;172;568;569;1;28;0.83
12;173;569;572;3;28;0.83
12;174;572;574;2;28;0.83
12;175;574;576;2;28;0.83
12;176;576;577;1;28;0.83
12;177;577;578;1;28;0.83
12;178;578;579;1;28;0.83
12;179;579;583;4;28;0.83
12;180;583;585;2;28;0.83
12;181;585;588;3;28;0.83
12;182;588;590;2;28;0.83
12;183;590;591;1;28;0.83
12;184;591;592;1;28;0.83
12;185;592;593;1;28;0.83
12;186;593;595;2;28;0.83
12;187;595;597;2;28;0.83
12;188;597;598;1;28;0.83
12;189;598;599;1;28;0.83
12;190;599;603;4;28;0.83
12;191;603;605;2;28;0.83
12;192;605;607;2;28;0.83
12;193;607;608;1;28;0.83
12;194;608;609;1;28;0.83
12;195;609;615;6;28;0.83
12;196;615;617;2;28;0.83
12;197;617;618;1;28;0.83
12;198;618;619;1;28;0.83
12;199;619;623;4;28;0.83
12;200;623;625;2;28;0.83
12;201;625;627;2;28;0.83
12;202;627;628;1;28;0.83
12;203;628;629;1;28;0.83
12;204;629;632;3;28;0.83
12;205;632;633;1;28;0.83
12;206;633;637;4;28;0.83
12;207;637;638;1;28;0.83
12;208;638;639;1;28;0.83
12;209;639;643;4;28;0.83
12;210;643;645;2;28;0.83
12;211;645;648;3;28;0.83
12;212;648;651;3;28;0.83
12;213;651;652;1;28;0.83
12;214;652;653;1;28;0.83
12;215;653;655;2;28;0.83
12;216;655;656;1;28;0.83
12;217;656;657;1;28;0.83
12;218;657;658;1;28;0.83
12;219;658;659;1;28;0.83
12;220;659;660;1;28;0.83
12;221;660;663;3;28;0.83
12;222;663;665;2;28;0.83
12;223;665;666;1;28;0.83
12;224;666;668;2;28;0.83
12;225;668;669;1;28;0.83
12;226;669;671;2;28;0.83
12;227;671;673;2;28;0.83
12;228;673;677;4;28;0.83
12;229;677;678;1;28;0.83
12;230;678;679;1;28;0.83
12;231;679;681;2;28;0.83
12;232;681;683;2;28;0.83
12;233;683;685;2;28;0.83
12;234;685;688;3;28;0.83
12;235;688;689;1;28;0.83
12;236;689;692;3;28;0.83
12;237;692;693;1;28;0.83
12;238;693;695;2;28;0.83
12;239;695;697;2;28;0.83
12;240;697;698;1;28;0.83
12;241;698;699;1;28;0.83
12;242;699;700;1;28;0.83
12;243;700;703;3;28;0.83
12;244;703;704;1;28;0.83
12;245;704;705;1;28;0.83
12;246;705;707;2;28;0.83
12;247;707;708;1;28;0.83
12;248;708;712;4;28;0.83
12;249;712;713;1;28;0.83
12;250;713;715;2;28;0.83
12;251;715;717;2;28;0.83
12;252;717;718;1;28;0.83
12;253;718;719;1;28;0.83
12;254;719;721;2;28;0.83
12;255;721;723;2;28;0.83
12;256;723;725;2;28;0.83
12;257;725;728;3;28;0.83
12;258;728;729;1;28;0.83
12;259;729;735;6;28;0.83
12;260;735;736;1;28;0.83
12;261;736;737;1;28;0.83
12;262;737;738;1;28;0.83
12;263;738;739;1;28;0.83
12;264;739;743;4;28;0.83
12;265;743;745;2;28;0.83
12;266;745;746;1;28;0.83
12;267;746;748;2;28;0.83
12;268;748;749;1;28;0.83
12;269;749;752;3;28;0.83
12;270;752;757;5;28;0.83
12;271;757;758;1;28;0.83
12;272;758;759;1;28;0.83
12;273;759;760;1;28;0.83
12;274;760;763;3;28;0.83
12;275;763;765;2;28;0.83
12;276;765;766;1;28;0.83
12;277;766;768;2;28;0.83
12;278;768;772;4;28;0.83
12;279;772;773;1;28;0.83
12;280;773;774;1;28;0.83
12;281;774;775;1;28;0.83
12;282;775;777;2;28;0.83
12;283;777;778;1;28;0.83
12;284;778;779;1;28;0.83
12;285;779;783;4;28;0.83
12;286;783;784;1;28;0.83
12;287;784;785;1;28;0.83
12;288;785;788;3;28;0.83
12;289;788;789;1;28;0.83
12;290;789;792;3;28;0.83
12;291;792;793;1;28;0.83
12;292;793;795;2;28;0.83
12;293;795;797;2;28;0.83
12;294;797;798;1;28;0.83
12;295;798;799;1;28;0.83
12;296;799;800;1;28;0.83
12;297;800;801;1;28;0.83
12;298;801;803;2;28;0.83
12;299;803;804;1;28;0.83
12;300;804;805;1;28;0.83
12;301;805;806;1;28;0.83
12;302;806;808;2;28;0.83
12;303;808;812;4;28;0.83
12;304;812;814;2;28;0.83
12;305;814;815;1;28;0.83
12;306;815;817;2;28;0.83
12;307;817;818;1;28;0.83
12;308;818;819;1;28;0.83
12;309;819;820;1;28;0.83
12;310;820;821;1;28;0.83
12;311;821;823;2;28;0.83
12;312;823;825;2;28;0.83
12;313;825;828;3;28;0.83
12;314;828;829;1;28;0.83
12;315;829;830;1;28;0.83
12;316;830;832;2;28;0.83
12;317;832;833;1;28;0.83
12;318;833;834;1;28;0.83
12;319;834;835;1;28;0.83
12;320;835;836;1;28;0.83
12;321;836;837;1;28;0.83
12;322;837;838;1;28;0.83
12;323;838;839;1;28;0.83
12;324;839;841;2;28;0.83
12;325;841;843;2;28;0.83
12;326;843;845;2;28;0.83
12;327;845;847;2;28;0.83
12;328;847;848;1;28;0.83
12;329;848;849;1;28;0.83
12;330;849;850;1;28;0.83
12;331;850;852;2;28;0.83
12;332;852;854;2;28;0.83
12;333;854;855;1;28;0.83
12;334;855;857;2;28;0.83
12;335;857;858;1;28;0.83
12;336;858;859;1;28;0.83
12;337;859;861;2;28;0.83
12;338;861;862;1;28;0.83
12;339;862;863;1;28;0.83
12;340;863;865;2;28;0.83
12;341;865;866;1;28;0.83
12;342;866;868;2;28;0.83
12;343;868;869;1;28;0.83
12;344;869;870;1;28;0.83
12;345;870;871;1;28;0.83
12;346;871;872;1;28;0.83
12;347;872;873;1;28;0.83
12;348;873;875;2;28;0.83
12;349;875;876;1;28;0.83
12;350;876;877;1;28;0.83
12;351;877;878;1;28;0.83
12;352;878;879;1;28;0.83
12;353;879;880;1;28;0.83
12;354;880;883;3;28;0.83
12;355;883;885;2;28;0.83
12;356;885;887;2;28;0.83
12;357;887;888;1;28;0.83
12;358;888;889;1;28;0.83
12;359;889;892;3;28;0.83
12;360;892;893;1;28;0.83
12;361;893;895;2;28;0.83
12;362;895;897;2;28;0.83
12;363;897;898;1;28;0.83
12;364;898;899;1;28;0.83
12;365;899;901;2;28;0.83
12;366;901;902;1;28;0.83
12;367;902;903;1;28;0.83
12;368;903;905;2;28;0.83
12;369;905;907;2;28;0.83
12;370;907;908;1;28;0.83
12;371;908;909;1;28;0.83
12;372;909;910;1;28;0.83
12;373;910;911;1;28;0.83
12;374;911;912;1;28;0.83
12;375;912;913;1;28;0.83
12;376;913;915;2;28;0.83
12;377;915;917;2;28;0.83
12;378;917;918;1;28;0.83
12;379;918;919;1;28;0.83
12;380;919;920;1;28;0.83
12;381;920;922;2;28;0.83
12;382;922;923;1;28;0.83
12;383;923;925;2;28;0.83
12;384;925;926;1;28;0.83
12;385;926;928;2;28;0.83
12;386;928;929;1;28;0.83
12;387;929;931;2;28;0.83
12;388;931;932;1;28;0.83
12;389;932;933;1;28;0.83
12;390;933;935;2;28;0.83
12;391;935;937;2;28;0.83
12;392;937;938;1;28;0.83
12;393;938;939;1;28;0.83
12;394;939;940;1;28;0.83
12;395;940;942;2;28;0.83
12;396;942;943;1;28;0.83
12;397;943;945;2;28;0.83
12;398;945;947;2;28;0.83
12;399;947;948;1;28;0.83
12;400;948;949;1;28;0.83
12;401;949;952;3;28;0.83
12;402;952;953;1;28;0.83
12;403;953;955;2;28;0.83
12;404;955;956;1;28;0.83
12;405;956;957;1;28;0.83
12;406;957;958;1;28;0.83
12;407;958;959;1;28;0.83
12;408;959;962;3;28;0.83
12;409;962;963;1;28;0.83
12;410;963;965;2;28;0.83
12;411;965;966;1;28;0.83
12;412;966;967;1;28;0.83
12;413;967;968;1;28;0.83
12;414;968;969;1;28;0.83
12;415;969;970;1;28;0.83
12;416;970;972;2;28;0.83
12;417;972;973;1;28;0.83
12;418;973;975;2;28;0.83
12;419;975;977;2;28;0.83
12;420;977;978;1;28;0.83
12;421;978;979;1;28;0.83
12;422;979;980;1;28;0.83
12;423;980;981;1;28;0.83
12;424;981;983;2;28;0.83
12;425;983;985;2;28;0.83
12;426;985;988;3;28;0.83
12;427;988;989;1;28;0.83
12;428;989;992;3;28;0.83
12;429;992;993;1;28;0.83
12;430;993;995;2;28;0.83
12;431;995;997;2;28;0.83
12;432;997;998;1;28;0.83
12;433;998;999;1;28;0.83
12;434;999;1000;1;28;0.83
12;435;1000;1002;2;28;0.83
12;436;1002;1003;1;28;0.83
12;437;1003;1005;2;28;0.83
12;438;1005;1007;2;28;0.83
12;439;1007;1008;1;28;0.83
12;440;1008;1009;1;28;0.83
12;441;1009;1011;2;28;0.83
12;442;1011;1012;1;28;0.83
12;443;1012;1014;2;28;0.83
12;444;1014;1015;1;28;0.83
12;445;1015;1017;2;28;0.83
12;446;1017;1018;1;28;0.83
12;447;1018;1019;1;28;0.83
12;448;1019;1020;1;28;0.83
12;449;1020;1021;1;28;0.83
12;450;1021;1023;2;28;0.83
12;451;1023;1026;3;28;0.83
12;452;1026;1027;1;28;0.83
12;453;1027;1028;1;28;0.83
12;454;1028;1029;1;28;0.83
12;455;1029;1030;1;28;0.83
12;456;1030;1032;2;28;0.83
12;457;1032;1033;1;28;0.83
12;458;1033;1037;4;28;0.83
12;459;1037;1038;1;28;0.83
12;460;1038;1039;1;28;0.83
12;461;1039;1041;2;28;0.83
12;462;1041;1043;2;28;0.83
12;463;1043;1044;1;28;0.83
12;464;1044;1045;1;28;0.83
12;465;1045;1047;2;28;0.83
12;466;1047;1048;1;28;0.83
12;467;1048;1049;1;28;0.83
12;468;1049;1053;4;28;0.83
12;469;1053;1055;2;28;0.83
12;470;1055;1057;2;28;0.83
12;471;1057;1058;1;28;0.83
12;472;1058;1059;1;28;0.83
12;473;1059;1060;1;28;0.83
12;474;1060;1062;2;28;0.83
12;475;1062;1063;1;28;0.83
12;476;1063;1065;2;28;0.83
12;477;1065;1067;2;28;0.83
12;478;1067;1068;1;28;0.83
12;479;1068;1069;1;28;0.83
12;480;1069;1071;2;28;0.83
12;481;1071;1075;4;28;0.83
12;482;1075;1076;1;28;0.83
12;483;1076;1077;1;28;0.83
12;484;1077;1078;1;28;0.83
12;485;1078;1079;1;28;0.83
12;486;1079;1083;4;28;0.83
12;487;1083;1084;1;28;0.83
12;488;1084;1085;1;28;0.83
12;489;1085;1087;2;28;0.83
12;490;1087;1088;1;28;0.83
12;491;1088;1089;1;28;0.83
12;492;1089;1090;1;28;0.83
12;493;1090;1093;3;28;0.83
12;494;1093;1094;1;28;0.83
12;495;1094;1095;1;28;0.83
12;496;1095;1097;2;28;0.83
12;497;1097;1098;1;28;0.83
12;498;1098;1100;2;28;0.83
12;499;1100;1101;1;28;0.83
12;500;1101;1103;2;28;0.83
12;501;1103;1105;2;28;0.83
12;502;1105;1107;2;28;0.83
12;503;1107;1108;1;28;0.83
12;504;1108;1109;1;28;0.83
12;505;1109;1110;1;28;0.83
12;506;1110;1111;1;28;0.83
12;507;1111;1112;1;28;0.83
12;508;1112;1113;1;28;0.83
12;509;1113;1117;4;28;0.83
12;510;1117;1120;3;28;0.83
12;511;1120;1121;1;28;0.83
12;512;1121;1125;4;28;0.83
12;513;1125;1128;3;28;0.83
12;514;1128;1132;4;28;0.83
12;515;1132;1134;2;28;0.83
12;516;1134;1137;3;28;0.83
12;517;1137;1139;2;28;0.83
12;518;1139;1140;1;28;0.83
12;519;1140;1141;1;28;0.83
12;520;1141;1142;1;28;0.83
12;521;1142;1145;3;28;0.83
12;522;1145;1147;2;28;0.83
12;523;1147;1150;3;28;0.83
12;524;1150;1152;2;28;0.83
12;525;1152;1153;1;28;0.83
12;526;1153;1155;2;28;0.83
12;527;1155;1157;2;28;0.83
12;528;1157;1160;3;28;0.83
12;529;1160;1162;2;28;0.83
12;530;1162;1170;8;28;0.83
12;531;1170;1171;1;28;0.83
12;532;1171;1174;3;28;0.83
12;533;1174;1175;1;28;0.83
12;534;1175;1176;1;28;0.83
12;535;1176;1177;1;28;0.83
12;536;1177;1178;1;28;0.83
12;537;1178;1180;2;28;0.83
12;538;1180;1181;1;28;0.83
12;539;1181;1182;1;28;0.83
12;540;1182;1186;4;28;0.83
12;541;1186;1188;2;28;0.83
12;542;1188;1189;1;28;0.83
12;543;1189;1195;6;28;0.83
12;544;1195;1197;2;28;0.83
12;545;1197;1199;2;28;0.83
12;546;1199;1200;1;28;0.83
12;547;1200;1202;2;28;0.83
12;548;1202;1205;3;28;0.83
12;549;1205;1209;4;28;0.83
12;550;1209;1210;1;28;0.83
12;551;1210;1215;5;28;0.83
12;552;1215;1217;2;28;0.83
12;553;1217;1221;4;28;0.83
12;554;1221;1222;1;28;0.83
12;555;1222;1223;1;28;0.83
12;556;1223;1225;2;28;0.83
12;557;1225;1226;1;28;0.83
12;558;1226;1227;1;28;0.83
12;559;1227;1228;1;28;0.83
12;560;1228;1230;2;28;0.83
12;561;1230;1231;1;28;0.83
12;562;1231;1232;1;28;0.83
12;563;1232;1235;3;28;0.83
12;564;1235;1237;2;28;0.83
12;565;1237;1247;10;28;0.83
12;566;1247;1250;3;28;0.83
12;567;1250;1252;2;28;0.83
12;568;1252;1253;1;28;0.83
12;569;1253;1256;3;28;0.83
12;570;1256;1258;2;28;0.83
12;571;1258;1260;2;28;0.83
12;572;1260;1262;2;28;0.83
12;573;1262;1263;1;28;0.83
12;574;1263;1266;3;28;0.83
12;575;1266;1267;1;28;0.83
12;576;1267;1268;1;28;0.83
12;577;1268;1269;1;28;0.83
12;578;1269;1271;2;28;0.83
12;579;1271;1272;1;28;0.83
12;580;1272;1275;3;28;0.83
12;581;1275;1277;2;28;0.83
12;582;1277;1280;3;28;0.83
12;583;1280;1281;1;28;0.83
12;584;1281;1282;1;28;0.83
12;585;1282;1284;2;28;0.83
12;586;1284;1285;1;28;0.83
12;587;1285;1291;6;28;0.83
12;588;1291;1296;5;28;0.83
12;589;1296;1299;3;28;0.83
12;590;1299;1300;1;28;0.83
12;591;1300;1302;2;28;0.83
12;592;1302;1305;3;28;0.83
12;593;1305;1307;2;28;0.83
12;594;1307;1309;2;28;0.83
12;595;1309;1310;1;28;0.83
12;596;1310;1312;2;28;0.83
12;597;1312;1316;4;28;0.83
12;598;1316;1321;5;28;0.83
12;599;1321;1322;1;28;0.83
12;600;1322;1323;1;28;0.83
12;601;1323;1326;3;28;0.83
12;602;1326;1327;1;28;0.83
12;603;1327;1330;3;28;0.83
12;604;1330;1332;2;28;0.83
12;605;1332;1334;2;28;0.83
12;606;1334;1335;1;28;0.83
12;607;1335;1337;2;28;0.83
12;608;1337;1338;1;28;0.83
12;609;1338;1341;3;28;0.83
12;610;1341;1342;1;28;0.83
12;611;1342;1344;2;28;0.83
12;612;1344;1345;1;28;0.83
12;613;1345;1347;2;28;0.83
12;614;1347;1350;3;28;0.83
12;615;1350;1357;7;28;0.83
12;616;1357;1360;3;28;0.83
12;617;1360;1362;2;28;0.83
12;618;1362;1363;1;28;0.83
12;619;1363;1364;1;28;0.83
12;620;1364;1365;1;28;0.83
12;621;1365;1366;1;28;0.83
12;622;1366;1371;5;28;0.83
12;623;1371;1374;3;28;0.83
12;624;1374;1376;2;28;0.83
12;625;1376;1378;2;28;0.83
12;626;1378;1379;1;28;0.83
12;627;1379;1380;1;28;0.83
12;628;1380;1382;2;28;0.83
12;629;1382;1385;3;28;0.83
12;630;1385;1386;1;28;0.83
12;631;1386;1387;1;28;0.83
12;632;1387;1394;7;28;0.83
12;633;1394;1409;15;28;0.83
12;634;1409;1424;15;28;0.83
12;635;1424;1439;15;28;0.83
12;636;1439;1454;15;28;0.83
12;637;1454;1469;15;28;0.83
12;638;1469;1484;15;28;0.83
12;639;1484;1499;15;28;0.83
12;640;1499;1514;15;28;0.83
12;641;1514;1529;15;28;0.83
12;642;1529;1544;15;28;0.83
12;643;1544;1559;15;28;0.83
12;644;1559;1574;15;28;0.83
12;645;1574;1589;15;28;0.83
12;646;1589;1604;15;28;0.83
12;647;1604;1619;15;28;0.83
12;648;1619;1634;15;28;0.83
12;649;1634;1649;15;28;0.83
12;650;1649;1664;15;28;0.83
12;651;1664;1679;15;28;0.83
12;652;1679;1680;1;28;0.83
13;0;240;282;42;28;0.83
13;1;282;325;43;28;0.83
13;2;325;326;1;28;0.83
13;3;326;329;3;28;0.83
13;4;329;330;1;28;0.83
13;5;330;331;1;28;0.83
13;6;331;333;2;28;0.83
13;7;333;334;1;28;0.83
13;8;334;336;2;28;0.83
13;9;336;337;1;28;0.83
13;10;337;338;1;28;0.83
13;11;338;339;1;28;0.83
13;12;339;342;3;28;0.83
13;13;342;344;2;28;0.83
13;14;344;345;1;28;0.83
13;15;345;346;1;28;0.83
13;16;346;348;2;28;0.83
13;17;348;349;1;28;0.83
13;18;349;351;2;28;0.83
13;19;351;352;1;28;0.83
13;20;352;353;1;28;0.83
13;21;353;354;1;28;0.83
13;22;354;355;1;28;0.83
13;23;355;356;1;28;0.83
13;24;356;357;1;28;0.83
13;25;357;358;1;28;0.83
13;26;358;360;2;28;0.83
13;27;360;361;1;28;0.83
13;28;361;362;1;28;0.83
13;29;362;365;3;28;0.83
13;30;365;366;1;28;0.83
13;31;366;367;1;28;0.83
13;32;367;368;1;28;0.83
13;33;368;369;1;28;0.83
13;34;369;371;2;28;0.83
13;35;371;375;4;28;0.83
13;36;375;377;2;28;0.83
13;37;377;378;1;28;0.83
13;38;378;379;1;28;0.83
13;39;379;380;1;28;0.83
13;40;380;381;1;28;0.83
13;41;381;382;1;28;0.83
13;42;382;383;1;28;0.83
13;43;383;384;1;28;0.83
13;44;384;385;1;28;0.83
13;45;385;387;2;28;0.83
13;46;387;388;1;28;0.83
13;47;388;391;3;28;0.83
13;48;391;392;1;28;0.83
13;49;392;393;1;28;0.83
13;50;393;394;1;28;0.83
13;51;394;395;1;28;0.83
13;52;395;396;1;28;0.83
13;53;396;397;1;28;0.83
13;54;397;398;1;28;0.83
13;55;398;399;1;28;0.83
13;56;399;401;2;28;0.83
13;57;401;403;2;28;0.83
13;58;403;404;1;28;0.83
13;59;404;405;1;28;0.83
13;60;405;406;1;28;0.83
13;61;406;408;2;28;0.83
13;62;408;409;1;28;0.83
13;63;409;412;3;28;0.83
13;64;412;413;1;28;0.83
13;65;413;415;2;28;0.83
13;66;415;416;1;28;0.83
13;67;416;417;1;28;0.83
13;68;417;418;1;28;0.83
13;69;418;419;1;28;0.83
13;70;419;420;1;28;0.83
13;71;420;421;1;28;0.83
13;72;421;422;1;28;0.83
13;73;422;423;1;28;0.83
13;74;423;425;2;28;0.83
13;75;425;427;2;28;0.83
13;76;427;428;1;28;0.83
13;77;428;429;1;28;0.83
13;78;429;431;2;28;0.83
13;79;431;432;1;28;0.83
13;80;432;433;1;28;0.83
13;81;433;435;2;28;0.83
13;82;435;436;1;28;0.83
13;83;436;438;2;28;0.83
13;84;438;439;1;28;0.83
13;85;439;442;3;28;0.83
13;86;442;443;1;28;0.83
13;87;443;444;1;28;0.83
13;88;444;445;1;28;0.83
13;89;445;446;1;28;0.83
13;90;446;447;1;28;0.83
13;91;447;448;1;28;0.83
13;92;448;450;2;28;0.83
13;93;450;451;1;28;0.83
13;94;451;452;1;28;0.83
13;95;452;453;1;28;0.83
13;96;453;454;1;28;0.83
13;97;454;455;1;28;0.83
13;98;455;457;2;28;0.83
13;99;457;458;1;28;0.83
13;100;458;459;1;28;0.83
13;101;459;462;3;28;0.83
13;102;462;463;1;28;0.83
13;103;463;465;2;28;0.83
13;104;465;466;1;28;0.83
13;105;466;467;1;28;0.83
13;106;467;468;1;28;0.83
13;107;468;469;1;28;0.83
13;108;469;471;2;28;0.83
13;109;471;472;1;28;0.83
13;110;472;473;1;28;0.83
13;111;473;475;2;28;0.83
13;112;475;476;1;28;0.83
13;113;476;478;2;28;0.83
13;114;478;479;1;28;0.83
13;115;479;480;1;28;0.83
13;116;480;481;1;28;0.83
13;117;481;482;1;28;0.83
13;118;482;483;1;28;0.83
13;119;483;484;1;28;0.83
13;120;484;485;1;28;0.83
13;121;485;488;3;28;0.83
13;122;488;489;1;28;0.83
13;123;489;492;3;28;0.83
13;124;492;493;1;28;0.83
13;125;493;494;1;28;0.83
13;126;494;495;1;28;0.83
13;127;495;496;1;28;0.83
13;128;496;498;2;28;0.83
13;129;498;499;1;28;0.83
13;130;499;501;2;28;0.83
13;131;501;503;2;28;0.83
13;132;503;504;1;28;0.83
13;133;504;505;1;28;0.83
13;134;505;508;3;28;0.83
13;135;508;512;4;28;0.83
13;136;512;513;1;28;0.83
13;137;513;514;1;28;0.83
13;138;514;515;1;28;0.83
13;139;515;517;2;28;0.83
13;140;517;518;1;28;0.83
13;141;518;519;1;28;0.83
13;142;519;520;1;28;0.83
13;143;520;521;1;28;0.83
13;144;521;522;1;28;0.83
13;145;522;523;1;28;0.83
13;146;523;525;2;28;0.83
13;147;525;528;3;28;0.83
13;148;528;529;1;28;0.83
13;149;529;531;2;28;0.83
13;150;531;532;1;28;0.83
13;151;532;533;1;28;0.83
13;152;533;537;4;28;0.83
13;153;537;538;1;28;0.83
13;154;538;539;1;28;0.83
13;155;539;540;1;28;0.83
13;156;540;543;3;28;0.83
13;157;543;544;1;28;0.83
13;158;544;545;1;28;0.83
13;159;545;547;2;28;0.83
13;160;547;548;1;28;0.83
13;161;548;549;1;28;0.83
13;162;549;550;1;28;0.83
13;163;550;553;3;28;0.83
13;164;553;555;2;28;0.83
13;165;555;556;1;28;0.83
13;166;556;557;1;28;0.83
13;167;557;558;1;28;0.83
13;168;558;559;1;28;0.83
13;169;559;563;4;28;0.83
13;170;563;565;2;28;0.83
13;171;565;568;3;28;0.83
13;172;568;569;1;28;0.83
13;173;569;572;3;28;0.83
13;174;572;574;2;28;0.83
13;175;574;576;2;28;0.83
13;176;576;577;1;28;0.83
13;177;577;578;1;28;0.83
13;178;578;579;1;28;0.83
13;179;579;583;4;28;0.83
13;180;583;585;2;28;0.83
13;181;585;588;3;28;0.83
13;182;588;590;2;28;0.83
13;183;590;591;1;28;0.83
13;184;591;592;1;28;0.83
13;185;592;593;1;28;0.83
13;186;593;595;2;28;0.83
13;187;595;597;2;28;0.83
13;188;597;598;1;28;0.83
13;189;598;599;1;28;0.83
13;190;599;603;4;28;0.83
13;191;603;605;2;28;0.83
13;192;605;607;2;28;0.83
13;193;607;608;1;28;0.83
13;194;608;609;1;28;0.83
13;195;609;615;6;28;0.83
13;196;615;617;2;28;0.83
13;197;617;618;1;28;0.83
13;198;618;619;1;28;0.83
13;199;619;623;4;28;0.83
13;200;623;625;2;28;0.83
13;201;625;627;2;28;0.83
13;202;627;628;1;28;0.83
13;203;628;629;1;28;0.83
13;204;629;632;3;28;0.83
13;205;632;633;1;28;0.83
13;206;633;637;4;28;0.83
13;207;637;638;1;28;0.83
13;208;638;639;1;28;0.83
13;209;639;643;4;28;0.83
13;210;643;645;2;28;0.83
13;211;645;648;3;28;0.83
13;212;648;651;3;28;0.83
13;213;651;652;1;28;0.83
13;214;652;653;1;28;0.83
13;215;653;655;2;28;0.83
13;216;655;656;1;28;0.83
13;217;656;657;1;28;0.83
13;218;657;658;1;28;0.83
13;219;658;659;1;28;0.83
13;220;659;660;1;28;0.83
13;221;660;663;3;28;0.83
13;222;663;665;2;28;0.83
13;223;665;666;1;28;0.83
13;224;666;668;2;28;0.83
13;225;668;669;1;28;0.83
13;226;669;671;2;28;0.83
13;227;671;673;2;28;0.83
13;228;673;677;4;28;0.83
13;229;677;678;1;28;0.83
13;230;678;679;1;28;0.83
13;231;679;681;2;28;0.83
13;232;681;683;2;28;0.83
13;233;683;685;2;28;0.83
13;234;685;688;3;28;0.83
13;235;688;689;1;28;0.83
13;236;689;692;3;28;0.83
13;237;692;693;1;28;0.83
13;238;693;695;2;28;0.83
13;239;695;697;2;28;0.83
13;240;697;698;1;28;0.83
13;241;698;699;1;28;0.83
13;242;699;700;1;28;0.83
13;243;700;703;3;28;0.83
13;244;703;704;1;28;0.83
13;245;704;705;1;28;0.83
13;246;705;707;2;28;0.83
13;247;707;708;1;28;0.83
13;248;708;712;4;28;0.83
13;249;712;713;1;28;0.83
13;250;713;715;2;28;0.83
13;251;715;717;2;28;0.83
13;252;717;718;1;28;0.83
13;253;718;719;1;28;0.83
13;254;719;721;2;28;0.83
13;255;721;723;2;28;0.83
13;256;723;725;2;28;0.83
13;257;725;728;3;28;0.83
13;258;728;729;1;28;0.83
13;259;729;735;6;28;0.83
13;260;735;736;1;28;0.83
13;261;736;737;1;28;0.83
13;262;737;738;1;28;0.83
13;263;738;739;1;28;0.83
13;264;739;743;4;28;0.83
13;265;743;745;2;28;0.83
13;266;745;746;1;28;0.83
13;267;746;748;2;28;0.83
13;268;748;749;1;28;0.83
13;269;749;752;3;28;0.83
13;270;752;757;5;28;0.83
13;271;757;758;1;28;0.83
13;272;758;759;1;28;0.83
13;273;759;760;1;28;0.83
13;274;760;763;3;28;0.83
13;275;763;765;2;28;0.83
13;276;765;766;1;28;0.83
13;277;766;768;2;28;0.83
13;278;768;772;4;28;0.83
13;279;772;773;1;28;0.83
13;280;773;774;1;28;0.83
13;281;774;775;1;28;0.83
13;282;775;777;2;28;0.83
13;283;777;778;1;28;0.83
13;284;778;779;1;28;0.83
13;285;779;783;4;28;0.83
13;286;783;784;1;28;0.83
13;287;784;785;1;28;0.83
13;288;785;788;3;28;0.83
13;289;788;789;1;28;0.83
13;290;789;792;3;28;0.83
13;291;792;793;1;28;0.83
13;292;793;795;2;28;0.83
13;293;795;797;2;28;0.83
13;294;797;798;1;28;0.83
13;295;798;799;1;28;0.83
13;296;799;800;1;28;0.83
13;297;800;801;1;28;0.83
13;298;801;803;2;28;0.83
13;299;803;804;1;28;0.83
13;300;804;805;1;28;0.83
13;301;805;806;1;28;0.83
13;302;806;808;2;28;0.83
13;303;808;812;4;28;0.83
13;304;812;814;2;28;0.83
13;305;814;815;1;28;0.83
13;306;815;817;2;28;0.83
13;307;817;818;1;28;0.83
13;308;818;819;1;28;0.83
13;309;819;820;1;28;0.83
13;310;820;821;1;28;0.83
13;311;821;823;2;28;0.83
13;312;823;825;2;28;0.83
13;313;825;828;3;28;0.83
13;314;828;829;1;28;0.83
13;315;829;830;1;28;0.83
13;316;830;832;2;28;0.83
13;317;832;833;1;28;0.83
13;318;833;834;1;28;0.83
13;319;834;835;1;28;0.83
13;320;835;836;1;28;0.83
13;321;836;837;1;28;0.83
13;322;837;838;1;28;0.83
13;323;838;839;1;28;0.83
13;324;839;841;2;28;0.83
13;325;841;843;2;28;0.83
13;326;843;845;2;28;0.83
13;327;845;847;2;28;0.83
13;328;847;848;1;28;0.83
13;329;848;849;1;28;0.83
13;330;849;850;1;28;0.83
13;331;850;852;2;28;0.83
13;332;852;854;2;28;0.83
13;333;854;855;1;28;0.83
13;334;855;857;2;28;0.83
13;335;857;858;1;28;0.83
13;336;858;859;1;28;0.83
13;337;859;861;2;28;0.83
13;338;861;862;1;28;0.83
13;339;862;863;1;28;0.83
13;340;863;865;2;28;0.83
13;341;865;866;1;28;0.83
13;342;866;868;2;28;0.83
13;343;868;869;1;28;0.83
13;344;869;870;1;28;0.83
13;345;870;871;1;28;0.83
13;346;871;872;1;28;0.83
13;347;872;873;1;28;0.83
13;348;873;875;2;28;0.83
13;349;875;876;1;28;0.83
13;350;876;877;1;28;0.83
13;351;877;878;1;28;0.83
13;352;878;879;1;28;0.83
13;353;879;880;1;28;0.83
13;354;880;883;3;28;0.83
13;355;883;885;2;28;0.83
13;356;885;887;2;28;0.83
13;357;887;888;1;28;0.83
13;358;888;889;1;28;0.83
13;359;889;892;3;28;0.83
13;360;892;893;1;28;0.83
13;361;893;895;2;28;0.83
13;362;895;897;2;28;0.83
13;363;897;898;1;28;0.83
13;364;898;899;1;28;0.83
13;365;899;901;2;28;0.83
13;366;901;902;1;28;0.83
13;367;902;903;1;28;0.83
13;368;903;905;2;28;0.83
13;369;905;907;2;28;0.83
13;370;907;908;1;28;0.83
13;371;908;909;1;28;0.83
13;372;909;910;1;28;0.83
13;373;910;911;1;28;0.83
13;374;911;912;1;28;0.83
13;375;912;913;1;28;0.83
13;376;913;915;2;28;0.83
13;377;915;917;2;28;0.83
13;378;917;918;1;28;0.83
13;379;918;919;1;28;0.83
13;380;919;920;1;28;0.83
13;381;920;922;2;28;0.83
13;382;922;923;1;28;0.83
13;383;923;925;2;28;0.83
13;384;925;926;1;28;0.83
13;385;926;928;2;28;0.83
13;386;928;929;1;28;0.83
13;387;929;931;2;28;0.83
13;388;931;932;1;28;0.83
13;389;932;933;1;28;0.83
13;390;933;935;2;28;0.83
13;391;935;937;2;28;0.83
13;392;937;938;1;28;0.83
13;393;938;939;1;28;0.83
13;394;939;940;1;28;0.83
13;395;940;942;2;28;0.83
13;396;942;943;1;28;0.83
13;397;943;945;2;28;0.83
13;398;945;947;2;28;0.83
13;399;947;948;1;28;0.83
13;400;948;949;1;28;0.83
13;401;949;952;3;28;0.83
13;402;952;953;1;28;0.83
13;403;953;955;2;28;0.83
13;404;955;956;1;28;0.83
13;405;956;957;1;28;0.83
13;406;957;958;1;28;0.83
13;407;958;959;1;28;0.83
13;408;959;962;3;28;0.83
13;409;962;963;1;28;0.83
13;410;963;965;2;28;0.83
13;411;965;966;1;28;0.83
13;412;966;967;1;28;0.83
13;413;967;968;1;28;0.83
13;414;968;969;1;28;0.83
13;415;969;970;1;28;0.83
13;416;970;972;2;28;0.83
13;417;972;973;1;28;0.83
13;418;973;975;2;28;0.83
13;419;975;977;2;28;0.83
13;420;977;978;1;28;0.83
13;421;978;979;1;28;0.83
13;422;979;980;1;28;0.83
13;423;980;981;1;28;0.83
13;424;981;983;2;28;0.83
13;425;983;985;2;28;0.83
13;426;985;988;3;28;0.83
13;427;988;989;1;28;0.83
13;428;989;992;3;28;0.83
13;429;992;993;1;28;0.83
13;430;993;995;2;28;0.83
13;431;995;997;2;28;0.83
13;432;997;998;1;28;0.83
13;433;998;999;1;28;0.83
13;434;999;1000;1;28;0.83
13;435;1000;1002;2;28;0.83
13;436;1002;1003;1;28;0.83
13;437;1003;1005;2;28;0.83
13;438;1005;1007;2;28;0.83
13;439;1007;1008;1;28;0.83
13;440;1008;1009;1;28;0.83
13;441;1009;1011;2;28;0.83
13;442;1011;1012;1;28;0.83
13;443;1012;1014;2;28;0.83
13;444;1014;1015;1;28;0.83
13;445;1015;1017;2;28;0.83
13;446;1017;1018;1;28;0.83
13;447;1018;1019;1;28;0.83
13;448;1019;1020;1;28;0.83
13;449;1020;1021;1;28;0.83
13;450;1021;1023;2;28;0.83
13;451;1023;1026;3;28;0.83
13;452;1026;1027;1;28;0.83
13;453;1027;1028;1;28;0.83
13;454;1028;1029;1;28;0.83
13;455;1029;1030;1;28;0.83
13;456;1030;1032;2;28;0.83
13;457;1032;1033;1;28;0.83
13;458;1033;1037;4;28;0.83
13;459;1037;1038;1;28;0.83
13;460;1038;1039;1;28;0.83
13;461;1039;1041;2;28;0.83
13;462;1041;1043;2;28;0.83
13;463;1043;1044;1;28;0.83
13;464;1044;1045;1;28;0.83
13;465;1045;1047;2;28;0.83
13;466;1047;1048;1;28;0.83
13;467;1048;1049;1;28;0.83
13;468;1049;1053;4;28;0.83
13;469;1053;1055;2;28;0.83
13;470;1055;1057;2;28;0.83
13;471;1057;1058;1;28;0.83
13;472;1058;1059;1;28;0.83
13;473;1059;1060;1;28;0.83
13;474;1060;1062;2;28;0.83
13;475;1062;1063;1;28;0.83
13;476;1063;1065;2;28;0.83
13;477;1065;1067;2;28;0.83
13;478;1067;1068;1;28;0.83
13;479;1068;1069;1;28;0.83
13;480;1069;1071;2;28;0.83
13;481;1071;1075;4;28;0.83
13;482;1075;1076;1;28;0.83
13;483;1076;1077;1;28;0.83
13;484;1077;1078;1;28;0.83
13;485;1078;1079;1;28;0.83
13;486;1079;1083;4;28;0.83
13;487;1083;1084;1;28;0.83
13;488;1084;1085;1;28;0.83
13;489;1085;1087;2;28;0.83
13;490;1087;1088;1;28;0.83
13;491;1088;1089;1;28;0.83
13;492;1089;1090;1;28;0.83
13;493;1090;1093;3;28;0.83
13;494;1093;1094;1;28;0.83
13;495;1094;1095;1;28;0.83
13;496;1095;1097;2;28;0.83
13;497;1097;1098;1;28;0.83
13;498;1098;1100;2;28;0.83
13;499;1100;1101;1;28;0.83
13;500;1101;1103;2;28;0.83
13;501;1103;1105;2;28;0.83
13;502;1105;1107;2;28;0.83
13;503;1107;1108;1;28;0.83
13;504;1108;1109;1;28;0.83
13;505;1109;1110;1;28;0.83
13;506;1110;1111;1;28;0.83
13;507;1111;1112;1;28;0.83
13;508;1112;1113;1;28;0.83
13;509;1113;1117;4;28;0.83
13;510;1117;1120;3;28;0.83
13;511;1120;1121;1;28;0.83
13;512;1121;1125;4;28;0.83
13;513;1125;1128;3;28;0.83
13;514;1128;1132;4;28;0.83
13;515;1132;1134;2;28;0.83
13;516;1134;1137;3;28;0.83
13;517;1137;1139;2;28;0.83
13;518;1139;1140;1;28;0.83
13;519;1140;1141;1;28;0.83
13;520;1141;1142;1;28;0.83
13;521;1142;1145;3;28;0.83
13;522;1145;1147;2;28;0.83
13;523;1147;1150;3;28;0.83
13;524;1150;1152;2;28;0.83
13;525;1152;1153;1;28;0.83
13;526;1153;1155;2;28;0.83
13;527;1155;1157;2;28;0.83
13;528;1157;1160;3;28;0.83
13;529;1160;1162;2;28;0.83
13;530;1162;1170;8;28;0.83
13;531;1170;1171;1;28;0.83
13;532;1171;1174;3;28;0.83
13;533;1174;1175;1;28;0.83
13;534;1175;1176;1;28;0.83
13;535;1176;1177;1;28;0.83
13;536;1177;1178;1;28;0.83
13;537;1178;1180;2;28;0.83
13;538;1180;1181;1;28;0.83
13;539;1181;1182;1;28;0.83
13;540;1182;1186;4;28;0.83
13;541;1186;1188;2;28;0.83
13;542;1188;1189;1;28;0.83
13;543;1189;1195;6;28;0.83
13;544;1195;1197;2;28;0.83
13;545;1197;1199;2;28;0.83
13;546;1199;1200;1;28;0.83
13;547;1200;1202;2;28;0.83
13;548;1202;1205;3;28;0.83
13;549;1205;1209;4;28;0.83
13;550;1209;1210;1;28;0.83
13;551;1210;1215;5;28;0.83
13;552;1215;1217;2;28;0.83
13;553;1217;1221;4;28;0.83
13;554;1221;1222;1;28;0.83
13;555;1222;1223;1;28;0.83
13;556;1223;1225;2;28;0.83
13;557;1225;1226;1;28;0.83
13;558;1226;1227;1;28;0.83
13;559;1227;1228;1;28;0.83
13;560;1228;1230;2;28;0.83
13;561;1230;1231;1;28;0.83
13;562;1231;1232;1;28;0.83
13;563;1232;1235;3;28;0.83
13;564;1235;1237;2;28;0.83
13;565;1237;1247;10;28;0.83
13;566;1247;1250;3;28;0.83
13;567;1250;1252;2;28;0.83
13;568;1252;1253;1;28;0.83
13;569;1253;1256;3;28;0.83
13;570;1256;1258;2;28;0.83
13;571;1258;1260;2;28;0.83
13;572;1260;1262;2;28;0.83
13;573;1262;1263;1;28;0.83
13;574;1263;1266;3;28;0.83
13;575;1266;1267;1;28;0.83
13;576;1267;1268;1;28;0.83
13;577;1268;1269;1;28;0.83
13;578;1269;1271;2;28;0.83
13;579;1271;1272;1;28;0.83
13;580;1272;1275;3;28;0.83
13;581;1275;1277;2;28;0.83
13;582;1277;1280;3;28;0.83
13;583;1280;1281;1;28;0.83
13;584;1281;1282;1;28;0.83
13;585;1282;1284;2;28;0.83
13;586;1284;1285;1;28;0.83
13;587;1285;1291;6;28;0.83
13;588;1291;1296;5;28;0.83
13;589;1296;1299;3;28;0.83
13;590;1299;1300;1;28;0.83
13;591;1300;1302;2;28;0.83
13;592;1302;1305;3;28;0.83
13;593;1305;1307;2;28;0.83
13;594;1307;1309;2;28;0.83
13;595;1309;1310;1;28;0.83
13;596;1310;1312;2;28;0.83
13;597;1312;1316;4;28;0.83
13;598;1316;1321;5;28;0.83
13;599;1321;1322;1;28;0.83
13;600;1322;1323;1;28;0.83
13;601;1323;1326;3;28;0.83
13;602;1326;1327;1;28;0.83
13;603;1327;1330;3;28;0.83
13;604;1330;1332;2;28;0.83
13;605;1332;1334;2;28;0.83
13;606;1334;1335;1;28;0.83
13;607;1335;1337;2;28;0.83
13;608;1337;1338;1;28;0.83
13;609;1338;1341;3;28;0.83
13;610;1341;1342;1;28;0.83
13;611;1342;1344;2;28;0.83
13;612;1344;1345;1;28;0.83
13;613;1345;1347;2;28;0.83
13;614;1347;1350;3;28;0.83
13;615;1350;1357;7;28;0.83
13;616;1357;1360;3;28;0.83
13;617;1360;1362;2;28;0.83
13;618;1362;1363;1;28;0.83
13;619;1363;1364;1;28;0.83
13;620;1364;1365;1;28;0.83
13;621;1365;1366;1;28;0.83
13;622;1366;1371;5;28;0.83
13;623;1371;1374;3;28;0.83
13;624;1374;1376;2;28;0.83
13;625;1376;1378;2;28;0.83
13;626;1378;1379;1;28;0.83
13;627;1379;1380;1;28;0.83
13;628;1380;1382;2;28;0.83
13;629;1382;1385;3;28;0.83
13;630;1385;1386;1;28;0.83
13;631;1386;1387;1;28;0.83
13;632;1387;1394;7;28;0.83
13;633;1394;1409;15;28;0.83
13;634;1409;1424;15;28;0.83
13;635;1424;1439;15;28;0.83
13;636;1439;1454;15;28;0.83
13;637;1454;1469;15;28;0.83
13;638;1469;1484;15;28;0.83
13;639;1484;1499;15;28;0.83
13;640;1499;1514;15;28;0.83
13;641;1514;1529;15;28;0.83
13;642;1529;1544;15;28;0.83
13;643;1544;1559;15;28;0.83
13;644;1559;1574;15;28;0.83
13;645;1574;1589;15;28;0.83
13;646;1589;1604;15;28;0.83
13;647;1604;1619;15;28;0.83
13;648;1619;1634;15;28;0.83
13;649;1634;1649;15;28;0.83
13;650;1649;1664;15;28;0.83
13;651;1664;1679;15;28;0.83
13;652;1679;1680;1;28;0.83
14;0;240;282;42;28;0.83
14;1;282;325;43;28;0.83
14;2;325;326;1;28;0.83
14;3;326;329;3;28;0.83
14;4;329;330;1;28;0.83
14;5;330;331;1;28;0.83
14;6;331;333;2;28;0.83
14;7;333;334;1;28;0.83
14;8;334;336;2;28;0.83
14;9;336;337;1;28;0.83
14;10;337;338;1;28;0.83
14;11;338;339;1;28;0.83
14;12;339;342;3;28;0.83
14;13;342;344;2;28;0.83
14;14;344;345;1;28;0.83
14;15;345;346;1;28;0.83
14;16;346;348;2;28;0.83
14;17;348;349;1;28;0.83
14;18;349;351;2;28;0.83
14;19;351;352;1;28;0.83
14;20;352;353;1;28;0.83
14;21;353;354;1;28;0.83
14;22;354;355;1;28;0.83
14;23;355;356;1;28;0.83
14;24;356;357;1;28;0.83
14;25;357;358;1;28;0.83
14;26;358;360;2;28;0.83
14;27;360;361;1;28;0.83
14;28;361;362;1;28;0.83
14;29;362;365;3;28;0.83
14;30;365;366;1;28;0.83
14;31;366;367;1;28;0.83
14;32;367;368;1;28;0.83
14;33;368;369;1;28;0.83
14;34;369;371;2;28;0.83
14;35;371;375;4;28;0.83
14;36;375;377;2;28;0.83
14;37;377;378;1;28;0.83
14;38;378;379;1;28;0.83
14;39;379;380;1;28;0.83
14;40;380;381;1;28;0.83
14;41;381;382;1;28;0.83
14;42;382;383;1;28;0.83
14;43;383;384;1;28;0.83
14;44;384;385;1;28;0.83
14;45;385;387;2;28;0.83
14;46;387;388;1;28;0.83
14;47;388;391;3;28;0.83
14;48;391;392;1;28;0.83
14;49;392;393;1;28;0.83
14;50;393;394;1;28;0.83
14;51;394;395;1;28;0.83
14;52;395;396;1;28;0.83
14;53;396;397;1;28;0.83
14;54;397;398;1;28;0.83
14;55;398;399;1;28;0.83
14;56;399;401;2;28;0.83
14;57;401;403;2;28;0.83
14;58;403;404;1;28;0.83
14;59;404;405;1;28;0.83
14;60;405;406;1;28;0.83
14;61;406;408;2;28;0.83
14;62;408;409;1;28;0.83
14;63;409;412;3;28;0.83
14;64;412;413;1;28;0.83
14;65;413;415;2;28;0.83
14;66;415;416;1;28;0.83
14;67;416;417;1;28;0.83
14;68;417;418;1;28;0.83
14;69;418;419;1;28;0.83
14;70;419;420;1;28;0.83
14;71;420;421;1;28;0.83
14;72;421;422;1;28;0.83
14;73;422;423;1;28;0.83
14;74;423;425;2;28;0.83
14;75;425;427;2;28;0.83
14;76;427;428;1;28;0.83
14;77;428;429;1;28;0.83
14;78;429;431;2;28;0.83
14;79;431;432;1;28;0.83
14;80;432;433;1;28;0.83
14;81;433;435;2;28;0.83
14;82;435;436;1;28;0.83
14;83;436;438;2;28;0.83
14;84;438;439;1;28;0.83
14;85;439;442;3;28;0.83
14;86;442;443;1;28;0.83
14;87;443;444;1;28;0.83
14;88;444;445;1;28;0.83
14;89;445;446;1;28;0.83
14;90;446;447;1;28;0.83
14;91;447;448;1;28;0.83
14;92;448;450;2;28;0.83
14;93;450;451;1;28;0.83
14;94;451;452;1;28;0.83
14;95;452;453;1;28;0.83
14;96;453;454;1;28;0.83
14;97;454;455;1;28;0.83
14;98;455;457;2;28;0.83
14;99;457;458;1;28;0.83
14;100;458;459;1;28;0.83
14;101;459;462;3;28;0.83
14;102;462;463;1;28;0.83
14;103;463;465;2;28;0.83
14;104;465;466;1;28;0.83
14;105;466;467;1;28;0.83
14;106;467;468;1;28;0.83
14;107;468;469;1;28;0.83
14;108;469;471;2;28;0.83
14;109;471;472;1;28;0.83
14;110;472;473;1;28;0.83
14;111;473;475;2;28;0.83
14;112;475;476;1;28;0.83
14;113;476;478;2;28;0.83
14;114;478;479;1;28;0.83
14;115;479;480;1;28;0.83
14;116;480;481;1;28;0.83
14;117;481;482;1;28;0.83
14;118;482;483;1;28;0.83
14;119;483;484;1;28;0.83
14;120;484;485;1;28;0.83
14;121;485;488;3;28;0.83
14;122;488;489;1;28;0.83
14;123;489;492;3;28;0.83
14;124;492;493;1;28;0.83
14;125;493;494;1;28;0.83
14;126;494;495;1;28;0.83
14;127;495;496;1;28;0.83
14;128;496;498;2;28;0.83
14;129;498;499;1;28;0.83
14;130;499;501;2;28;0.83
14;131;501;503;2;28;0.83
14;132;503;504;1;28;0.83
14;133;504;505;1;28;0.83
14;134;505;508;3;28;0.83
14;135;508;512;4;28;0.83
14;136;512;513;1;28;0.83
14;137;513;514;1;28;0.83
14;138;514;515;1;28;0.83
14;139;515;517;2;28;0.83
14;140;517;518;1;28;0.83
14;141;518;519;1;28;0.83
14;142;519;520;1;28;0.83
14;143;520;521;1;28;0.83
14;144;521;522;1;28;0.83
14;145;522;523;1;28;0.83
14;146;523;525;2;28;0.83
14;147;525;528;3;28;0.83
14;148;528;529;1;28;0.83
14;149;529;531;2;28;0.83
14;150;531;532;1;28;0.83
14;151;532;533;1;28;0.83
14;152;533;537;4;28;0.83
14;153;537;538;1;28;0.83
14;154;538;539;1;28;0.83
14;155;539;540;1;28;0.83
14;156;540;543;3;28;0.83
14;157;543;544;1;28;0.83
14;158;544;545;1;28;0.83
14;159;545;547;2;28;0.83
14;160;547;548;1;28;0.83
14;161;548;549;1;28;0.83
14;162;549;550;1;28;0.83
14;163;550;553;3;28;0.83
14;164;553;555;2;28;0.83
14;165;555;556;1;28;0.83
14;166;556;557;1;28;0.83
14;167;557;558;1;28;0.83
14;168;558;559;1;28;0.83
14;169;559;563;4;28;0.83
14;170;563;565;2;28;0.83
14;171;565;568;3;28;0.83
14;172;568;569;1;28;0.83
14;173;569;572;3;28;0.83
14;174;572;574;2;28;0.83
14;175;574;576;2;28;0.83
14;176;576;577;1;28;0.83
14;177;577;578;1;28;0.83
14;178;578;579;1;28;0.83
14;179;579;583;4;28;0.83
14;180;583;585;2;28;0.83
14;181;585;588;3;28;0.83
14;182;588;590;2;28;0.83
14;183;590;591;1;28;0.83
14;184;591;592;1;28;0.83
14;185;592;593;1;28;0.83
14;186;593;595;2;28;0.83
14;187;595;597;2;28;0.83
14;188;597;598;1;28;0.83
14;189;598;599;1;28;0.83
14;190;599;603;4;28;0.83
14;191;603;605;2;28;0.83
14;192;605;607;2;28;0.83
14;193;607;608;1;28;0.83
14;194;608;609;1;28;0.83
14;195;609;615;6;28;0.83
14;196;615;617;2;28;0.83
14;197;617;618;1;28;0.83
14;198;618;619;1;28;0.83
14;199;619;623;4;28;0.83
14;200;623;625;2;28;0.83
14;201;625;627;2;28;0.83
14;202;627;628;1;28;0.83
14;203;628;629;1;28;0.83
14;204;629;632;3;28;0.83
14;205;632;633;1;28;0.83
14;206;633;637;4;28;0.83
14;207;637;638;1;28;0.83
14;208;638;639;1;28;0.83
14;209;639;643;4;28;0.83
14;210;643;645;2;28;0.83
14;211;645;648;3;28;0.83
14;212;648;651;3;28;0.83
14;213;651;652;1;28;0.83
14;214;652;653;1;28;0.83
14;215;653;655;2;28;0.83
14;216;655;656;1;28;0.83
14;217;656;657;1;28;0.83
14;218;657;658;1;28;0.83
14;219;658;659;1;28;0.83
14;220;659;660;1;28;0.83
14;221;660;663;3;28;0.83
14;222;663;665;2;28;0.83
14;223;665;666;1;28;0.83
14;224;666;668;2;28;0.83
14;225;668;669;1;28;0.83
14;226;669;671;2;28;0.83
14;227;671;673;2;28;0.83
14;228;673;677;4;28;0.83
14;229;677;678;1;28;0.83
14;230;678;679;1;28;0.83
14;231;679;681;2;28;0.83
14;232;681;683;2;28;0.83
14;233;683;685;2;28;0.83
14;234;685;688;3;28;0.83
14;235;688;689;1;28;0.83
14;236;689;692;3;28;0.83
14;237;692;693;1;28;0.83
14;238;693;695;2;28;0.83
14;239;695;697;2;28;0.83
14;240;697;698;1;28;0.83
14;241;698;699;1;28;0.83
14;242;699;700;1;28;0.83
14;243;700;703;3;28;0.83
14;244;703;704;1;28;0.83
14;245;704;705;1;28;0.83
14;246;705;707;2;28;0.83
14;247;707;708;1;28;0.83
14;248;708;712;4;28;0.83
14;249;712;713;1;28;0.83
14;250;713;715;2;28;0.83
14;251;715;717;2;28;0.83
14;252;717;718;1;28;0.83
14;253;718;719;1;28;0.83
14;254;719;721;2;28;0.83
14;255;721;723;2;28;0.83
14;256;723;725;2;28;0.83
14;257;725;728;3;28;0.83
14;258;728;729;1;28;0.83
14;259;729;735;6;28;0.83
14;260;735;736;1;28;0.83
14;261;736;737;1;28;0.83
14;262;737;738;1;28;0.83
14;263;738;739;1;28;0.83
14;264;739;743;4;28;0.83
14;265;743;745;2;28;0.83
14;266;745;746;1;28;0.83
14;267;746;748;2;28;0.83
14;268;748;749;1;28;0.83
14;269;749;752;3;28;0.83
14;270;752;757;5;28;0.83
14;271;757;758;1;28;0.83
14;272;758;759;1;28;0.83
14;273;759;760;1;28;0.83
14;274;760;763;3;28;0.83
14;275;763;765;2;28;0.83
14;276;765;766;1;28;0.83
14;277;766;768;2;28;0.83
14;278;768;772;4;28;0.83
14;279;772;773;1;28;0.83
14;280;773;774;1;28;0.83
14;281;774;775;1;28;0.83
14;282;775;777;2;28;0.83
14;283;777;778;1;28;0.83
14;284;778;779;1;28;0.83
14;285;779;783;4;28;0.83
14;286;783;784;1;28;0.83
14;287;784;785;1;28;0.83
14;288;785;788;3;28;0.83
14;289;788;789;1;28;0.83
14;290;789;792;3;28;0.83
14;291;792;793;1;28;0.83
14;292;793;795;2;28;0.83
14;293;795;797;2;28;0.83
14;294;797;798;1;28;0.83
14;295;798;799;1;28;0.83
14;296;799;800;1;28;0.83
14;297;800;801;1;28;0.83
14;298;801;803;2;28;0.83
14;299;803;804;1;28;0.83
14;300;804;805;1;28;0.83
14;301;805;806;1;28;0.83
14;302;806;808;2;28;0.83
14;303;808;812;4;28;0.83
14;304;812;814;2;28;0.83
14;305;814;815;1;28;0.83
14;306;815;817;2;28;0.83
14;307;817;818;1;28;0.83
14;308;818;819;1;28;0.83
14;309;819;820;1;28;0.83
14;310;820;821;1;28;0.83
14;311;821;823;2;28;0.83
14;312;823;825;2;28;0.83
14;313;825;828;3;28;0.83
14;314;828;829;1;28;0.83
14;315;829;830;1;28;0.83
14;316;830;832;2;28;0.83
14;317;832;833;1;28;0.83
14;318;833;834;1;28;0.83
14;319;834;835;1;28;0.83
14;320;835;836;1;28;0.83
14;321;836;837;1;28;0.83
14;322;837;838;1;28;0.83
14;323;838;839;1;28;0.83
14;324;839;841;2;28;0.83
14;325;841;843;2;28;0.83
14;326;843;845;2;28;0.83
14;327;845;847;2;28;0.83
14;328;847;848;1;28;0.83
14;329;848;849;1;28;0.83
14;330;849;850;1;28;0.83
14;331;850;852;2;28;0.83
14;332;852;854;2;28;0.83
14;333;854;855;1;28;0.83
14;334;855;857;2;28;0.83
14;335;857;858;1;28;0.83
14;336;858;859;1;28;0.83
14;337;859;861;2;28;0.83
14;338;861;862;1;28;0.83
14;339;862;863;1;28;0.83
14;340;863;865;2;28;0.83
14;341;865;866;1;28;0.83
14;342;866;868;2;28;0.83
14;343;868;869;1;28;0.83
14;344;869;870;1;28;0.83
14;345;870;871;1;28;0.83
14;346;871;872;1;28;0.83
14;347;872;873;1;28;0.83
14;348;873;875;2;28;0.83
14;349;875;876;1;28;0.83
14;350;876;877;1;28;0.83
14;351;877;878;1;28;0.83
14;352;878;879;1;28;0.83
14;353;879;880;1;28;0.83
14;354;880;883;3;28;0.83
14;355;883;885;2;28;0.83
14;356;885;887;2;28;0.83
14;357;887;888;1;28;0.83
14;358;888;889;1;28;0.83
14;359;889;892;3;28;0.83
14;360;892;893;1;28;0.83
14;361;893;895;2;28;0.83
14;362;895;897;2;28;0.83
14;363;897;898;1;28;0.83
14;364;898;899;1;28;0.83
14;365;899;901;2;28;0.83
14;366;901;902;1;28;0.83
14;367;902;903;1;28;0.83
14;368;903;905;2;28;0.83
14;369;905;907;2;28;0.83
14;370;907;908;1;28;0.83
14;371;908;909;1;28;0.83
14;372;909;910;1;28;0.83
14;373;910;911;1;28;0.83
14;374;911;912;1;28;0.83
14;375;912;913;1;28;0.83
14;376;913;915;2;28;0.83
14;377;915;917;2;28;0.83
14;378;917;918;1;28;0.83
14;379;918;919;1;28;0.83
14;380;919;920;1;28;0.83
14;381;920;922;2;28;0.83
14;382;922;923;1;28;0.83
14;383;923;925;2;28;0.83
14;384;925;926;1;28;0.83
14;385;926;928;2;28;0.83
14;386;928;929;1;28;0.83
14;387;929;931;2;28;0.83
14;388;931;932;1;28;0.83
14;389;932;933;1;28;0.83
14;390;933;935;2;28;0.83
14;391;935;937;2;28;0.83
14;392;937;938;1;28;0.83
14;393;938;939;1;28;0.83
14;394;939;940;1;28;0.83
14;395;940;942;2;28;0.83
14;396;942;943;1;28;0.83
14;397;943;945;2;28;0.83
14;398;945;947;2;28;0.83
14;399;947;948;1;28;0.83
14;400;948;949;1;28;0.83
14;401;949;952;3;28;0.83
14;402;952;953;1;28;0.83
14;403;953;955;2;28;0.83
14;404;955;956;1;28;0.83
14;405;956;957;1;28;0.83
14;406;957;958;1;28;0.83
14;407;958;959;1;28;0.83
14;408;959;962;3;28;0.83
14;409;962;963;1;28;0.83
14;410;963;965;2;28;0.83
14;411;965;966;1;28;0.83
14;412;966;967;1;28;0.83
14;413;967;968;1;28;0.83
14;414;968;969;1;28;0.83
14;415;969;970;1;28;0.83
14;416;970;972;2;28;0.83
14;417;972;973;1;28;0.83
14;418;973;975;2;28;0.83
14;419;975;977;2;28;0.83
14;420;977;978;1;28;0.83
14;421;978;979;1;28;0.83
14;422;979;980;1;28;0.83
14;423;980;981;1;28;0.83
14;424;981;983;2;28;0.83
14;425;983;985;2;28;0.83
14;426;985;988;3;28;0.83
14;427;988;989;1;28;0.83
14;428;989;992;3;28;0.83
14;429;992;993;1;28;0.83
14;430;993;995;2;28;0.83
14;431;995;997;2;28;0.83
14;432;997;998;1;28;0.83
14;433;998;999;1;28;0.83
14;434;999;1000;1;28;0.83
14;435;1000;1002;2;28;0.83
14;436;1002;1003;1;28;0.83
14;437;1003;1005;2;28;0.83
14;438;1005;1007;2;28;0.83
14;439;1007;1008;1;28;0.83
14;440;1008;1009;1;28;0.83
14;441;1009;1011;2;28;0.83
14;442;1011;1012;1;28;0.83
14;443;1012;1014;2;28;0.83
14;444;1014;1015;1;28;0.83
14;445;1015;1017;2;28;0.83
14;446;1017;1018;1;28;0.83
14;447;1018;1019;1;28;0.83
14;448;1019;1020;1;28;0.83
14;449;1020;1021;1;28;0.83
14;450;1021;1023;2;28;0.83
14;451;1023;1026;3;28;0.83
14;452;1026;1027;1;28;0.83
14;453;1027;1028;1;28;0.83
14;454;1028;1029;1;28;0.83
14;455;1029;1030;1;28;0.83
14;456;1030;1032;2;28;0.83
14;457;1032;1033;1;28;0.83
14;458;1033;1037;4;28;0.83
14;459;1037;1038;1;28;0.83
14;460;1038;1039;1;28;0.83
14;461;1039;1041;2;28;0.83
14;462;1041;1043;2;28;0.83
14;463;1043;1044;1;28;0.83
14;464;1044;1045;1;28;0.83
14;465;1045;1047;2;28;0.83
14;466;1047;1048;1;28;0.83
14;467;1048;1049;1;28;0.83
14;468;1049;1053;4;28;0.83
14;469;1053;1055;2;28;0.83
14;470;1055;1057;2;28;0.83
14;471;1057;1058;1;28;0.83
14;472;1058;1059;1;28;0.83
14;473;1059;1060;1;28;0.83
14;474;1060;1062;2;28;0.83
14;475;1062;1063;1;28;0.83
14;476;1063;1065;2;28;0.83
14;477;1065;1067;2;28;0.83
14;478;1067;1068;1;28;0.83
14;479;1068;1069;1;28;0.83
14;480;1069;1071;2;28;0.83
14;481;1071;1075;4;28;0.83
14;482;1075;1076;1;28;0.83
14;483;1076;1077;1;28;0.83
14;484;1077;1078;1;28;0.83
14;485;1078;1079;1;28;0.83
14;486;1079;1083;4;28;0.83
14;487;1083;1084;1;28;0.83
14;488;1084;1085;1;28;0.83
14;489;1085;1087;2;28;0.83
14;490;1087;1088;1;28;0.83
14;491;1088;1089;1;28;0.83
14;492;1089;1090;1;28;0.83
14;493;1090;1093;3;28;0.83
14;494;1093;1094;1;28;0.83
14;495;1094;1095;1;28;0.83
14;496;1095;1097;2;28;0.83
14;497;1097;1098;1;28;0.83
14;498;1098;1100;2;28;0.83
14;499;1100;1101;1;28;0.83
14;500;1101;1103;2;28;0.83
14;501;1103;1105;2;28;0.83
14;502;1105;1107;2;28;0.83
14;503;1107;1108;1;28;0.83
14;504;1108;1109;1;28;0.83
14;505;1109;1110;1;28;0.83
14;506;1110;1111;1;28;0.83
14;507;1111;1112;1;28;0.83
14;508;1112;1113;1;28;0.83
14;509;1113;1117;4;28;0.83
14;510;1117;1120;3;28;0.83
14;511;1120;1121;1;28;0.83
14;512;1121;1125;4;28;0.83
14;513;1125;1128;3;28;0.83
14;514;1128;1132;4;28;0.83
14;515;1132;1134;2;28;0.83
14;516;1134;1137;3;28;0.83
14;517;1137;1139;2;28;0.83
14;518;1139;1140;1;28;0.83
14;519;1140;1141;1;28;0.83
14;520;1141;1142;1;28;0.83
14;521;1142;1145;3;28;0.83
14;522;1145;1147;2;28;0.83
14;523;1147;1150;3;28;0.83
14;524;1150;1152;2;28;0.83
14;525;1152;1153;1;28;0.83
14;526;1153;1155;2;28;0.83
14;527;1155;1157;2;28;0.83
14;528;1157;1160;3;28;0.83
14;529;1160;1162;2;28;0.83
14;530;1162;1170;8;28;0.83
14;531;1170;1171;1;28;0.83
14;532;1171;1174;3;28;0.83
14;533;1174;1175;1;28;0.83
14;534;1175;1176;1;28;0.83
14;535;1176;1177;1;28;0.83
14;536;1177;1178;1;28;0.83
14;537;1178;1180;2;28;0.83
14;538;1180;1181;1;28;0.83
14;539;1181;1182;1;28;0.83
14;540;1182;1186;4;28;0.83
14;541;1186;1188;2;28;0.83
14;542;1188;1189;1;28;0.83
14;543;1189;1195;6;28;0.83
14;544;1195;1197;2;28;0.83
14;545;1197;1199;2;28;0.83
14;546;1199;1200;1;28;0.83
14;547;1200;1202;2;28;0.83
14;548;1202;1205;3;28;0.83
14;549;1205;1209;4;28;0.83
14;550;1209;1210;1;28;0.83
14;551;1210;1215;5;28;0.83
14;552;1215;1217;2;28;0.83
14;553;1217;1221;4;28;0.83
14;554;1221;1222;1;28;0.83
14;555;1222;1223;1;28;0.83
14;556;1223;1225;2;28;0.83
14;557;1225;1226;1;28;0.83
14;558;1226;1227;1;28;0.83
14;559;1227;1228;1;28;0.83
14;560;1228;1230;2;28;0.83
14;561;1230;1231;1;28;0.83
14;562;1231;1232;1;28;0.83
14;563;1232;1235;3;28;0.83
14;564;1235;1237;2;28;0.83
14;565;1237;1247;10;28;0.83
14;566;1247;1250;3;28;0.83
14;567;1250;1252;2;28;0.83
14;568;1252;1253;1;28;0.83
14;569;1253;1256;3;28;0.83
14;570;1256;1258;2;28;0.83
14;571;1258;1260;2;28;0.83
14;572;1260;1262;2;28;0.83
14;573;1262;1263;1;28;0.83
14;574;1263;1266;3;28;0.83
14;575;1266;1267;1;28;0.83
14;576;1267;1268;1;28;0.83
14;577;1268;1269;1;28;0.83
14;578;1269;1271;2;28;0.83
14;579;1271;1272;1;28;0.83
14;580;1272;1275;3;28;0.83
14;581;1275;1277;2;28;0.83
14;582;1277;1280;3;28;0.83
14;583;1280;1281;1;28;0.83
14;584;1281;1282;1;28;0.83
14;585;1282;1284;2;28;0.83
14;586;1284;1285;1;28;0.83
14;587;1285;1291;6;28;0.83
14;588;1291;1296;5;28;0.83
14;589;1296;1299;3;28;0.83
14;590;1299;1300;1;28;0.83
14;591;1300;1302;2;28;0.83
14;592;1302;1305;3;28;0.83
14;593;1305;1307;2;28;0.83
14;594;1307;1309;2;28;0.83
14;595;1309;1310;1;28;0.83
14;596;1310;1312;2;28;0.83
14;597;1312;1316;4;28;0.83
14;598;1316;1321;5;28;0.83
14;599;1321;1322;1;28;0.83
14;600;1322;1323;1;28;0.83
14;601;1323;1326;3;28;0.83
14;602;1326;1327;1;28;0.83
14;603;1327;1330;3;28;0.83
14;604;1330;1332;2;28;0.83
14;605;1332;1334;2;28;0.83
14;606;1334;1335;1;28;0.83
14;607;1335;1337;2;28;0.83
14;608;1337;1338;1;28;0.83
14;609;1338;1341;3;28;0.83
14;610;1341;1342;1;28;0.83
14;611;1342;1344;2;28;0.83
14;612;1344;1345;1;28;0.83
14;613;1345;1347;2;28;0.83
14;614;1347;1350;3;28;0.83
14;615;1350;1357;7;28;0.83
14;616;1357;1360;3;28;0.83
14;617;1360;1362;2;28;0.83
14;618;1362;1363;1;28;0.83
14;619;1363;1364;1;28;0.83
14;620;1364;1365;1;28;0.83
14;621;1365;1366;1;28;0.83
14;622;1366;1371;5;28;0.83
14;623;1371;1374;3;28;0.83
14;624;1374;1376;2;28;0.83
14;625;1376;1378;2;28;0.83
14;626;1378;1379;1;28;0.83
14;627;1379;1380;1;28;0.83
14;628;1380;1382;2;28;0.83
14;629;1382;1385;3;28;0.83
14;630;1385;1386;1;28;0.83
14;631;1386;1387;1;28;0.83
14;632;1387;1394;7;28;0.83
14;633;1394;1409;15;28;0.83
14;634;1409;1424;15;28;0.83
14;635;1424;1439;15;28;0.83
14;636;1439;1454;15;28;0.83
14;637;1454;1469;15;28;0.83
14;638;1469;1484;15;28;0.83
14;639;1484;1499;15;28;0.83
14;640;1499;1514;15;28;0.83
14;641;1514;1529;15;28;0.83
14;642;1529;1544;15;28;0.83
14;643;1544;1559;15;28;0.83
14;644;1559;1574;15;28;0.83
14;645;1574;1589;15;28;0.83
14;646;1589;1604;15;28;0.83
14;647;1604;1619;15;28;0.83
14;648;1619;1634;15;28;0.83
14;649;1634;1649;15;28;0.83
14;650;1649;1664;15;28;0.83
14;651;1664;1679;15;28;0.83
14;652;1679;1680;1;28;0.83
