Index Nabijacky;Index Udalosti;Cas Zaciatku;Cas Konca;CasTrvania;Miesto;Rychlost nabijania
0;0;243;281;38;25;2.0
0;1;281;323;42;25;2.0
0;2;323;328;5;25;2.0
0;3;328;329;1;25;2.0
0;4;329;330;1;25;2.0
0;5;330;331;1;25;2.0
0;6;331;333;2;25;2.0
0;7;333;334;1;25;2.0
0;8;334;335;1;25;2.0
0;9;335;336;1;25;2.0
0;10;336;339;3;25;2.0
0;11;339;342;3;25;2.0
0;12;342;343;1;25;2.0
0;13;343;345;2;25;2.0
0;14;345;347;2;25;2.0
0;15;347;350;3;25;2.0
0;16;350;354;4;25;2.0
0;17;354;355;1;25;2.0
0;18;355;357;2;25;2.0
0;19;357;358;1;25;2.0
0;20;358;359;1;25;2.0
0;21;359;360;1;25;2.0
0;22;360;362;2;25;2.0
0;23;362;364;2;25;2.0
0;24;364;366;2;25;2.0
0;25;366;368;2;25;2.0
0;26;368;369;1;25;2.0
0;27;369;379;10;25;2.0
0;28;379;380;1;25;2.0
0;29;380;382;2;25;2.0
0;30;382;383;1;25;2.0
0;31;383;387;4;25;2.0
0;32;387;388;1;25;2.0
0;33;388;389;1;25;2.0
0;34;389;390;1;25;2.0
0;35;390;393;3;25;2.0
0;36;393;394;1;25;2.0
0;37;394;395;1;25;2.0
0;38;395;396;1;25;2.0
0;39;396;401;5;25;2.0
0;40;401;402;1;25;2.0
0;41;402;403;1;25;2.0
0;42;403;404;1;25;2.0
0;43;404;405;1;25;2.0
0;44;405;406;1;25;2.0
0;45;406;410;4;25;2.0
0;46;410;413;3;25;2.0
0;47;413;415;2;25;2.0
0;48;415;416;1;25;2.0
0;49;416;417;1;25;2.0
0;50;417;418;1;25;2.0
0;51;418;419;1;25;2.0
0;52;419;420;1;25;2.0
0;53;420;422;2;25;2.0
0;54;422;424;2;25;2.0
0;55;424;426;2;25;2.0
0;56;426;427;1;25;2.0
0;57;427;428;1;25;2.0
0;58;428;432;4;25;2.0
0;59;432;433;1;25;2.0
0;60;433;434;1;25;2.0
0;61;434;435;1;25;2.0
0;62;435;439;4;25;2.0
0;63;439;443;4;25;2.0
0;64;443;446;3;25;2.0
0;65;446;447;1;25;2.0
0;66;447;448;1;25;2.0
0;67;448;449;1;25;2.0
0;68;449;450;1;25;2.0
0;69;450;451;1;25;2.0
0;70;451;457;6;25;2.0
0;71;457;459;2;25;2.0
0;72;459;460;1;25;2.0
0;73;460;461;1;25;2.0
0;74;461;462;1;25;2.0
0;75;462;463;1;25;2.0
0;76;463;465;2;25;2.0
0;77;465;466;1;25;2.0
0;78;466;467;1;25;2.0
0;79;467;468;1;25;2.0
0;80;468;470;2;25;2.0
0;81;470;471;1;25;2.0
0;82;471;474;3;25;2.0
0;83;474;477;3;25;2.0
0;84;477;478;1;25;2.0
0;85;478;479;1;25;2.0
0;86;479;480;1;25;2.0
0;87;480;481;1;25;2.0
0;88;481;482;1;25;2.0
0;89;482;483;1;25;2.0
0;90;483;491;8;25;2.0
0;91;491;494;3;25;2.0
0;92;494;495;1;25;2.0
0;93;495;496;1;25;2.0
0;94;496;500;4;25;2.0
0;95;500;501;1;25;2.0
0;96;501;502;1;25;2.0
0;97;502;510;8;25;2.0
0;98;510;511;1;25;2.0
0;99;511;513;2;25;2.0
0;100;513;517;4;25;2.0
0;101;517;518;1;25;2.0
0;102;518;524;6;25;2.0
0;103;524;530;6;25;2.0
0;104;530;531;1;25;2.0
0;105;531;534;3;25;2.0
0;106;534;539;5;25;2.0
0;107;539;540;1;25;2.0
0;108;540;543;3;25;2.0
0;109;543;546;3;25;2.0
0;110;546;547;1;25;2.0
0;111;547;548;1;25;2.0
0;112;548;551;3;25;2.0
0;113;551;553;2;25;2.0
0;114;553;559;6;25;2.0
0;115;559;569;10;25;2.0
0;116;569;573;4;25;2.0
0;117;573;579;6;25;2.0
0;118;579;582;3;25;2.0
0;119;582;586;4;25;2.0
0;120;586;587;1;25;2.0
0;121;587;589;2;25;2.0
0;122;589;590;1;25;2.0
0;123;590;591;1;25;2.0
0;124;591;594;3;25;2.0
0;125;594;609;15;25;2.0
0;126;609;614;5;25;2.0
0;127;614;616;2;25;2.0
0;128;616;622;6;25;2.0
0;129;622;624;2;25;2.0
0;130;624;627;3;25;2.0
0;131;627;628;1;25;2.0
0;132;628;629;1;25;2.0
0;133;629;631;2;25;2.0
0;134;631;648;17;25;2.0
0;135;648;652;4;25;2.0
0;136;652;654;2;25;2.0
0;137;654;655;1;25;2.0
0;138;655;657;2;25;2.0
0;139;657;659;2;25;2.0
0;140;659;669;10;25;2.0
0;141;669;670;1;25;2.0
0;142;670;671;1;25;2.0
0;143;671;680;9;25;2.0
0;144;680;689;9;25;2.0
0;145;689;692;3;25;2.0
0;146;692;699;7;25;2.0
0;147;699;703;4;25;2.0
0;148;703;709;6;25;2.0
0;149;709;711;2;25;2.0
0;150;711;714;3;25;2.0
0;151;714;715;1;25;2.0
0;152;715;716;1;25;2.0
0;153;716;720;4;25;2.0
0;154;720;722;2;25;2.0
0;155;722;724;2;25;2.0
0;156;724;727;3;25;2.0
0;157;727;734;7;25;2.0
0;158;734;736;2;25;2.0
0;159;736;739;3;25;2.0
0;160;739;745;6;25;2.0
0;161;745;747;2;25;2.0
0;162;747;748;1;25;2.0
0;163;748;759;11;25;2.0
0;164;759;761;2;25;2.0
0;165;761;765;4;25;2.0
0;166;765;767;2;25;2.0
0;167;767;769;2;25;2.0
0;168;769;772;3;25;2.0
0;169;772;773;1;25;2.0
0;170;773;774;1;25;2.0
0;171;774;775;1;25;2.0
0;172;775;781;6;25;2.0
0;173;781;787;6;25;2.0
0;174;787;789;2;25;2.0
0;175;789;794;5;25;2.0
0;176;794;797;3;25;2.0
0;177;797;799;2;25;2.0
0;178;799;802;3;25;2.0
0;179;802;803;1;25;2.0
0;180;803;804;1;25;2.0
0;181;804;805;1;25;2.0
0;182;805;811;6;25;2.0
0;183;811;814;3;25;2.0
0;184;814;816;2;25;2.0
0;185;816;817;1;25;2.0
0;186;817;819;2;25;2.0
0;187;819;820;1;25;2.0
0;188;820;829;9;25;2.0
0;189;829;830;1;25;2.0
0;190;830;831;1;25;2.0
0;191;831;833;2;25;2.0
0;192;833;834;1;25;2.0
0;193;834;835;1;25;2.0
0;194;835;836;1;25;2.0
0;195;836;837;1;25;2.0
0;196;837;839;2;25;2.0
0;197;839;840;1;25;2.0
0;198;840;844;4;25;2.0
0;199;844;847;3;25;2.0
0;200;847;849;2;25;2.0
0;201;849;850;1;25;2.0
0;202;850;852;2;25;2.0
0;203;852;853;1;25;2.0
0;204;853;854;1;25;2.0
0;205;854;857;3;25;2.0
0;206;857;860;3;25;2.0
0;207;860;862;2;25;2.0
0;208;862;864;2;25;2.0
0;209;864;865;1;25;2.0
0;210;865;868;3;25;2.0
0;211;868;869;1;25;2.0
0;212;869;870;1;25;2.0
0;213;870;873;3;25;2.0
0;214;873;878;5;25;2.0
0;215;878;879;1;25;2.0
0;216;879;881;2;25;2.0
0;217;881;882;1;25;2.0
0;218;882;885;3;25;2.0
0;219;885;886;1;25;2.0
0;220;886;887;1;25;2.0
0;221;887;890;3;25;2.0
0;222;890;892;2;25;2.0
0;223;892;894;2;25;2.0
0;224;894;898;4;25;2.0
0;225;898;899;1;25;2.0
0;226;899;900;1;25;2.0
0;227;900;902;2;25;2.0
0;228;902;903;1;25;2.0
0;229;903;905;2;25;2.0
0;230;905;908;3;25;2.0
0;231;908;909;1;25;2.0
0;232;909;911;2;25;2.0
0;233;911;914;3;25;2.0
0;234;914;917;3;25;2.0
0;235;917;919;2;25;2.0
0;236;919;921;2;25;2.0
0;237;921;922;1;25;2.0
0;238;922;924;2;25;2.0
0;239;924;925;1;25;2.0
0;240;925;928;3;25;2.0
0;241;928;929;1;25;2.0
0;242;929;930;1;25;2.0
0;243;930;934;4;25;2.0
0;244;934;935;1;25;2.0
0;245;935;937;2;25;2.0
0;246;937;939;2;25;2.0
0;247;939;941;2;25;2.0
0;248;941;944;3;25;2.0
0;249;944;945;1;25;2.0
0;250;945;949;4;25;2.0
0;251;949;952;3;25;2.0
0;252;952;954;2;25;2.0
0;253;954;955;1;25;2.0
0;254;955;957;2;25;2.0
0;255;957;958;1;25;2.0
0;256;958;959;1;25;2.0
0;257;959;963;4;25;2.0
0;258;963;965;2;25;2.0
0;259;965;967;2;25;2.0
0;260;967;968;1;25;2.0
0;261;968;969;1;25;2.0
0;262;969;971;2;25;2.0
0;263;971;972;1;25;2.0
0;264;972;974;2;25;2.0
0;265;974;975;1;25;2.0
0;266;975;977;2;25;2.0
0;267;977;978;1;25;2.0
0;268;978;979;1;25;2.0
0;269;979;985;6;25;2.0
0;270;985;990;5;25;2.0
0;271;990;994;4;25;2.0
0;272;994;997;3;25;2.0
0;273;997;999;2;25;2.0
0;274;999;1001;2;25;2.0
0;275;1001;1002;1;25;2.0
0;276;1002;1004;2;25;2.0
0;277;1004;1006;2;25;2.0
0;278;1006;1008;2;25;2.0
0;279;1008;1009;1;25;2.0
0;280;1009;1011;2;25;2.0
0;281;1011;1013;2;25;2.0
0;282;1013;1014;1;25;2.0
0;283;1014;1017;3;25;2.0
0;284;1017;1018;1;25;2.0
0;285;1018;1019;1;25;2.0
0;286;1019;1020;1;25;2.0
0;287;1020;1024;4;25;2.0
0;288;1024;1029;5;25;2.0
0;289;1029;1030;1;25;2.0
0;290;1030;1031;1;25;2.0
0;291;1031;1032;1;25;2.0
0;292;1032;1034;2;25;2.0
0;293;1034;1036;2;25;2.0
0;294;1036;1038;2;25;2.0
0;295;1038;1040;2;25;2.0
0;296;1040;1041;1;25;2.0
0;297;1041;1044;3;25;2.0
0;298;1044;1045;1;25;2.0
0;299;1045;1053;8;25;2.0
0;300;1053;1057;4;25;2.0
0;301;1057;1059;2;25;2.0
0;302;1059;1061;2;25;2.0
0;303;1061;1064;3;25;2.0
0;304;1064;1068;4;25;2.0
0;305;1068;1074;6;25;2.0
0;306;1074;1075;1;25;2.0
0;307;1075;1077;2;25;2.0
0;308;1077;1080;3;25;2.0
0;309;1080;1082;2;25;2.0
0;310;1082;1083;1;25;2.0
0;311;1083;1084;1;25;2.0
0;312;1084;1086;2;25;2.0
0;313;1086;1089;3;25;2.0
0;314;1089;1091;2;25;2.0
0;315;1091;1092;1;25;2.0
0;316;1092;1094;2;25;2.0
0;317;1094;1095;1;25;2.0
0;318;1095;1096;1;25;2.0
0;319;1096;1098;2;25;2.0
0;320;1098;1099;1;25;2.0
0;321;1099;1102;3;25;2.0
0;322;1102;1107;5;25;2.0
0;323;1107;1108;1;25;2.0
0;324;1108;1109;1;25;2.0
0;325;1109;1118;9;25;2.0
0;326;1118;1121;3;25;2.0
0;327;1121;1133;12;25;2.0
0;328;1133;1136;3;25;2.0
0;329;1136;1138;2;25;2.0
0;330;1138;1139;1;25;2.0
0;331;1139;1143;4;25;2.0
0;332;1143;1145;2;25;2.0
0;333;1145;1149;4;25;2.0
0;334;1149;1152;3;25;2.0
0;335;1152;1159;7;25;2.0
0;336;1159;1168;9;25;2.0
0;337;1168;1169;1;25;2.0
0;338;1169;1173;4;25;2.0
0;339;1173;1175;2;25;2.0
0;340;1175;1178;3;25;2.0
0;341;1178;1186;8;25;2.0
0;342;1186;1188;2;25;2.0
0;343;1188;1198;10;25;2.0
0;344;1198;1203;5;25;2.0
0;345;1203;1204;1;25;2.0
0;346;1204;1207;3;25;2.0
0;347;1207;1208;1;25;2.0
0;348;1208;1216;8;25;2.0
0;349;1216;1218;2;25;2.0
0;350;1218;1222;4;25;2.0
0;351;1222;1228;6;25;2.0
0;352;1228;1229;1;25;2.0
0;353;1229;1253;24;25;2.0
0;354;1253;1255;2;25;2.0
0;355;1255;1261;6;25;2.0
0;356;1261;1262;1;25;2.0
0;357;1262;1263;1;25;2.0
0;358;1263;1265;2;25;2.0
0;359;1265;1268;3;25;2.0
0;360;1268;1278;10;25;2.0
0;361;1278;1279;1;25;2.0
0;362;1279;1280;1;25;2.0
0;363;1280;1281;1;25;2.0
0;364;1281;1289;8;25;2.0
0;365;1289;1293;4;25;2.0
0;366;1293;1304;11;25;2.0
0;367;1304;1307;3;25;2.0
0;368;1307;1313;6;25;2.0
0;369;1313;1318;5;25;2.0
0;370;1318;1320;2;25;2.0
0;371;1320;1321;1;25;2.0
0;372;1321;1322;1;25;2.0
0;373;1322;1329;7;25;2.0
0;374;1329;1331;2;25;2.0
0;375;1331;1335;4;25;2.0
0;376;1335;1336;1;25;2.0
0;377;1336;1339;3;25;2.0
0;378;1339;1342;3;25;2.0
0;379;1342;1343;1;25;2.0
0;380;1343;1355;12;25;2.0
0;381;1355;1357;2;25;2.0
0;382;1357;1359;2;25;2.0
0;383;1359;1360;1;25;2.0
0;384;1360;1363;3;25;2.0
0;385;1363;1364;1;25;2.0
0;386;1364;1365;1;25;2.0
0;387;1365;1366;1;25;2.0
0;388;1366;1368;2;25;2.0
0;389;1368;1373;5;25;2.0
0;390;1373;1377;4;25;2.0
0;391;1377;1378;1;25;2.0
0;392;1378;1383;5;25;2.0
0;393;1383;1385;2;25;2.0
0;394;1385;1388;3;25;2.0
0;395;1388;1393;5;25;2.0
0;396;1393;1408;15;25;2.0
0;397;1408;1423;15;25;2.0
0;398;1423;1438;15;25;2.0
0;399;1438;1453;15;25;2.0
0;400;1453;1468;15;25;2.0
0;401;1468;1483;15;25;2.0
0;402;1483;1498;15;25;2.0
0;403;1498;1513;15;25;2.0
0;404;1513;1528;15;25;2.0
0;405;1528;1543;15;25;2.0
0;406;1543;1558;15;25;2.0
0;407;1558;1573;15;25;2.0
0;408;1573;1588;15;25;2.0
0;409;1588;1603;15;25;2.0
0;410;1603;1618;15;25;2.0
0;411;1618;1633;15;25;2.0
0;412;1633;1648;15;25;2.0
0;413;1648;1663;15;25;2.0
0;414;1663;1680;17;25;2.0
1;0;242;280;38;42;2.0
1;1;280;324;44;42;2.0
1;2;324;328;4;42;2.0
1;3;328;330;2;42;2.0
1;4;330;332;2;42;2.0
1;5;332;333;1;42;2.0
1;6;333;334;1;42;2.0
1;7;334;336;2;42;2.0
1;8;336;338;2;42;2.0
1;9;338;343;5;42;2.0
1;10;343;345;2;42;2.0
1;11;345;347;2;42;2.0
1;12;347;351;4;42;2.0
1;13;351;354;3;42;2.0
1;14;354;356;2;42;2.0
1;15;356;357;1;42;2.0
1;16;357;358;1;42;2.0
1;17;358;360;2;42;2.0
1;18;360;363;3;42;2.0
1;19;363;366;3;42;2.0
1;20;366;367;1;42;2.0
1;21;367;368;1;42;2.0
1;22;368;369;1;42;2.0
1;23;369;379;10;42;2.0
1;24;379;380;1;42;2.0
1;25;380;382;2;42;2.0
1;26;382;383;1;42;2.0
1;27;383;387;4;42;2.0
1;28;387;388;1;42;2.0
1;29;388;389;1;42;2.0
1;30;389;390;1;42;2.0
1;31;390;391;1;42;2.0
1;32;391;392;1;42;2.0
1;33;392;394;2;42;2.0
1;34;394;395;1;42;2.0
1;35;395;396;1;42;2.0
1;36;396;402;6;42;2.0
1;37;402;404;2;42;2.0
1;38;404;405;1;42;2.0
1;39;405;406;1;42;2.0
1;40;406;411;5;42;2.0
1;41;411;414;3;42;2.0
1;42;414;415;1;42;2.0
1;43;415;416;1;42;2.0
1;44;416;417;1;42;2.0
1;45;417;418;1;42;2.0
1;46;418;419;1;42;2.0
1;47;419;420;1;42;2.0
1;48;420;423;3;42;2.0
1;49;423;424;1;42;2.0
1;50;424;426;2;42;2.0
1;51;426;427;1;42;2.0
1;52;427;428;1;42;2.0
1;53;428;429;1;42;2.0
1;54;429;433;4;42;2.0
1;55;433;435;2;42;2.0
1;56;435;439;4;42;2.0
1;57;439;442;3;42;2.0
1;58;442;446;4;42;2.0
1;59;446;448;2;42;2.0
1;60;448;449;1;42;2.0
1;61;449;450;1;42;2.0
1;62;450;451;1;42;2.0
1;63;451;452;1;42;2.0
1;64;452;456;4;42;2.0
1;65;456;459;3;42;2.0
1;66;459;460;1;42;2.0
1;67;460;461;1;42;2.0
1;68;461;463;2;42;2.0
1;69;463;465;2;42;2.0
1;70;465;466;1;42;2.0
1;71;466;467;1;42;2.0
1;72;467;469;2;42;2.0
1;73;469;470;1;42;2.0
1;74;470;471;1;42;2.0
1;75;471;473;2;42;2.0
1;76;473;477;4;42;2.0
1;77;477;478;1;42;2.0
1;78;478;479;1;42;2.0
1;79;479;480;1;42;2.0
1;80;480;481;1;42;2.0
1;81;481;482;1;42;2.0
1;82;482;483;1;42;2.0
1;83;483;492;9;42;2.0
1;84;492;494;2;42;2.0
1;85;494;495;1;42;2.0
1;86;495;496;1;42;2.0
1;87;496;499;3;42;2.0
1;88;499;502;3;42;2.0
1;89;502;503;1;42;2.0
1;90;503;511;8;42;2.0
1;91;511;512;1;42;2.0
1;92;512;517;5;42;2.0
1;93;517;519;2;42;2.0
1;94;519;523;4;42;2.0
1;95;523;524;1;42;2.0
1;96;524;530;6;42;2.0
1;97;530;533;3;42;2.0
1;98;533;535;2;42;2.0
1;99;535;539;4;42;2.0
1;100;539;541;2;42;2.0
1;101;541;544;3;42;2.0
1;102;544;547;3;42;2.0
1;103;547;548;1;42;2.0
1;104;548;552;4;42;2.0
1;105;552;554;2;42;2.0
1;106;554;558;4;42;2.0
1;107;558;570;12;42;2.0
1;108;570;573;3;42;2.0
1;109;573;578;5;42;2.0
1;110;578;579;1;42;2.0
1;111;579;583;4;42;2.0
1;112;583;587;4;42;2.0
1;113;587;590;3;42;2.0
1;114;590;591;1;42;2.0
1;115;591;593;2;42;2.0
1;116;593;608;15;42;2.0
1;117;608;613;5;42;2.0
1;118;613;617;4;42;2.0
1;119;617;622;5;42;2.0
1;120;622;623;1;42;2.0
1;121;623;624;1;42;2.0
1;122;624;627;3;42;2.0
1;123;627;628;1;42;2.0
1;124;628;629;1;42;2.0
1;125;629;632;3;42;2.0
1;126;632;649;17;42;2.0
1;127;649;653;4;42;2.0
1;128;653;655;2;42;2.0
1;129;655;657;2;42;2.0
1;130;657;660;3;42;2.0
1;131;660;668;8;42;2.0
1;132;668;670;2;42;2.0
1;133;670;672;2;42;2.0
1;134;672;679;7;42;2.0
1;135;679;690;11;42;2.0
1;136;690;692;2;42;2.0
1;137;692;693;1;42;2.0
1;138;693;699;6;42;2.0
1;139;699;704;5;42;2.0
1;140;704;708;4;42;2.0
1;141;708;711;3;42;2.0
1;142;711;713;2;42;2.0
1;143;713;716;3;42;2.0
1;144;716;717;1;42;2.0
1;145;717;720;3;42;2.0
1;146;720;723;3;42;2.0
1;147;723;725;2;42;2.0
1;148;725;727;2;42;2.0
1;149;727;733;6;42;2.0
1;150;733;737;4;42;2.0
1;151;737;738;1;42;2.0
1;152;738;745;7;42;2.0
1;153;745;746;1;42;2.0
1;154;746;747;1;42;2.0
1;155;747;759;12;42;2.0
1;156;759;761;2;42;2.0
1;157;761;762;1;42;2.0
1;158;762;765;3;42;2.0
1;159;765;767;2;42;2.0
1;160;767;770;3;42;2.0
1;161;770;773;3;42;2.0
1;162;773;774;1;42;2.0
1;163;774;776;2;42;2.0
1;164;776;782;6;42;2.0
1;165;782;787;5;42;2.0
1;166;787;790;3;42;2.0
1;167;790;793;3;42;2.0
1;168;793;794;1;42;2.0
1;169;794;795;1;42;2.0
1;170;795;796;1;42;2.0
1;171;796;798;2;42;2.0
1;172;798;803;5;42;2.0
1;173;803;805;2;42;2.0
1;174;805;812;7;42;2.0
1;175;812;813;1;42;2.0
1;176;813;816;3;42;2.0
1;177;816;817;1;42;2.0
1;178;817;819;2;42;2.0
1;179;819;820;1;42;2.0
1;180;820;830;10;42;2.0
1;181;830;831;1;42;2.0
1;182;831;833;2;42;2.0
1;183;833;834;1;42;2.0
1;184;834;835;1;42;2.0
1;185;835;837;2;42;2.0
1;186;837;838;1;42;2.0
1;187;838;840;2;42;2.0
1;188;840;844;4;42;2.0
1;189;844;847;3;42;2.0
1;190;847;850;3;42;2.0
1;191;850;853;3;42;2.0
1;192;853;856;3;42;2.0
1;193;856;860;4;42;2.0
1;194;860;862;2;42;2.0
1;195;862;863;1;42;2.0
1;196;863;864;1;42;2.0
1;197;864;865;1;42;2.0
1;198;865;866;1;42;2.0
1;199;866;868;2;42;2.0
1;200;868;870;2;42;2.0
1;201;870;874;4;42;2.0
1;202;874;878;4;42;2.0
1;203;878;879;1;42;2.0
1;204;879;880;1;42;2.0
1;205;880;881;1;42;2.0
1;206;881;882;1;42;2.0
1;207;882;883;1;42;2.0
1;208;883;885;2;42;2.0
1;209;885;886;1;42;2.0
1;210;886;887;1;42;2.0
1;211;887;891;4;42;2.0
1;212;891;893;2;42;2.0
1;213;893;897;4;42;2.0
1;214;897;899;2;42;2.0
1;215;899;900;1;42;2.0
1;216;900;901;1;42;2.0
1;217;901;902;1;42;2.0
1;218;902;905;3;42;2.0
1;219;905;908;3;42;2.0
1;220;908;909;1;42;2.0
1;221;909;910;1;42;2.0
1;222;910;911;1;42;2.0
1;223;911;913;2;42;2.0
1;224;913;914;1;42;2.0
1;225;914;917;3;42;2.0
1;226;917;918;1;42;2.0
1;227;918;922;4;42;2.0
1;228;922;923;1;42;2.0
1;229;923;926;3;42;2.0
1;230;926;927;1;42;2.0
1;231;927;928;1;42;2.0
1;232;928;929;1;42;2.0
1;233;929;930;1;42;2.0
1;234;930;933;3;42;2.0
1;235;933;936;3;42;2.0
1;236;936;937;1;42;2.0
1;237;937;938;1;42;2.0
1;238;938;939;1;42;2.0
1;239;939;940;1;42;2.0
1;240;940;941;1;42;2.0
1;241;941;945;4;42;2.0
1;242;945;948;3;42;2.0
1;243;948;953;5;42;2.0
1;244;953;954;1;42;2.0
1;245;954;956;2;42;2.0
1;246;956;957;1;42;2.0
1;247;957;958;1;42;2.0
1;248;958;960;2;42;2.0
1;249;960;964;4;42;2.0
1;250;964;965;1;42;2.0
1;251;965;967;2;42;2.0
1;252;967;968;1;42;2.0
1;253;968;969;1;42;2.0
1;254;969;970;1;42;2.0
1;255;970;971;1;42;2.0
1;256;971;973;2;42;2.0
1;257;973;974;1;42;2.0
1;258;974;976;2;42;2.0
1;259;976;977;1;42;2.0
1;260;977;978;1;42;2.0
1;261;978;979;1;42;2.0
1;262;979;986;7;42;2.0
1;263;986;990;4;42;2.0
1;264;990;991;1;42;2.0
1;265;991;994;3;42;2.0
1;266;994;997;3;42;2.0
1;267;997;998;1;42;2.0
1;268;998;999;1;42;2.0
1;269;999;1000;1;42;2.0
1;270;1000;1001;1;42;2.0
1;271;1001;1002;1;42;2.0
1;272;1002;1003;1;42;2.0
1;273;1003;1005;2;42;2.0
1;274;1005;1009;4;42;2.0
1;275;1009;1010;1;42;2.0
1;276;1010;1012;2;42;2.0
1;277;1012;1013;1;42;2.0
1;278;1013;1017;4;42;2.0
1;279;1017;1018;1;42;2.0
1;280;1018;1020;2;42;2.0
1;281;1020;1021;1;42;2.0
1;282;1021;1024;3;42;2.0
1;283;1024;1028;4;42;2.0
1;284;1028;1030;2;42;2.0
1;285;1030;1031;1;42;2.0
1;286;1031;1032;1;42;2.0
1;287;1032;1033;1;42;2.0
1;288;1033;1035;2;42;2.0
1;289;1035;1039;4;42;2.0
1;290;1039;1041;2;42;2.0
1;291;1041;1042;1;42;2.0
1;292;1042;1043;1;42;2.0
1;293;1043;1044;1;42;2.0
1;294;1044;1046;2;42;2.0
1;295;1046;1054;8;42;2.0
1;296;1054;1057;3;42;2.0
1;297;1057;1060;3;42;2.0
1;298;1060;1061;1;42;2.0
1;299;1061;1063;2;42;2.0
1;300;1063;1064;1;42;2.0
1;301;1064;1065;1;42;2.0
1;302;1065;1069;4;42;2.0
1;303;1069;1073;4;42;2.0
1;304;1073;1074;1;42;2.0
1;305;1074;1075;1;42;2.0
1;306;1075;1077;2;42;2.0
1;307;1077;1081;4;42;2.0
1;308;1081;1082;1;42;2.0
1;309;1082;1084;2;42;2.0
1;310;1084;1085;1;42;2.0
1;311;1085;1087;2;42;2.0
1;312;1087;1088;1;42;2.0
1;313;1088;1091;3;42;2.0
1;314;1091;1092;1;42;2.0
1;315;1092;1093;1;42;2.0
1;316;1093;1095;2;42;2.0
1;317;1095;1096;1;42;2.0
1;318;1096;1098;2;42;2.0
1;319;1098;1099;1;42;2.0
1;320;1099;1101;2;42;2.0
1;321;1101;1108;7;42;2.0
1;322;1108;1109;1;42;2.0
1;323;1109;1110;1;42;2.0
1;324;1110;1119;9;42;2.0
1;325;1119;1121;2;42;2.0
1;326;1121;1133;12;42;2.0
1;327;1133;1136;3;42;2.0
1;328;1136;1138;2;42;2.0
1;329;1138;1139;1;42;2.0
1;330;1139;1140;1;42;2.0
1;331;1140;1143;3;42;2.0
1;332;1143;1145;2;42;2.0
1;333;1145;1148;3;42;2.0
1;334;1148;1150;2;42;2.0
1;335;1150;1153;3;42;2.0
1;336;1153;1158;5;42;2.0
1;337;1158;1169;11;42;2.0
1;338;1169;1170;1;42;2.0
1;339;1170;1173;3;42;2.0
1;340;1173;1174;1;42;2.0
1;341;1174;1179;5;42;2.0
1;342;1179;1187;8;42;2.0
1;343;1187;1199;12;42;2.0
1;344;1199;1203;4;42;2.0
1;345;1203;1208;5;42;2.0
1;346;1208;1217;9;42;2.0
1;347;1217;1219;2;42;2.0
1;348;1219;1221;2;42;2.0
1;349;1221;1227;6;42;2.0
1;350;1227;1230;3;42;2.0
1;351;1230;1254;24;42;2.0
1;352;1254;1256;2;42;2.0
1;353;1256;1261;5;42;2.0
1;354;1261;1263;2;42;2.0
1;355;1263;1265;2;42;2.0
1;356;1265;1267;2;42;2.0
1;357;1267;1268;1;42;2.0
1;358;1268;1269;1;42;2.0
1;359;1269;1278;9;42;2.0
1;360;1278;1279;1;42;2.0
1;361;1279;1280;1;42;2.0
1;362;1280;1290;10;42;2.0
1;363;1290;1294;4;42;2.0
1;364;1294;1304;10;42;2.0
1;365;1304;1308;4;42;2.0
1;366;1308;1313;5;42;2.0
1;367;1313;1317;4;42;2.0
1;368;1317;1321;4;42;2.0
1;369;1321;1322;1;42;2.0
1;370;1322;1328;6;42;2.0
1;371;1328;1330;2;42;2.0
1;372;1330;1336;6;42;2.0
1;373;1336;1339;3;42;2.0
1;374;1339;1342;3;42;2.0
1;375;1342;1343;1;42;2.0
1;376;1343;1356;13;42;2.0
1;377;1356;1358;2;42;2.0
1;378;1358;1360;2;42;2.0
1;379;1360;1361;1;42;2.0
1;380;1361;1363;2;42;2.0
1;381;1363;1364;1;42;2.0
1;382;1364;1365;1;42;2.0
1;383;1365;1369;4;42;2.0
1;384;1369;1373;4;42;2.0
1;385;1373;1376;3;42;2.0
1;386;1376;1377;1;42;2.0
1;387;1377;1384;7;42;2.0
1;388;1384;1385;1;42;2.0
1;389;1385;1387;2;42;2.0
1;390;1387;1392;5;42;2.0
1;391;1392;1407;15;42;2.0
1;392;1407;1422;15;42;2.0
1;393;1422;1437;15;42;2.0
1;394;1437;1452;15;42;2.0
1;395;1452;1467;15;42;2.0
1;396;1467;1482;15;42;2.0
1;397;1482;1497;15;42;2.0
1;398;1497;1512;15;42;2.0
1;399;1512;1527;15;42;2.0
1;400;1527;1542;15;42;2.0
1;401;1542;1557;15;42;2.0
1;402;1557;1572;15;42;2.0
1;403;1572;1587;15;42;2.0
1;404;1587;1602;15;42;2.0
1;405;1602;1617;15;42;2.0
1;406;1617;1632;15;42;2.0
1;407;1632;1647;15;42;2.0
1;408;1647;1662;15;42;2.0
1;409;1662;1677;15;42;2.0
1;410;1677;1680;3;42;2.0
2;0;246;285;39;49;2.0
2;1;285;324;39;49;2.0
2;2;324;325;1;49;2.0
2;3;325;329;4;49;2.0
2;4;329;332;3;49;2.0
2;5;332;333;1;49;2.0
2;6;333;334;1;49;2.0
2;7;334;335;1;49;2.0
2;8;335;336;1;49;2.0
2;9;336;337;1;49;2.0
2;10;337;340;3;49;2.0
2;11;340;342;2;49;2.0
2;12;342;344;2;49;2.0
2;13;344;346;2;49;2.0
2;14;346;348;2;49;2.0
2;15;348;351;3;49;2.0
2;16;351;354;3;49;2.0
2;17;354;355;1;49;2.0
2;18;355;356;1;49;2.0
2;19;356;357;1;49;2.0
2;20;357;358;1;49;2.0
2;21;358;359;1;49;2.0
2;22;359;361;2;49;2.0
2;23;361;362;1;49;2.0
2;24;362;366;4;49;2.0
2;25;366;367;1;49;2.0
2;26;367;369;2;49;2.0
2;27;369;371;2;49;2.0
2;28;371;372;1;49;2.0
2;29;372;375;3;49;2.0
2;30;375;380;5;49;2.0
2;31;380;386;6;49;2.0
2;32;386;387;1;49;2.0
2;33;387;388;1;49;2.0
2;34;388;389;1;49;2.0
2;35;389;390;1;49;2.0
2;36;390;391;1;49;2.0
2;37;391;392;1;49;2.0
2;38;392;394;2;49;2.0
2;39;394;395;1;49;2.0
2;40;395;396;1;49;2.0
2;41;396;397;1;49;2.0
2;42;397;403;6;49;2.0
2;43;403;404;1;49;2.0
2;44;404;405;1;49;2.0
2;45;405;406;1;49;2.0
2;46;406;407;1;49;2.0
2;47;407;409;2;49;2.0
2;48;409;410;1;49;2.0
2;49;410;414;4;49;2.0
2;50;414;418;4;49;2.0
2;51;418;419;1;49;2.0
2;52;419;420;1;49;2.0
2;53;420;421;1;49;2.0
2;54;421;422;1;49;2.0
2;55;422;423;1;49;2.0
2;56;423;426;3;49;2.0
2;57;426;427;1;49;2.0
2;58;427;428;1;49;2.0
2;59;428;429;1;49;2.0
2;60;429;431;2;49;2.0
2;61;431;434;3;49;2.0
2;62;434;436;2;49;2.0
2;63;436;437;1;49;2.0
2;64;437;442;5;49;2.0
2;65;442;445;3;49;2.0
2;66;445;447;2;49;2.0
2;67;447;449;2;49;2.0
2;68;449;450;1;49;2.0
2;69;450;451;1;49;2.0
2;70;451;452;1;49;2.0
2;71;452;454;2;49;2.0
2;72;454;455;1;49;2.0
2;73;455;460;5;49;2.0
2;74;460;462;2;49;2.0
2;75;462;463;1;49;2.0
2;76;463;464;1;49;2.0
2;77;464;465;1;49;2.0
2;78;465;466;1;49;2.0
2;79;466;468;2;49;2.0
2;80;468;469;1;49;2.0
2;81;469;470;1;49;2.0
2;82;470;474;4;49;2.0
2;83;474;475;1;49;2.0
2;84;475;477;2;49;2.0
2;85;477;478;1;49;2.0
2;86;478;479;1;49;2.0
2;87;479;480;1;49;2.0
2;88;480;481;1;49;2.0
2;89;481;482;1;49;2.0
2;90;482;483;1;49;2.0
2;91;483;486;3;49;2.0
2;92;486;494;8;49;2.0
2;93;494;495;1;49;2.0
2;94;495;496;1;49;2.0
2;95;496;497;1;49;2.0
2;96;497;504;7;49;2.0
2;97;504;505;1;49;2.0
2;98;505;506;1;49;2.0
2;99;506;514;8;49;2.0
2;100;514;517;3;49;2.0
2;101;517;518;1;49;2.0
2;102;518;519;1;49;2.0
2;103;519;525;6;49;2.0
2;104;525;527;2;49;2.0
2;105;527;528;1;49;2.0
2;106;528;535;7;49;2.0
2;107;535;536;1;49;2.0
2;108;536;538;2;49;2.0
2;109;538;540;2;49;2.0
2;110;540;542;2;49;2.0
2;111;542;544;2;49;2.0
2;112;544;546;2;49;2.0
2;113;546;550;4;49;2.0
2;114;550;551;1;49;2.0
2;115;551;554;3;49;2.0
2;116;554;562;8;49;2.0
2;117;562;572;10;49;2.0
2;118;572;574;2;49;2.0
2;119;574;582;8;49;2.0
2;120;582;586;4;49;2.0
2;121;586;588;2;49;2.0
2;122;588;589;1;49;2.0
2;123;589;590;1;49;2.0
2;124;590;591;1;49;2.0
2;125;591;594;3;49;2.0
2;126;594;596;2;49;2.0
2;127;596;612;16;49;2.0
2;128;612;618;6;49;2.0
2;129;618;620;2;49;2.0
2;130;620;623;3;49;2.0
2;131;623;625;2;49;2.0
2;132;625;626;1;49;2.0
2;133;626;627;1;49;2.0
2;134;627;631;4;49;2.0
2;135;631;632;1;49;2.0
2;136;632;634;2;49;2.0
2;137;634;649;15;49;2.0
2;138;649;650;1;49;2.0
2;139;650;656;6;49;2.0
2;140;656;658;2;49;2.0
2;141;658;660;2;49;2.0
2;142;660;669;9;49;2.0
2;143;669;672;3;49;2.0
2;144;672;674;2;49;2.0
2;145;674;684;10;49;2.0
2;146;684;692;8;49;2.0
2;147;692;693;1;49;2.0
2;148;693;696;3;49;2.0
2;149;696;700;4;49;2.0
2;150;700;702;2;49;2.0
2;151;702;711;9;49;2.0
2;152;711;712;1;49;2.0
2;153;712;716;4;49;2.0
2;154;716;719;3;49;2.0
2;155;719;725;6;49;2.0
2;156;725;726;1;49;2.0
2;157;726;728;2;49;2.0
2;158;728;738;10;49;2.0
2;159;738;740;2;49;2.0
2;160;740;742;2;49;2.0
2;161;742;751;9;49;2.0
2;162;751;752;1;49;2.0
2;163;752;760;8;49;2.0
2;164;760;762;2;49;2.0
2;165;762;764;2;49;2.0
2;166;764;768;4;49;2.0
2;167;768;770;2;49;2.0
2;168;770;772;2;49;2.0
2;169;772;776;4;49;2.0
2;170;776;779;3;49;2.0
2;171;779;785;6;49;2.0
2;172;785;788;3;49;2.0
2;173;788;792;4;49;2.0
2;174;792;795;3;49;2.0
2;175;795;797;2;49;2.0
2;176;797;798;1;49;2.0
2;177;798;801;3;49;2.0
2;178;801;803;2;49;2.0
2;179;803;804;1;49;2.0
2;180;804;806;2;49;2.0
2;181;806;807;1;49;2.0
2;182;807;815;8;49;2.0
2;183;815;816;1;49;2.0
2;184;816;817;1;49;2.0
2;185;817;818;1;49;2.0
2;186;818;820;2;49;2.0
2;187;820;821;1;49;2.0
2;188;821;822;1;49;2.0
2;189;822;832;10;49;2.0
2;190;832;833;1;49;2.0
2;191;833;834;1;49;2.0
2;192;834;835;1;49;2.0
2;193;835;836;1;49;2.0
2;194;836;837;1;49;2.0
2;195;837;838;1;49;2.0
2;196;838;839;1;49;2.0
2;197;839;842;3;49;2.0
2;198;842;847;5;49;2.0
2;199;847;848;1;49;2.0
2;200;848;850;2;49;2.0
2;201;850;853;3;49;2.0
2;202;853;854;1;49;2.0
2;203;854;856;2;49;2.0
2;204;856;858;2;49;2.0
2;205;858;859;1;49;2.0
2;206;859;861;2;49;2.0
2;207;861;863;2;49;2.0
2;208;863;865;2;49;2.0
2;209;865;867;2;49;2.0
2;210;867;869;2;49;2.0
2;211;869;871;2;49;2.0
2;212;871;872;1;49;2.0
2;213;872;873;1;49;2.0
2;214;873;874;1;49;2.0
2;215;874;880;6;49;2.0
2;216;880;881;1;49;2.0
2;217;881;882;1;49;2.0
2;218;882;885;3;49;2.0
2;219;885;886;1;49;2.0
2;220;886;888;2;49;2.0
2;221;888;889;1;49;2.0
2;222;889;891;2;49;2.0
2;223;891;896;5;49;2.0
2;224;896;897;1;49;2.0
2;225;897;901;4;49;2.0
2;226;901;902;1;49;2.0
2;227;902;903;1;49;2.0
2;228;903;904;1;49;2.0
2;229;904;906;2;49;2.0
2;230;906;907;1;49;2.0
2;231;907;908;1;49;2.0
2;232;908;909;1;49;2.0
2;233;909;910;1;49;2.0
2;234;910;913;3;49;2.0
2;235;913;914;1;49;2.0
2;236;914;916;2;49;2.0
2;237;916;917;1;49;2.0
2;238;917;918;1;49;2.0
2;239;918;923;5;49;2.0
2;240;923;925;2;49;2.0
2;241;925;926;1;49;2.0
2;242;926;928;2;49;2.0
2;243;928;929;1;49;2.0
2;244;929;932;3;49;2.0
2;245;932;933;1;49;2.0
2;246;933;936;3;49;2.0
2;247;936;937;1;49;2.0
2;248;937;938;1;49;2.0
2;249;938;939;1;49;2.0
2;250;939;940;1;49;2.0
2;251;940;941;1;49;2.0
2;252;941;942;1;49;2.0
2;253;942;943;1;49;2.0
2;254;943;944;1;49;2.0
2;255;944;945;1;49;2.0
2;256;945;948;3;49;2.0
2;257;948;952;4;49;2.0
2;258;952;956;4;49;2.0
2;259;956;957;1;49;2.0
2;260;957;958;1;49;2.0
2;261;958;959;1;49;2.0
2;262;959;962;3;49;2.0
2;263;962;964;2;49;2.0
2;264;964;966;2;49;2.0
2;265;966;967;1;49;2.0
2;266;967;968;1;49;2.0
2;267;968;970;2;49;2.0
2;268;970;973;3;49;2.0
2;269;973;974;1;49;2.0
2;270;974;976;2;49;2.0
2;271;976;977;1;49;2.0
2;272;977;978;1;49;2.0
2;273;978;979;1;49;2.0
2;274;979;982;3;49;2.0
2;275;982;983;1;49;2.0
2;276;983;989;6;49;2.0
2;277;989;993;4;49;2.0
2;278;993;994;1;49;2.0
2;279;994;997;3;49;2.0
2;280;997;998;1;49;2.0
2;281;998;1000;2;49;2.0
2;282;1000;1001;1;49;2.0
2;283;1001;1004;3;49;2.0
2;284;1004;1007;3;49;2.0
2;285;1007;1009;2;49;2.0
2;286;1009;1012;3;49;2.0
2;287;1012;1015;3;49;2.0
2;288;1015;1017;2;49;2.0
2;289;1017;1018;1;49;2.0
2;290;1018;1022;4;49;2.0
2;291;1022;1023;1;49;2.0
2;292;1023;1024;1;49;2.0
2;293;1024;1027;3;49;2.0
2;294;1027;1030;3;49;2.0
2;295;1030;1031;1;49;2.0
2;296;1031;1032;1;49;2.0
2;297;1032;1033;1;49;2.0
2;298;1033;1034;1;49;2.0
2;299;1034;1035;1;49;2.0
2;300;1035;1037;2;49;2.0
2;301;1037;1039;2;49;2.0
2;302;1039;1044;5;49;2.0
2;303;1044;1045;1;49;2.0
2;304;1045;1047;2;49;2.0
2;305;1047;1048;1;49;2.0
2;306;1048;1049;1;49;2.0
2;307;1049;1056;7;49;2.0
2;308;1056;1058;2;49;2.0
2;309;1058;1061;3;49;2.0
2;310;1061;1062;1;49;2.0
2;311;1062;1064;2;49;2.0
2;312;1064;1065;1;49;2.0
2;313;1065;1067;2;49;2.0
2;314;1067;1069;2;49;2.0
2;315;1069;1070;1;49;2.0
2;316;1070;1077;7;49;2.0
2;317;1077;1078;1;49;2.0
2;318;1078;1079;1;49;2.0
2;319;1079;1081;2;49;2.0
2;320;1081;1084;3;49;2.0
2;321;1084;1086;2;49;2.0
2;322;1086;1087;1;49;2.0
2;323;1087;1088;1;49;2.0
2;324;1088;1090;2;49;2.0
2;325;1090;1092;2;49;2.0
2;326;1092;1095;3;49;2.0
2;327;1095;1096;1;49;2.0
2;328;1096;1098;2;49;2.0
2;329;1098;1099;1;49;2.0
2;330;1099;1100;1;49;2.0
2;331;1100;1102;2;49;2.0
2;332;1102;1103;1;49;2.0
2;333;1103;1106;3;49;2.0
2;334;1106;1107;1;49;2.0
2;335;1107;1111;4;49;2.0
2;336;1111;1112;1;49;2.0
2;337;1112;1122;10;49;2.0
2;338;1122;1124;2;49;2.0
2;339;1124;1134;10;49;2.0
2;340;1134;1135;1;49;2.0
2;341;1135;1141;6;49;2.0
2;342;1141;1142;1;49;2.0
2;343;1142;1145;3;49;2.0
2;344;1145;1146;1;49;2.0
2;345;1146;1153;7;49;2.0
2;346;1153;1156;3;49;2.0
2;347;1156;1163;7;49;2.0
2;348;1163;1172;9;49;2.0
2;349;1172;1174;2;49;2.0
2;350;1174;1179;5;49;2.0
2;351;1179;1182;3;49;2.0
2;352;1182;1187;5;49;2.0
2;353;1187;1191;4;49;2.0
2;354;1191;1197;6;49;2.0
2;355;1197;1206;9;49;2.0
2;356;1206;1208;2;49;2.0
2;357;1208;1209;1;49;2.0
2;358;1209;1211;2;49;2.0
2;359;1211;1220;9;49;2.0
2;360;1220;1222;2;49;2.0
2;361;1222;1226;4;49;2.0
2;362;1226;1231;5;49;2.0
2;363;1231;1232;1;49;2.0
2;364;1232;1256;24;49;2.0
2;365;1256;1257;1;49;2.0
2;366;1257;1258;1;49;2.0
2;367;1258;1260;2;49;2.0
2;368;1260;1265;5;49;2.0
2;369;1265;1266;1;49;2.0
2;370;1266;1269;3;49;2.0
2;371;1269;1271;2;49;2.0
2;372;1271;1282;11;49;2.0
2;373;1282;1283;1;49;2.0
2;374;1283;1284;1;49;2.0
2;375;1284;1285;1;49;2.0
2;376;1285;1292;7;49;2.0
2;377;1292;1297;5;49;2.0
2;378;1297;1302;5;49;2.0
2;379;1302;1308;6;49;2.0
2;380;1308;1316;8;49;2.0
2;381;1316;1320;4;49;2.0
2;382;1320;1321;1;49;2.0
2;383;1321;1323;2;49;2.0
2;384;1323;1324;1;49;2.0
2;385;1324;1331;7;49;2.0
2;386;1331;1332;1;49;2.0
2;387;1332;1335;3;49;2.0
2;388;1335;1339;4;49;2.0
2;389;1339;1342;3;49;2.0
2;390;1342;1346;4;49;2.0
2;391;1346;1347;1;49;2.0
2;392;1347;1358;11;49;2.0
2;393;1358;1361;3;49;2.0
2;394;1361;1364;3;49;2.0
2;395;1364;1367;3;49;2.0
2;396;1367;1368;1;49;2.0
2;397;1368;1369;1;49;2.0
2;398;1369;1371;2;49;2.0
2;399;1371;1374;3;49;2.0
2;400;1374;1380;6;49;2.0
2;401;1380;1381;1;49;2.0
2;402;1381;1382;1;49;2.0
2;403;1382;1385;3;49;2.0
2;404;1385;1387;2;49;2.0
2;405;1387;1391;4;49;2.0
2;406;1391;1397;6;49;2.0
2;407;1397;1412;15;49;2.0
2;408;1412;1427;15;49;2.0
2;409;1427;1442;15;49;2.0
2;410;1442;1457;15;49;2.0
2;411;1457;1472;15;49;2.0
2;412;1472;1487;15;49;2.0
2;413;1487;1502;15;49;2.0
2;414;1502;1517;15;49;2.0
2;415;1517;1532;15;49;2.0
2;416;1532;1547;15;49;2.0
2;417;1547;1562;15;49;2.0
2;418;1562;1577;15;49;2.0
2;419;1577;1592;15;49;2.0
2;420;1592;1607;15;49;2.0
2;421;1607;1622;15;49;2.0
2;422;1622;1637;15;49;2.0
2;423;1637;1652;15;49;2.0
2;424;1652;1667;15;49;2.0
2;425;1667;1680;13;49;2.0
3;0;244;284;40;77;2.0
3;1;284;325;41;77;2.0
3;2;325;327;2;77;2.0
3;3;327;329;2;77;2.0
3;4;329;330;1;77;2.0
3;5;330;331;1;77;2.0
3;6;331;334;3;77;2.0
3;7;334;335;1;77;2.0
3;8;335;336;1;77;2.0
3;9;336;337;1;77;2.0
3;10;337;338;1;77;2.0
3;11;338;344;6;77;2.0
3;12;344;346;2;77;2.0
3;13;346;347;1;77;2.0
3;14;347;349;2;77;2.0
3;15;349;354;5;77;2.0
3;16;354;356;2;77;2.0
3;17;356;357;1;77;2.0
3;18;357;359;2;77;2.0
3;19;359;361;2;77;2.0
3;20;361;362;1;77;2.0
3;21;362;363;1;77;2.0
3;22;363;366;3;77;2.0
3;23;366;367;1;77;2.0
3;24;367;371;4;77;2.0
3;25;371;372;1;77;2.0
3;26;372;376;4;77;2.0
3;27;376;381;5;77;2.0
3;28;381;384;3;77;2.0
3;29;384;386;2;77;2.0
3;30;386;387;1;77;2.0
3;31;387;389;2;77;2.0
3;32;389;392;3;77;2.0
3;33;392;393;1;77;2.0
3;34;393;396;3;77;2.0
3;35;396;397;1;77;2.0
3;36;397;398;1;77;2.0
3;37;398;399;1;77;2.0
3;38;399;402;3;77;2.0
3;39;402;404;2;77;2.0
3;40;404;406;2;77;2.0
3;41;406;407;1;77;2.0
3;42;407;410;3;77;2.0
3;43;410;414;4;77;2.0
3;44;414;416;2;77;2.0
3;45;416;417;1;77;2.0
3;46;417;418;1;77;2.0
3;47;418;419;1;77;2.0
3;48;419;420;1;77;2.0
3;49;420;421;1;77;2.0
3;50;421;424;3;77;2.0
3;51;424;426;2;77;2.0
3;52;426;427;1;77;2.0
3;53;427;429;2;77;2.0
3;54;429;431;2;77;2.0
3;55;431;432;1;77;2.0
3;56;432;433;1;77;2.0
3;57;433;434;1;77;2.0
3;58;434;437;3;77;2.0
3;59;437;442;5;77;2.0
3;60;442;443;1;77;2.0
3;61;443;446;3;77;2.0
3;62;446;449;3;77;2.0
3;63;449;451;2;77;2.0
3;64;451;452;1;77;2.0
3;65;452;454;2;77;2.0
3;66;454;456;2;77;2.0
3;67;456;458;2;77;2.0
3;68;458;462;4;77;2.0
3;69;462;464;2;77;2.0
3;70;464;467;3;77;2.0
3;71;467;469;2;77;2.0
3;72;469;472;3;77;2.0
3;73;472;473;1;77;2.0
3;74;473;474;1;77;2.0
3;75;474;476;2;77;2.0
3;76;476;477;1;77;2.0
3;77;477;479;2;77;2.0
3;78;479;481;2;77;2.0
3;79;481;482;1;77;2.0
3;80;482;483;1;77;2.0
3;81;483;486;3;77;2.0
3;82;486;494;8;77;2.0
3;83;494;495;1;77;2.0
3;84;495;497;2;77;2.0
3;85;497;499;2;77;2.0
3;86;499;503;4;77;2.0
3;87;503;505;2;77;2.0
3;88;505;507;2;77;2.0
3;89;507;514;7;77;2.0
3;90;514;515;1;77;2.0
3;91;515;516;1;77;2.0
3;92;516;522;6;77;2.0
3;93;522;523;1;77;2.0
3;94;523;527;4;77;2.0
3;95;527;530;3;77;2.0
3;96;530;531;1;77;2.0
3;97;531;534;3;77;2.0
3;98;534;536;2;77;2.0
3;99;536;538;2;77;2.0
3;100;538;544;6;77;2.0
3;101;544;545;1;77;2.0
3;102;545;546;1;77;2.0
3;103;546;547;1;77;2.0
3;104;547;548;1;77;2.0
3;105;548;550;2;77;2.0
3;106;550;552;2;77;2.0
3;107;552;555;3;77;2.0
3;108;555;557;2;77;2.0
3;109;557;558;1;77;2.0
3;110;558;570;12;77;2.0
3;111;570;574;4;77;2.0
3;112;574;579;5;77;2.0
3;113;579;582;3;77;2.0
3;114;582;584;2;77;2.0
3;115;584;587;3;77;2.0
3;116;587;588;1;77;2.0
3;117;588;589;1;77;2.0
3;118;589;590;1;77;2.0
3;119;590;594;4;77;2.0
3;120;594;608;14;77;2.0
3;121;608;617;9;77;2.0
3;122;617;619;2;77;2.0
3;123;619;621;2;77;2.0
3;124;621;626;5;77;2.0
3;125;626;627;1;77;2.0
3;126;627;630;3;77;2.0
3;127;630;631;1;77;2.0
3;128;631;632;1;77;2.0
3;129;632;635;3;77;2.0
3;130;635;650;15;77;2.0
3;131;650;652;2;77;2.0
3;132;652;654;2;77;2.0
3;133;654;656;2;77;2.0
3;134;656;657;1;77;2.0
3;135;657;658;1;77;2.0
3;136;658;669;11;77;2.0
3;137;669;675;6;77;2.0
3;138;675;683;8;77;2.0
3;139;683;689;6;77;2.0
3;140;689;694;5;77;2.0
3;141;694;696;2;77;2.0
3;142;696;697;1;77;2.0
3;143;697;702;5;77;2.0
3;144;702;705;3;77;2.0
3;145;705;708;3;77;2.0
3;146;708;710;2;77;2.0
3;147;710;714;4;77;2.0
3;148;714;719;5;77;2.0
3;149;719;720;1;77;2.0
3;150;720;723;3;77;2.0
3;151;723;724;1;77;2.0
3;152;724;727;3;77;2.0
3;153;727;737;10;77;2.0
3;154;737;739;2;77;2.0
3;155;739;741;2;77;2.0
3;156;741;746;5;77;2.0
3;157;746;750;4;77;2.0
3;158;750;751;1;77;2.0
3;159;751;756;5;77;2.0
3;160;756;759;3;77;2.0
3;161;759;762;3;77;2.0
3;162;762;764;2;77;2.0
3;163;764;765;1;77;2.0
3;164;765;770;5;77;2.0
3;165;770;773;3;77;2.0
3;166;773;775;2;77;2.0
3;167;775;777;2;77;2.0
3;168;777;779;2;77;2.0
3;169;779;784;5;77;2.0
3;170;784;785;1;77;2.0
3;171;785;793;8;77;2.0
3;172;793;794;1;77;2.0
3;173;794;797;3;77;2.0
3;174;797;800;3;77;2.0
3;175;800;802;2;77;2.0
3;176;802;804;2;77;2.0
3;177;804;806;2;77;2.0
3;178;806;807;1;77;2.0
3;179;807;813;6;77;2.0
3;180;813;814;1;77;2.0
3;181;814;815;1;77;2.0
3;182;815;816;1;77;2.0
3;183;816;819;3;77;2.0
3;184;819;820;1;77;2.0
3;185;820;821;1;77;2.0
3;186;821;822;1;77;2.0
3;187;822;829;7;77;2.0
3;188;829;830;1;77;2.0
3;189;830;834;4;77;2.0
3;190;834;835;1;77;2.0
3;191;835;837;2;77;2.0
3;192;837;838;1;77;2.0
3;193;838;839;1;77;2.0
3;194;839;844;5;77;2.0
3;195;844;847;3;77;2.0
3;196;847;848;1;77;2.0
3;197;848;850;2;77;2.0
3;198;850;854;4;77;2.0
3;199;854;857;3;77;2.0
3;200;857;859;2;77;2.0
3;201;859;860;1;77;2.0
3;202;860;863;3;77;2.0
3;203;863;867;4;77;2.0
3;204;867;869;2;77;2.0
3;205;869;871;2;77;2.0
3;206;871;872;1;77;2.0
3;207;872;874;2;77;2.0
3;208;874;876;2;77;2.0
3;209;876;877;1;77;2.0
3;210;877;878;1;77;2.0
3;211;878;881;3;77;2.0
3;212;881;882;1;77;2.0
3;213;882;884;2;77;2.0
3;214;884;887;3;77;2.0
3;215;887;889;2;77;2.0
3;216;889;890;1;77;2.0
3;217;890;893;3;77;2.0
3;218;893;894;1;77;2.0
3;219;894;897;3;77;2.0
3;220;897;899;2;77;2.0
3;221;899;901;2;77;2.0
3;222;901;902;1;77;2.0
3;223;902;903;1;77;2.0
3;224;903;904;1;77;2.0
3;225;904;906;2;77;2.0
3;226;906;908;2;77;2.0
3;227;908;909;1;77;2.0
3;228;909;910;1;77;2.0
3;229;910;912;2;77;2.0
3;230;912;913;1;77;2.0
3;231;913;914;1;77;2.0
3;232;914;916;2;77;2.0
3;233;916;917;1;77;2.0
3;234;917;922;5;77;2.0
3;235;922;926;4;77;2.0
3;236;926;927;1;77;2.0
3;237;927;929;2;77;2.0
3;238;929;931;2;77;2.0
3;239;931;932;1;77;2.0
3;240;932;933;1;77;2.0
3;241;933;934;1;77;2.0
3;242;934;936;2;77;2.0
3;243;936;939;3;77;2.0
3;244;939;942;3;77;2.0
3;245;942;943;1;77;2.0
3;246;943;944;1;77;2.0
3;247;944;948;4;77;2.0
3;248;948;949;1;77;2.0
3;249;949;954;5;77;2.0
3;250;954;957;3;77;2.0
3;251;957;959;2;77;2.0
3;252;959;961;2;77;2.0
3;253;961;964;3;77;2.0
3;254;964;966;2;77;2.0
3;255;966;967;1;77;2.0
3;256;967;968;1;77;2.0
3;257;968;969;1;77;2.0
3;258;969;970;1;77;2.0
3;259;970;972;2;77;2.0
3;260;972;973;1;77;2.0
3;261;973;974;1;77;2.0
3;262;974;977;3;77;2.0
3;263;977;979;2;77;2.0
3;264;979;982;3;77;2.0
3;265;982;989;7;77;2.0
3;266;989;994;5;77;2.0
3;267;994;996;2;77;2.0
3;268;996;997;1;77;2.0
3;269;997;999;2;77;2.0
3;270;999;1001;2;77;2.0
3;271;1001;1002;1;77;2.0
3;272;1002;1003;1;77;2.0
3;273;1003;1004;1;77;2.0
3;274;1004;1005;1;77;2.0
3;275;1005;1012;7;77;2.0
3;276;1012;1014;2;77;2.0
3;277;1014;1015;1;77;2.0
3;278;1015;1016;1;77;2.0
3;279;1016;1017;1;77;2.0
3;280;1017;1021;4;77;2.0
3;281;1021;1022;1;77;2.0
3;282;1022;1025;3;77;2.0
3;283;1025;1027;2;77;2.0
3;284;1027;1028;1;77;2.0
3;285;1028;1029;1;77;2.0
3;286;1029;1031;2;77;2.0
3;287;1031;1033;2;77;2.0
3;288;1033;1034;1;77;2.0
3;289;1034;1035;1;77;2.0
3;290;1035;1042;7;77;2.0
3;291;1042;1044;2;77;2.0
3;292;1044;1046;2;77;2.0
3;293;1046;1047;1;77;2.0
3;294;1047;1049;2;77;2.0
3;295;1049;1054;5;77;2.0
3;296;1054;1056;2;77;2.0
3;297;1056;1057;1;77;2.0
3;298;1057;1059;2;77;2.0
3;299;1059;1063;4;77;2.0
3;300;1063;1064;1;77;2.0
3;301;1064;1067;3;77;2.0
3;302;1067;1072;5;77;2.0
3;303;1072;1074;2;77;2.0
3;304;1074;1076;2;77;2.0
3;305;1076;1078;2;77;2.0
3;306;1078;1081;3;77;2.0
3;307;1081;1084;3;77;2.0
3;308;1084;1086;2;77;2.0
3;309;1086;1087;1;77;2.0
3;310;1087;1088;1;77;2.0
3;311;1088;1091;3;77;2.0
3;312;1091;1095;4;77;2.0
3;313;1095;1096;1;77;2.0
3;314;1096;1097;1;77;2.0
3;315;1097;1099;2;77;2.0
3;316;1099;1102;3;77;2.0
3;317;1102;1105;3;77;2.0
3;318;1105;1108;3;77;2.0
3;319;1108;1111;3;77;2.0
3;320;1111;1113;2;77;2.0
3;321;1113;1119;6;77;2.0
3;322;1119;1123;4;77;2.0
3;323;1123;1130;7;77;2.0
3;324;1130;1135;5;77;2.0
3;325;1135;1139;4;77;2.0
3;326;1139;1143;4;77;2.0
3;327;1143;1146;3;77;2.0
3;328;1146;1148;2;77;2.0
3;329;1148;1152;4;77;2.0
3;330;1152;1153;1;77;2.0
3;331;1153;1156;3;77;2.0
3;332;1156;1162;6;77;2.0
3;333;1162;1170;8;77;2.0
3;334;1170;1172;2;77;2.0
3;335;1172;1173;1;77;2.0
3;336;1173;1178;5;77;2.0
3;337;1178;1183;5;77;2.0
3;338;1183;1187;4;77;2.0
3;339;1187;1190;3;77;2.0
3;340;1190;1198;8;77;2.0
3;341;1198;1205;7;77;2.0
3;342;1205;1206;1;77;2.0
3;343;1206;1207;1;77;2.0
3;344;1207;1211;4;77;2.0
3;345;1211;1221;10;77;2.0
3;346;1221;1222;1;77;2.0
3;347;1222;1225;3;77;2.0
3;348;1225;1227;2;77;2.0
3;349;1227;1233;6;77;2.0
3;350;1233;1255;22;77;2.0
3;351;1255;1258;3;77;2.0
3;352;1258;1259;1;77;2.0
3;353;1259;1260;1;77;2.0
3;354;1260;1265;5;77;2.0
3;355;1265;1266;1;77;2.0
3;356;1266;1267;1;77;2.0
3;357;1267;1268;1;77;2.0
3;358;1268;1273;5;77;2.0
3;359;1273;1282;9;77;2.0
3;360;1282;1283;1;77;2.0
3;361;1283;1284;1;77;2.0
3;362;1284;1293;9;77;2.0
3;363;1293;1298;5;77;2.0
3;364;1298;1305;7;77;2.0
3;365;1305;1311;6;77;2.0
3;366;1311;1316;5;77;2.0
3;367;1316;1317;1;77;2.0
3;368;1317;1319;2;77;2.0
3;369;1319;1320;1;77;2.0
3;370;1320;1325;5;77;2.0
3;371;1325;1329;4;77;2.0
3;372;1329;1334;5;77;2.0
3;373;1334;1337;3;77;2.0
3;374;1337;1339;2;77;2.0
3;375;1339;1343;4;77;2.0
3;376;1343;1346;3;77;2.0
3;377;1346;1359;13;77;2.0
3;378;1359;1362;3;77;2.0
3;379;1362;1364;2;77;2.0
3;380;1364;1365;1;77;2.0
3;381;1365;1367;2;77;2.0
3;382;1367;1370;3;77;2.0
3;383;1370;1373;3;77;2.0
3;384;1373;1377;4;77;2.0
3;385;1377;1380;3;77;2.0
3;386;1380;1381;1;77;2.0
3;387;1381;1387;6;77;2.0
3;388;1387;1388;1;77;2.0
3;389;1388;1389;1;77;2.0
3;390;1389;1396;7;77;2.0
3;391;1396;1411;15;77;2.0
3;392;1411;1426;15;77;2.0
3;393;1426;1441;15;77;2.0
3;394;1441;1456;15;77;2.0
3;395;1456;1471;15;77;2.0
3;396;1471;1486;15;77;2.0
3;397;1486;1501;15;77;2.0
3;398;1501;1516;15;77;2.0
3;399;1516;1531;15;77;2.0
3;400;1531;1546;15;77;2.0
3;401;1546;1561;15;77;2.0
3;402;1561;1576;15;77;2.0
3;403;1576;1591;15;77;2.0
3;404;1591;1606;15;77;2.0
3;405;1606;1621;15;77;2.0
3;406;1621;1636;15;77;2.0
3;407;1636;1651;15;77;2.0
3;408;1651;1666;15;77;2.0
3;409;1666;1680;14;77;2.0
4;0;243;284;41;93;2.0
4;1;284;326;42;93;2.0
4;2;326;327;1;93;2.0
4;3;327;329;2;93;2.0
4;4;329;331;2;93;2.0
4;5;331;332;1;93;2.0
4;6;332;334;2;93;2.0
4;7;334;335;1;93;2.0
4;8;335;336;1;93;2.0
4;9;336;338;2;93;2.0
4;10;338;346;8;93;2.0
4;11;346;347;1;93;2.0
4;12;347;348;1;93;2.0
4;13;348;351;3;93;2.0
4;14;351;354;3;93;2.0
4;15;354;355;1;93;2.0
4;16;355;356;1;93;2.0
4;17;356;358;2;93;2.0
4;18;358;360;2;93;2.0
4;19;360;361;1;93;2.0
4;20;361;362;1;93;2.0
4;21;362;365;3;93;2.0
4;22;365;367;2;93;2.0
4;23;367;370;3;93;2.0
4;24;370;371;1;93;2.0
4;25;371;372;1;93;2.0
4;26;372;380;8;93;2.0
4;27;380;382;2;93;2.0
4;28;382;385;3;93;2.0
4;29;385;386;1;93;2.0
4;30;386;387;1;93;2.0
4;31;387;388;1;93;2.0
4;32;388;390;2;93;2.0
4;33;390;391;1;93;2.0
4;34;391;393;2;93;2.0
4;35;393;397;4;93;2.0
4;36;397;398;1;93;2.0
4;37;398;399;1;93;2.0
4;38;399;403;4;93;2.0
4;39;403;405;2;93;2.0
4;40;405;406;1;93;2.0
4;41;406;410;4;93;2.0
4;42;410;414;4;93;2.0
4;43;414;415;1;93;2.0
4;44;415;416;1;93;2.0
4;45;416;417;1;93;2.0
4;46;417;418;1;93;2.0
4;47;418;419;1;93;2.0
4;48;419;420;1;93;2.0
4;49;420;421;1;93;2.0
4;50;421;423;2;93;2.0
4;51;423;425;2;93;2.0
4;52;425;427;2;93;2.0
4;53;427;428;1;93;2.0
4;54;428;429;1;93;2.0
4;55;429;430;1;93;2.0
4;56;430;431;1;93;2.0
4;57;431;432;1;93;2.0
4;58;432;436;4;93;2.0
4;59;436;437;1;93;2.0
4;60;437;440;3;93;2.0
4;61;440;445;5;93;2.0
4;62;445;446;1;93;2.0
4;63;446;447;1;93;2.0
4;64;447;450;3;93;2.0
4;65;450;451;1;93;2.0
4;66;451;452;1;93;2.0
4;67;452;453;1;93;2.0
4;68;453;454;1;93;2.0
4;69;454;457;3;93;2.0
4;70;457;460;3;93;2.0
4;71;460;464;4;93;2.0
4;72;464;466;2;93;2.0
4;73;466;467;1;93;2.0
4;74;467;468;1;93;2.0
4;75;468;469;1;93;2.0
4;76;469;470;1;93;2.0
4;77;470;472;2;93;2.0
4;78;472;474;2;93;2.0
4;79;474;476;2;93;2.0
4;80;476;478;2;93;2.0
4;81;478;480;2;93;2.0
4;82;480;481;1;93;2.0
4;83;481;482;1;93;2.0
4;84;482;483;1;93;2.0
4;85;483;486;3;93;2.0
4;86;486;495;9;93;2.0
4;87;495;496;1;93;2.0
4;88;496;499;3;93;2.0
4;89;499;503;4;93;2.0
4;90;503;505;2;93;2.0
4;91;505;507;2;93;2.0
4;92;507;514;7;93;2.0
4;93;514;516;2;93;2.0
4;94;516;518;2;93;2.0
4;95;518;520;2;93;2.0
4;96;520;522;2;93;2.0
4;97;522;525;3;93;2.0
4;98;525;527;2;93;2.0
4;99;527;532;5;93;2.0
4;100;532;534;2;93;2.0
4;101;534;538;4;93;2.0
4;102;538;540;2;93;2.0
4;103;540;544;4;93;2.0
4;104;544;545;1;93;2.0
4;105;545;548;3;93;2.0
4;106;548;549;1;93;2.0
4;107;549;550;1;93;2.0
4;108;550;552;2;93;2.0
4;109;552;555;3;93;2.0
4;110;555;556;1;93;2.0
4;111;556;557;1;93;2.0
4;112;557;574;17;93;2.0
4;113;574;576;2;93;2.0
4;114;576;580;4;93;2.0
4;115;580;587;7;93;2.0
4;116;587;588;1;93;2.0
4;117;588;590;2;93;2.0
4;118;590;591;1;93;2.0
4;119;591;592;1;93;2.0
4;120;592;594;2;93;2.0
4;121;594;605;11;93;2.0
4;122;605;617;12;93;2.0
4;123;617;619;2;93;2.0
4;124;619;623;4;93;2.0
4;125;623;625;2;93;2.0
4;126;625;627;2;93;2.0
4;127;627;629;2;93;2.0
4;128;629;630;1;93;2.0
4;129;630;631;1;93;2.0
4;130;631;636;5;93;2.0
4;131;636;652;16;93;2.0
4;132;652;657;5;93;2.0
4;133;657;658;1;93;2.0
4;134;658;660;2;93;2.0
4;135;660;666;6;93;2.0
4;136;666;671;5;93;2.0
4;137;671;676;5;93;2.0
4;138;676;683;7;93;2.0
4;139;683;693;10;93;2.0
4;140;693;694;1;93;2.0
4;141;694;697;3;93;2.0
4;142;697;700;3;93;2.0
4;143;700;705;5;93;2.0
4;144;705;712;7;93;2.0
4;145;712;714;2;93;2.0
4;146;714;719;5;93;2.0
4;147;719;721;2;93;2.0
4;148;721;725;4;93;2.0
4;149;725;727;2;93;2.0
4;150;727;728;1;93;2.0
4;151;728;736;8;93;2.0
4;152;736;737;1;93;2.0
4;153;737;739;2;93;2.0
4;154;739;747;8;93;2.0
4;155;747;750;3;93;2.0
4;156;750;751;1;93;2.0
4;157;751;758;7;93;2.0
4;158;758;760;2;93;2.0
4;159;760;766;6;93;2.0
4;160;766;768;2;93;2.0
4;161;768;772;4;93;2.0
4;162;772;773;1;93;2.0
4;163;773;775;2;93;2.0
4;164;775;777;2;93;2.0
4;165;777;779;2;93;2.0
4;166;779;785;6;93;2.0
4;167;785;788;3;93;2.0
4;168;788;794;6;93;2.0
4;169;794;795;1;93;2.0
4;170;795;797;2;93;2.0
4;171;797;800;3;93;2.0
4;172;800;801;1;93;2.0
4;173;801;802;1;93;2.0
4;174;802;806;4;93;2.0
4;175;806;807;1;93;2.0
4;176;807;810;3;93;2.0
4;177;810;815;5;93;2.0
4;178;815;818;3;93;2.0
4;179;818;819;1;93;2.0
4;180;819;820;1;93;2.0
4;181;820;822;2;93;2.0
4;182;822;828;6;93;2.0
4;183;828;832;4;93;2.0
4;184;832;834;2;93;2.0
4;185;834;835;1;93;2.0
4;186;835;836;1;93;2.0
4;187;836;837;1;93;2.0
4;188;837;838;1;93;2.0
4;189;838;839;1;93;2.0
4;190;839;841;2;93;2.0
4;191;841;845;4;93;2.0
4;192;845;848;3;93;2.0
4;193;848;850;2;93;2.0
4;194;850;854;4;93;2.0
4;195;854;857;3;93;2.0
4;196;857;860;3;93;2.0
4;197;860;861;1;93;2.0
4;198;861;863;2;93;2.0
4;199;863;865;2;93;2.0
4;200;865;866;1;93;2.0
4;201;866;869;3;93;2.0
4;202;869;871;2;93;2.0
4;203;871;872;1;93;2.0
4;204;872;874;2;93;2.0
4;205;874;875;1;93;2.0
4;206;875;877;2;93;2.0
4;207;877;878;1;93;2.0
4;208;878;880;2;93;2.0
4;209;880;883;3;93;2.0
4;210;883;884;1;93;2.0
4;211;884;887;3;93;2.0
4;212;887;888;1;93;2.0
4;213;888;889;1;93;2.0
4;214;889;890;1;93;2.0
4;215;890;892;2;93;2.0
4;216;892;894;2;93;2.0
4;217;894;897;3;93;2.0
4;218;897;900;3;93;2.0
4;219;900;901;1;93;2.0
4;220;901;903;2;93;2.0
4;221;903;904;1;93;2.0
4;222;904;908;4;93;2.0
4;223;908;909;1;93;2.0
4;224;909;910;1;93;2.0
4;225;910;912;2;93;2.0
4;226;912;914;2;93;2.0
4;227;914;915;1;93;2.0
4;228;915;917;2;93;2.0
4;229;917;918;1;93;2.0
4;230;918;922;4;93;2.0
4;231;922;924;2;93;2.0
4;232;924;926;2;93;2.0
4;233;926;927;1;93;2.0
4;234;927;929;2;93;2.0
4;235;929;930;1;93;2.0
4;236;930;931;1;93;2.0
4;237;931;932;1;93;2.0
4;238;932;934;2;93;2.0
4;239;934;938;4;93;2.0
4;240;938;939;1;93;2.0
4;241;939;940;1;93;2.0
4;242;940;942;2;93;2.0
4;243;942;943;1;93;2.0
4;244;943;944;1;93;2.0
4;245;944;945;1;93;2.0
4;246;945;949;4;93;2.0
4;247;949;955;6;93;2.0
4;248;955;956;1;93;2.0
4;249;956;957;1;93;2.0
4;250;957;958;1;93;2.0
4;251;958;959;1;93;2.0
4;252;959;961;2;93;2.0
4;253;961;964;3;93;2.0
4;254;964;967;3;93;2.0
4;255;967;968;1;93;2.0
4;256;968;969;1;93;2.0
4;257;969;970;1;93;2.0
4;258;970;972;2;93;2.0
4;259;972;975;3;93;2.0
4;260;975;977;2;93;2.0
4;261;977;978;1;93;2.0
4;262;978;979;1;93;2.0
4;263;979;982;3;93;2.0
4;264;982;989;7;93;2.0
4;265;989;994;5;93;2.0
4;266;994;995;1;93;2.0
4;267;995;998;3;93;2.0
4;268;998;1000;2;93;2.0
4;269;1000;1002;2;93;2.0
4;270;1002;1003;1;93;2.0
4;271;1003;1004;1;93;2.0
4;272;1004;1012;8;93;2.0
4;273;1012;1014;2;93;2.0
4;274;1014;1015;1;93;2.0
4;275;1015;1016;1;93;2.0
4;276;1016;1017;1;93;2.0
4;277;1017;1018;1;93;2.0
4;278;1018;1021;3;93;2.0
4;279;1021;1022;1;93;2.0
4;280;1022;1025;3;93;2.0
4;281;1025;1026;1;93;2.0
4;282;1026;1028;2;93;2.0
4;283;1028;1030;2;93;2.0
4;284;1030;1032;2;93;2.0
4;285;1032;1033;1;93;2.0
4;286;1033;1034;1;93;2.0
4;287;1034;1042;8;93;2.0
4;288;1042;1044;2;93;2.0
4;289;1044;1045;1;93;2.0
4;290;1045;1046;1;93;2.0
4;291;1046;1047;1;93;2.0
4;292;1047;1049;2;93;2.0
4;293;1049;1058;9;93;2.0
4;294;1058;1060;2;93;2.0
4;295;1060;1064;4;93;2.0
4;296;1064;1065;1;93;2.0
4;297;1065;1071;6;93;2.0
4;298;1071;1072;1;93;2.0
4;299;1072;1077;5;93;2.0
4;300;1077;1078;1;93;2.0
4;301;1078;1083;5;93;2.0
4;302;1083;1084;1;93;2.0
4;303;1084;1085;1;93;2.0
4;304;1085;1086;1;93;2.0
4;305;1086;1088;2;93;2.0
4;306;1088;1089;1;93;2.0
4;307;1089;1095;6;93;2.0
4;308;1095;1096;1;93;2.0
4;309;1096;1097;1;93;2.0
4;310;1097;1099;2;93;2.0
4;311;1099;1102;3;93;2.0
4;312;1102;1105;3;93;2.0
4;313;1105;1110;5;93;2.0
4;314;1110;1111;1;93;2.0
4;315;1111;1114;3;93;2.0
4;316;1114;1118;4;93;2.0
4;317;1118;1123;5;93;2.0
4;318;1123;1134;11;93;2.0
4;319;1134;1136;2;93;2.0
4;320;1136;1137;1;93;2.0
4;321;1137;1143;6;93;2.0
4;322;1143;1144;1;93;2.0
4;323;1144;1148;4;93;2.0
4;324;1148;1152;4;93;2.0
4;325;1152;1153;1;93;2.0
4;326;1153;1156;3;93;2.0
4;327;1156;1162;6;93;2.0
4;328;1162;1172;10;93;2.0
4;329;1172;1174;2;93;2.0
4;330;1174;1178;4;93;2.0
4;331;1178;1183;5;93;2.0
4;332;1183;1184;1;93;2.0
4;333;1184;1190;6;93;2.0
4;334;1190;1200;10;93;2.0
4;335;1200;1204;4;93;2.0
4;336;1204;1207;3;93;2.0
4;337;1207;1209;2;93;2.0
4;338;1209;1211;2;93;2.0
4;339;1211;1219;8;93;2.0
4;340;1219;1222;3;93;2.0
4;341;1222;1224;2;93;2.0
4;342;1224;1225;1;93;2.0
4;343;1225;1234;9;93;2.0
4;344;1234;1252;18;93;2.0
4;345;1252;1258;6;93;2.0
4;346;1258;1259;1;93;2.0
4;347;1259;1262;3;93;2.0
4;348;1262;1264;2;93;2.0
4;349;1264;1265;1;93;2.0
4;350;1265;1268;3;93;2.0
4;351;1268;1269;1;93;2.0
4;352;1269;1273;4;93;2.0
4;353;1273;1282;9;93;2.0
4;354;1282;1283;1;93;2.0
4;355;1283;1284;1;93;2.0
4;356;1284;1294;10;93;2.0
4;357;1294;1298;4;93;2.0
4;358;1298;1306;8;93;2.0
4;359;1306;1311;5;93;2.0
4;360;1311;1314;3;93;2.0
4;361;1314;1321;7;93;2.0
4;362;1321;1322;1;93;2.0
4;363;1322;1323;1;93;2.0
4;364;1323;1325;2;93;2.0
4;365;1325;1326;1;93;2.0
4;366;1326;1334;8;93;2.0
4;367;1334;1338;4;93;2.0
4;368;1338;1339;1;93;2.0
4;369;1339;1343;4;93;2.0
4;370;1343;1346;3;93;2.0
4;371;1346;1360;14;93;2.0
4;372;1360;1361;1;93;2.0
4;373;1361;1362;1;93;2.0
4;374;1362;1364;2;93;2.0
4;375;1364;1366;2;93;2.0
4;376;1366;1367;1;93;2.0
4;377;1367;1373;6;93;2.0
4;378;1373;1374;1;93;2.0
4;379;1374;1378;4;93;2.0
4;380;1378;1380;2;93;2.0
4;381;1380;1381;1;93;2.0
4;382;1381;1387;6;93;2.0
4;383;1387;1388;1;93;2.0
4;384;1388;1396;8;93;2.0
4;385;1396;1411;15;93;2.0
4;386;1411;1426;15;93;2.0
4;387;1426;1441;15;93;2.0
4;388;1441;1456;15;93;2.0
4;389;1456;1471;15;93;2.0
4;390;1471;1486;15;93;2.0
4;391;1486;1501;15;93;2.0
4;392;1501;1516;15;93;2.0
4;393;1516;1531;15;93;2.0
4;394;1531;1546;15;93;2.0
4;395;1546;1561;15;93;2.0
4;396;1561;1576;15;93;2.0
4;397;1576;1591;15;93;2.0
4;398;1591;1606;15;93;2.0
4;399;1606;1621;15;93;2.0
4;400;1621;1636;15;93;2.0
4;401;1636;1651;15;93;2.0
4;402;1651;1666;15;93;2.0
4;403;1666;1680;14;93;2.0
5;0;245;284;39;112;2.0
5;1;284;322;38;112;2.0
5;2;322;327;5;112;2.0
5;3;327;328;1;112;2.0
5;4;328;331;3;112;2.0
5;5;331;332;1;112;2.0
5;6;332;333;1;112;2.0
5;7;333;334;1;112;2.0
5;8;334;335;1;112;2.0
5;9;335;341;6;112;2.0
5;10;341;342;1;112;2.0
5;11;342;343;1;112;2.0
5;12;343;344;1;112;2.0
5;13;344;347;3;112;2.0
5;14;347;349;2;112;2.0
5;15;349;353;4;112;2.0
5;16;353;354;1;112;2.0
5;17;354;355;1;112;2.0
5;18;355;357;2;112;2.0
5;19;357;358;1;112;2.0
5;20;358;359;1;112;2.0
5;21;359;360;1;112;2.0
5;22;360;361;1;112;2.0
5;23;361;364;3;112;2.0
5;24;364;366;2;112;2.0
5;25;366;367;1;112;2.0
5;26;367;370;3;112;2.0
5;27;370;377;7;112;2.0
5;28;377;379;2;112;2.0
5;29;379;384;5;112;2.0
5;30;384;386;2;112;2.0
5;31;386;387;1;112;2.0
5;32;387;388;1;112;2.0
5;33;388;389;1;112;2.0
5;34;389;390;1;112;2.0
5;35;390;392;2;112;2.0
5;36;392;393;1;112;2.0
5;37;393;395;2;112;2.0
5;38;395;402;7;112;2.0
5;39;402;403;1;112;2.0
5;40;403;404;1;112;2.0
5;41;404;405;1;112;2.0
5;42;405;407;2;112;2.0
5;43;407;412;5;112;2.0
5;44;412;413;1;112;2.0
5;45;413;417;4;112;2.0
5;46;417;418;1;112;2.0
5;47;418;419;1;112;2.0
5;48;419;420;1;112;2.0
5;49;420;421;1;112;2.0
5;50;421;424;3;112;2.0
5;51;424;425;1;112;2.0
5;52;425;427;2;112;2.0
5;53;427;430;3;112;2.0
5;54;430;433;3;112;2.0
5;55;433;434;1;112;2.0
5;56;434;436;2;112;2.0
5;57;436;440;4;112;2.0
5;58;440;446;6;112;2.0
5;59;446;447;1;112;2.0
5;60;447;448;1;112;2.0
5;61;448;449;1;112;2.0
5;62;449;450;1;112;2.0
5;63;450;451;1;112;2.0
5;64;451;453;2;112;2.0
5;65;453;459;6;112;2.0
5;66;459;460;1;112;2.0
5;67;460;462;2;112;2.0
5;68;462;463;1;112;2.0
5;69;463;464;1;112;2.0
5;70;464;467;3;112;2.0
5;71;467;469;2;112;2.0
5;72;469;473;4;112;2.0
5;73;473;474;1;112;2.0
5;74;474;476;2;112;2.0
5;75;476;477;1;112;2.0
5;76;477;478;1;112;2.0
5;77;478;479;1;112;2.0
5;78;479;480;1;112;2.0
5;79;480;481;1;112;2.0
5;80;481;482;1;112;2.0
5;81;482;484;2;112;2.0
5;82;484;485;1;112;2.0
5;83;485;493;8;112;2.0
5;84;493;494;1;112;2.0
5;85;494;495;1;112;2.0
5;86;495;503;8;112;2.0
5;87;503;504;1;112;2.0
5;88;504;512;8;112;2.0
5;89;512;513;1;112;2.0
5;90;513;516;3;112;2.0
5;91;516;517;1;112;2.0
5;92;517;525;8;112;2.0
5;93;525;526;1;112;2.0
5;94;526;527;1;112;2.0
5;95;527;534;7;112;2.0
5;96;534;535;1;112;2.0
5;97;535;537;2;112;2.0
5;98;537;539;2;112;2.0
5;99;539;540;1;112;2.0
5;100;540;543;3;112;2.0
5;101;543;545;2;112;2.0
5;102;545;549;4;112;2.0
5;103;549;550;1;112;2.0
5;104;550;552;2;112;2.0
5;105;552;561;9;112;2.0
5;106;561;570;9;112;2.0
5;107;570;573;3;112;2.0
5;108;573;580;7;112;2.0
5;109;580;581;1;112;2.0
5;110;581;584;3;112;2.0
5;111;584;587;3;112;2.0
5;112;587;588;1;112;2.0
5;113;588;589;1;112;2.0
5;114;589;593;4;112;2.0
5;115;593;595;2;112;2.0
5;116;595;611;16;112;2.0
5;117;611;617;6;112;2.0
5;118;617;618;1;112;2.0
5;119;618;622;4;112;2.0
5;120;622;624;2;112;2.0
5;121;624;625;1;112;2.0
5;122;625;630;5;112;2.0
5;123;630;631;1;112;2.0
5;124;631;632;1;112;2.0
5;125;632;647;15;112;2.0
5;126;647;652;5;112;2.0
5;127;652;654;2;112;2.0
5;128;654;655;1;112;2.0
5;129;655;657;2;112;2.0
5;130;657;658;1;112;2.0
5;131;658;668;10;112;2.0
5;132;668;671;3;112;2.0
5;133;671;672;1;112;2.0
5;134;672;683;11;112;2.0
5;135;683;690;7;112;2.0
5;136;690;692;2;112;2.0
5;137;692;694;2;112;2.0
5;138;694;699;5;112;2.0
5;139;699;700;1;112;2.0
5;140;700;709;9;112;2.0
5;141;709;711;2;112;2.0
5;142;711;715;4;112;2.0
5;143;715;717;2;112;2.0
5;144;717;718;1;112;2.0
5;145;718;723;5;112;2.0
5;146;723;724;1;112;2.0
5;147;724;727;3;112;2.0
5;148;727;737;10;112;2.0
5;149;737;738;1;112;2.0
5;150;738;741;3;112;2.0
5;151;741;742;1;112;2.0
5;152;742;750;8;112;2.0
5;153;750;751;1;112;2.0
5;154;751;759;8;112;2.0
5;155;759;760;1;112;2.0
5;156;760;762;2;112;2.0
5;157;762;763;1;112;2.0
5;158;763;767;4;112;2.0
5;159;767;768;1;112;2.0
5;160;768;770;2;112;2.0
5;161;770;774;4;112;2.0
5;162;774;775;1;112;2.0
5;163;775;778;3;112;2.0
5;164;778;784;6;112;2.0
5;165;784;787;3;112;2.0
5;166;787;790;3;112;2.0
5;167;790;793;3;112;2.0
5;168;793;795;2;112;2.0
5;169;795;797;2;112;2.0
5;170;797;800;3;112;2.0
5;171;800;802;2;112;2.0
5;172;802;803;1;112;2.0
5;173;803;804;1;112;2.0
5;174;804;806;2;112;2.0
5;175;806;814;8;112;2.0
5;176;814;816;2;112;2.0
5;177;816;817;1;112;2.0
5;178;817;819;2;112;2.0
5;179;819;820;1;112;2.0
5;180;820;830;10;112;2.0
5;181;830;831;1;112;2.0
5;182;831;832;1;112;2.0
5;183;832;833;1;112;2.0
5;184;833;834;1;112;2.0
5;185;834;835;1;112;2.0
5;186;835;836;1;112;2.0
5;187;836;837;1;112;2.0
5;188;837;838;1;112;2.0
5;189;838;841;3;112;2.0
5;190;841;845;4;112;2.0
5;191;845;847;2;112;2.0
5;192;847;848;1;112;2.0
5;193;848;851;3;112;2.0
5;194;851;853;2;112;2.0
5;195;853;854;1;112;2.0
5;196;854;857;3;112;2.0
5;197;857;858;1;112;2.0
5;198;858;860;2;112;2.0
5;199;860;862;2;112;2.0
5;200;862;863;1;112;2.0
5;201;863;865;2;112;2.0
5;202;865;866;1;112;2.0
5;203;866;867;1;112;2.0
5;204;867;868;1;112;2.0
5;205;868;869;1;112;2.0
5;206;869;871;2;112;2.0
5;207;871;872;1;112;2.0
5;208;872;878;6;112;2.0
5;209;878;879;1;112;2.0
5;210;879;880;1;112;2.0
5;211;880;884;4;112;2.0
5;212;884;886;2;112;2.0
5;213;886;887;1;112;2.0
5;214;887;888;1;112;2.0
5;215;888;889;1;112;2.0
5;216;889;894;5;112;2.0
5;217;894;895;1;112;2.0
5;218;895;896;1;112;2.0
5;219;896;900;4;112;2.0
5;220;900;901;1;112;2.0
5;221;901;902;1;112;2.0
5;222;902;903;1;112;2.0
5;223;903;905;2;112;2.0
5;224;905;906;1;112;2.0
5;225;906;907;1;112;2.0
5;226;907;908;1;112;2.0
5;227;908;909;1;112;2.0
5;228;909;911;2;112;2.0
5;229;911;912;1;112;2.0
5;230;912;913;1;112;2.0
5;231;913;915;2;112;2.0
5;232;915;916;1;112;2.0
5;233;916;917;1;112;2.0
5;234;917;922;5;112;2.0
5;235;922;923;1;112;2.0
5;236;923;924;1;112;2.0
5;237;924;927;3;112;2.0
5;238;927;928;1;112;2.0
5;239;928;931;3;112;2.0
5;240;931;935;4;112;2.0
5;241;935;936;1;112;2.0
5;242;936;937;1;112;2.0
5;243;937;938;1;112;2.0
5;244;938;939;1;112;2.0
5;245;939;940;1;112;2.0
5;246;940;942;2;112;2.0
5;247;942;943;1;112;2.0
5;248;943;946;3;112;2.0
5;249;946;951;5;112;2.0
5;250;951;954;3;112;2.0
5;251;954;955;1;112;2.0
5;252;955;957;2;112;2.0
5;253;957;958;1;112;2.0
5;254;958;960;2;112;2.0
5;255;960;961;1;112;2.0
5;256;961;962;1;112;2.0
5;257;962;965;3;112;2.0
5;258;965;966;1;112;2.0
5;259;966;968;2;112;2.0
5;260;968;969;1;112;2.0
5;261;969;972;3;112;2.0
5;262;972;973;1;112;2.0
5;263;973;974;1;112;2.0
5;264;974;975;1;112;2.0
5;265;975;976;1;112;2.0
5;266;976;977;1;112;2.0
5;267;977;978;1;112;2.0
5;268;978;981;3;112;2.0
5;269;981;982;1;112;2.0
5;270;982;988;6;112;2.0
5;271;988;991;3;112;2.0
5;272;991;993;2;112;2.0
5;273;993;995;2;112;2.0
5;274;995;997;2;112;2.0
5;275;997;999;2;112;2.0
5;276;999;1000;1;112;2.0
5;277;1000;1003;3;112;2.0
5;278;1003;1006;3;112;2.0
5;279;1006;1007;1;112;2.0
5;280;1007;1008;1;112;2.0
5;281;1008;1010;2;112;2.0
5;282;1010;1011;1;112;2.0
5;283;1011;1014;3;112;2.0
5;284;1014;1016;2;112;2.0
5;285;1016;1017;1;112;2.0
5;286;1017;1021;4;112;2.0
5;287;1021;1022;1;112;2.0
5;288;1022;1025;3;112;2.0
5;289;1025;1028;3;112;2.0
5;290;1028;1030;2;112;2.0
5;291;1030;1031;1;112;2.0
5;292;1031;1033;2;112;2.0
5;293;1033;1034;1;112;2.0
5;294;1034;1036;2;112;2.0
5;295;1036;1037;1;112;2.0
5;296;1037;1038;1;112;2.0
5;297;1038;1043;5;112;2.0
5;298;1043;1045;2;112;2.0
5;299;1045;1047;2;112;2.0
5;300;1047;1048;1;112;2.0
5;301;1048;1054;6;112;2.0
5;302;1054;1055;1;112;2.0
5;303;1055;1057;2;112;2.0
5;304;1057;1059;2;112;2.0
5;305;1059;1060;1;112;2.0
5;306;1060;1063;3;112;2.0
5;307;1063;1065;2;112;2.0
5;308;1065;1066;1;112;2.0
5;309;1066;1067;1;112;2.0
5;310;1067;1072;5;112;2.0
5;311;1072;1076;4;112;2.0
5;312;1076;1077;1;112;2.0
5;313;1077;1078;1;112;2.0
5;314;1078;1080;2;112;2.0
5;315;1080;1083;3;112;2.0
5;316;1083;1084;1;112;2.0
5;317;1084;1085;1;112;2.0
5;318;1085;1086;1;112;2.0
5;319;1086;1087;1;112;2.0
5;320;1087;1088;1;112;2.0
5;321;1088;1091;3;112;2.0
5;322;1091;1093;2;112;2.0
5;323;1093;1095;2;112;2.0
5;324;1095;1097;2;112;2.0
5;325;1097;1098;1;112;2.0
5;326;1098;1099;1;112;2.0
5;327;1099;1101;2;112;2.0
5;328;1101;1102;1;112;2.0
5;329;1102;1105;3;112;2.0
5;330;1105;1106;1;112;2.0
5;331;1106;1110;4;112;2.0
5;332;1110;1120;10;112;2.0
5;333;1120;1123;3;112;2.0
5;334;1123;1133;10;112;2.0
5;335;1133;1134;1;112;2.0
5;336;1134;1139;5;112;2.0
5;337;1139;1140;1;112;2.0
5;338;1140;1141;1;112;2.0
5;339;1141;1143;2;112;2.0
5;340;1143;1144;1;112;2.0
5;341;1144;1152;8;112;2.0
5;342;1152;1155;3;112;2.0
5;343;1155;1162;7;112;2.0
5;344;1162;1170;8;112;2.0
5;345;1170;1171;1;112;2.0
5;346;1171;1173;2;112;2.0
5;347;1173;1178;5;112;2.0
5;348;1178;1180;2;112;2.0
5;349;1180;1185;5;112;2.0
5;350;1185;1190;5;112;2.0
5;351;1190;1196;6;112;2.0
5;352;1196;1204;8;112;2.0
5;353;1204;1207;3;112;2.0
5;354;1207;1208;1;112;2.0
5;355;1208;1210;2;112;2.0
5;356;1210;1218;8;112;2.0
5;357;1218;1221;3;112;2.0
5;358;1221;1225;4;112;2.0
5;359;1225;1230;5;112;2.0
5;360;1230;1254;24;112;2.0
5;361;1254;1255;1;112;2.0
5;362;1255;1257;2;112;2.0
5;363;1257;1259;2;112;2.0
5;364;1259;1263;4;112;2.0
5;365;1263;1264;1;112;2.0
5;366;1264;1265;1;112;2.0
5;367;1265;1268;3;112;2.0
5;368;1268;1269;1;112;2.0
5;369;1269;1270;1;112;2.0
5;370;1270;1281;11;112;2.0
5;371;1281;1282;1;112;2.0
5;372;1282;1283;1;112;2.0
5;373;1283;1284;1;112;2.0
5;374;1284;1290;6;112;2.0
5;375;1290;1295;5;112;2.0
5;376;1295;1300;5;112;2.0
5;377;1300;1306;6;112;2.0
5;378;1306;1314;8;112;2.0
5;379;1314;1319;5;112;2.0
5;380;1319;1320;1;112;2.0
5;381;1320;1322;2;112;2.0
5;382;1322;1331;9;112;2.0
5;383;1331;1333;2;112;2.0
5;384;1333;1334;1;112;2.0
5;385;1334;1338;4;112;2.0
5;386;1338;1340;2;112;2.0
5;387;1340;1345;5;112;2.0
5;388;1345;1346;1;112;2.0
5;389;1346;1356;10;112;2.0
5;390;1356;1357;1;112;2.0
5;391;1357;1359;2;112;2.0
5;392;1359;1363;4;112;2.0
5;393;1363;1366;3;112;2.0
5;394;1366;1367;1;112;2.0
5;395;1367;1368;1;112;2.0
5;396;1368;1369;1;112;2.0
5;397;1369;1373;4;112;2.0
5;398;1373;1378;5;112;2.0
5;399;1378;1380;2;112;2.0
5;400;1380;1381;1;112;2.0
5;401;1381;1383;2;112;2.0
5;402;1383;1386;3;112;2.0
5;403;1386;1390;4;112;2.0
5;404;1390;1396;6;112;2.0
5;405;1396;1411;15;112;2.0
5;406;1411;1426;15;112;2.0
5;407;1426;1441;15;112;2.0
5;408;1441;1456;15;112;2.0
5;409;1456;1471;15;112;2.0
5;410;1471;1486;15;112;2.0
5;411;1486;1501;15;112;2.0
5;412;1501;1516;15;112;2.0
5;413;1516;1531;15;112;2.0
5;414;1531;1546;15;112;2.0
5;415;1546;1561;15;112;2.0
5;416;1561;1576;15;112;2.0
5;417;1576;1591;15;112;2.0
5;418;1591;1606;15;112;2.0
5;419;1606;1621;15;112;2.0
5;420;1621;1636;15;112;2.0
5;421;1636;1651;15;112;2.0
5;422;1651;1666;15;112;2.0
5;423;1666;1680;14;112;2.0
6;0;245;284;39;112;2.0
6;1;284;322;38;112;2.0
6;2;322;327;5;112;2.0
6;3;327;328;1;112;2.0
6;4;328;331;3;112;2.0
6;5;331;332;1;112;2.0
6;6;332;333;1;112;2.0
6;7;333;334;1;112;2.0
6;8;334;335;1;112;2.0
6;9;335;341;6;112;2.0
6;10;341;342;1;112;2.0
6;11;342;343;1;112;2.0
6;12;343;344;1;112;2.0
6;13;344;347;3;112;2.0
6;14;347;349;2;112;2.0
6;15;349;353;4;112;2.0
6;16;353;354;1;112;2.0
6;17;354;355;1;112;2.0
6;18;355;357;2;112;2.0
6;19;357;358;1;112;2.0
6;20;358;359;1;112;2.0
6;21;359;360;1;112;2.0
6;22;360;361;1;112;2.0
6;23;361;364;3;112;2.0
6;24;364;366;2;112;2.0
6;25;366;367;1;112;2.0
6;26;367;370;3;112;2.0
6;27;370;377;7;112;2.0
6;28;377;379;2;112;2.0
6;29;379;384;5;112;2.0
6;30;384;386;2;112;2.0
6;31;386;387;1;112;2.0
6;32;387;388;1;112;2.0
6;33;388;389;1;112;2.0
6;34;389;390;1;112;2.0
6;35;390;392;2;112;2.0
6;36;392;393;1;112;2.0
6;37;393;395;2;112;2.0
6;38;395;402;7;112;2.0
6;39;402;403;1;112;2.0
6;40;403;404;1;112;2.0
6;41;404;405;1;112;2.0
6;42;405;407;2;112;2.0
6;43;407;412;5;112;2.0
6;44;412;413;1;112;2.0
6;45;413;417;4;112;2.0
6;46;417;418;1;112;2.0
6;47;418;419;1;112;2.0
6;48;419;420;1;112;2.0
6;49;420;421;1;112;2.0
6;50;421;424;3;112;2.0
6;51;424;425;1;112;2.0
6;52;425;427;2;112;2.0
6;53;427;430;3;112;2.0
6;54;430;433;3;112;2.0
6;55;433;434;1;112;2.0
6;56;434;436;2;112;2.0
6;57;436;440;4;112;2.0
6;58;440;446;6;112;2.0
6;59;446;447;1;112;2.0
6;60;447;448;1;112;2.0
6;61;448;449;1;112;2.0
6;62;449;450;1;112;2.0
6;63;450;451;1;112;2.0
6;64;451;453;2;112;2.0
6;65;453;459;6;112;2.0
6;66;459;460;1;112;2.0
6;67;460;462;2;112;2.0
6;68;462;463;1;112;2.0
6;69;463;464;1;112;2.0
6;70;464;467;3;112;2.0
6;71;467;469;2;112;2.0
6;72;469;473;4;112;2.0
6;73;473;474;1;112;2.0
6;74;474;476;2;112;2.0
6;75;476;477;1;112;2.0
6;76;477;478;1;112;2.0
6;77;478;479;1;112;2.0
6;78;479;480;1;112;2.0
6;79;480;481;1;112;2.0
6;80;481;482;1;112;2.0
6;81;482;484;2;112;2.0
6;82;484;485;1;112;2.0
6;83;485;493;8;112;2.0
6;84;493;494;1;112;2.0
6;85;494;495;1;112;2.0
6;86;495;503;8;112;2.0
6;87;503;504;1;112;2.0
6;88;504;512;8;112;2.0
6;89;512;513;1;112;2.0
6;90;513;516;3;112;2.0
6;91;516;517;1;112;2.0
6;92;517;525;8;112;2.0
6;93;525;526;1;112;2.0
6;94;526;527;1;112;2.0
6;95;527;534;7;112;2.0
6;96;534;535;1;112;2.0
6;97;535;537;2;112;2.0
6;98;537;539;2;112;2.0
6;99;539;540;1;112;2.0
6;100;540;543;3;112;2.0
6;101;543;545;2;112;2.0
6;102;545;549;4;112;2.0
6;103;549;550;1;112;2.0
6;104;550;552;2;112;2.0
6;105;552;561;9;112;2.0
6;106;561;570;9;112;2.0
6;107;570;573;3;112;2.0
6;108;573;580;7;112;2.0
6;109;580;581;1;112;2.0
6;110;581;584;3;112;2.0
6;111;584;587;3;112;2.0
6;112;587;588;1;112;2.0
6;113;588;589;1;112;2.0
6;114;589;593;4;112;2.0
6;115;593;595;2;112;2.0
6;116;595;611;16;112;2.0
6;117;611;617;6;112;2.0
6;118;617;618;1;112;2.0
6;119;618;622;4;112;2.0
6;120;622;624;2;112;2.0
6;121;624;625;1;112;2.0
6;122;625;630;5;112;2.0
6;123;630;631;1;112;2.0
6;124;631;632;1;112;2.0
6;125;632;647;15;112;2.0
6;126;647;652;5;112;2.0
6;127;652;654;2;112;2.0
6;128;654;655;1;112;2.0
6;129;655;657;2;112;2.0
6;130;657;658;1;112;2.0
6;131;658;668;10;112;2.0
6;132;668;671;3;112;2.0
6;133;671;672;1;112;2.0
6;134;672;683;11;112;2.0
6;135;683;690;7;112;2.0
6;136;690;692;2;112;2.0
6;137;692;694;2;112;2.0
6;138;694;699;5;112;2.0
6;139;699;700;1;112;2.0
6;140;700;709;9;112;2.0
6;141;709;711;2;112;2.0
6;142;711;715;4;112;2.0
6;143;715;717;2;112;2.0
6;144;717;718;1;112;2.0
6;145;718;723;5;112;2.0
6;146;723;724;1;112;2.0
6;147;724;727;3;112;2.0
6;148;727;737;10;112;2.0
6;149;737;738;1;112;2.0
6;150;738;741;3;112;2.0
6;151;741;742;1;112;2.0
6;152;742;750;8;112;2.0
6;153;750;751;1;112;2.0
6;154;751;759;8;112;2.0
6;155;759;760;1;112;2.0
6;156;760;762;2;112;2.0
6;157;762;763;1;112;2.0
6;158;763;767;4;112;2.0
6;159;767;768;1;112;2.0
6;160;768;770;2;112;2.0
6;161;770;774;4;112;2.0
6;162;774;775;1;112;2.0
6;163;775;778;3;112;2.0
6;164;778;784;6;112;2.0
6;165;784;787;3;112;2.0
6;166;787;790;3;112;2.0
6;167;790;793;3;112;2.0
6;168;793;795;2;112;2.0
6;169;795;797;2;112;2.0
6;170;797;800;3;112;2.0
6;171;800;802;2;112;2.0
6;172;802;803;1;112;2.0
6;173;803;804;1;112;2.0
6;174;804;806;2;112;2.0
6;175;806;814;8;112;2.0
6;176;814;816;2;112;2.0
6;177;816;817;1;112;2.0
6;178;817;819;2;112;2.0
6;179;819;820;1;112;2.0
6;180;820;830;10;112;2.0
6;181;830;831;1;112;2.0
6;182;831;832;1;112;2.0
6;183;832;833;1;112;2.0
6;184;833;834;1;112;2.0
6;185;834;835;1;112;2.0
6;186;835;836;1;112;2.0
6;187;836;837;1;112;2.0
6;188;837;838;1;112;2.0
6;189;838;841;3;112;2.0
6;190;841;845;4;112;2.0
6;191;845;847;2;112;2.0
6;192;847;848;1;112;2.0
6;193;848;851;3;112;2.0
6;194;851;853;2;112;2.0
6;195;853;854;1;112;2.0
6;196;854;857;3;112;2.0
6;197;857;858;1;112;2.0
6;198;858;860;2;112;2.0
6;199;860;862;2;112;2.0
6;200;862;863;1;112;2.0
6;201;863;865;2;112;2.0
6;202;865;866;1;112;2.0
6;203;866;867;1;112;2.0
6;204;867;868;1;112;2.0
6;205;868;869;1;112;2.0
6;206;869;871;2;112;2.0
6;207;871;872;1;112;2.0
6;208;872;878;6;112;2.0
6;209;878;879;1;112;2.0
6;210;879;880;1;112;2.0
6;211;880;884;4;112;2.0
6;212;884;886;2;112;2.0
6;213;886;887;1;112;2.0
6;214;887;888;1;112;2.0
6;215;888;889;1;112;2.0
6;216;889;894;5;112;2.0
6;217;894;895;1;112;2.0
6;218;895;896;1;112;2.0
6;219;896;900;4;112;2.0
6;220;900;901;1;112;2.0
6;221;901;902;1;112;2.0
6;222;902;903;1;112;2.0
6;223;903;905;2;112;2.0
6;224;905;906;1;112;2.0
6;225;906;907;1;112;2.0
6;226;907;908;1;112;2.0
6;227;908;909;1;112;2.0
6;228;909;911;2;112;2.0
6;229;911;912;1;112;2.0
6;230;912;913;1;112;2.0
6;231;913;915;2;112;2.0
6;232;915;916;1;112;2.0
6;233;916;917;1;112;2.0
6;234;917;922;5;112;2.0
6;235;922;923;1;112;2.0
6;236;923;924;1;112;2.0
6;237;924;927;3;112;2.0
6;238;927;928;1;112;2.0
6;239;928;931;3;112;2.0
6;240;931;935;4;112;2.0
6;241;935;936;1;112;2.0
6;242;936;937;1;112;2.0
6;243;937;938;1;112;2.0
6;244;938;939;1;112;2.0
6;245;939;940;1;112;2.0
6;246;940;942;2;112;2.0
6;247;942;943;1;112;2.0
6;248;943;946;3;112;2.0
6;249;946;951;5;112;2.0
6;250;951;954;3;112;2.0
6;251;954;955;1;112;2.0
6;252;955;957;2;112;2.0
6;253;957;958;1;112;2.0
6;254;958;960;2;112;2.0
6;255;960;961;1;112;2.0
6;256;961;962;1;112;2.0
6;257;962;965;3;112;2.0
6;258;965;966;1;112;2.0
6;259;966;968;2;112;2.0
6;260;968;969;1;112;2.0
6;261;969;972;3;112;2.0
6;262;972;973;1;112;2.0
6;263;973;974;1;112;2.0
6;264;974;975;1;112;2.0
6;265;975;976;1;112;2.0
6;266;976;977;1;112;2.0
6;267;977;978;1;112;2.0
6;268;978;981;3;112;2.0
6;269;981;982;1;112;2.0
6;270;982;988;6;112;2.0
6;271;988;991;3;112;2.0
6;272;991;993;2;112;2.0
6;273;993;995;2;112;2.0
6;274;995;997;2;112;2.0
6;275;997;999;2;112;2.0
6;276;999;1000;1;112;2.0
6;277;1000;1003;3;112;2.0
6;278;1003;1006;3;112;2.0
6;279;1006;1007;1;112;2.0
6;280;1007;1008;1;112;2.0
6;281;1008;1010;2;112;2.0
6;282;1010;1011;1;112;2.0
6;283;1011;1014;3;112;2.0
6;284;1014;1016;2;112;2.0
6;285;1016;1017;1;112;2.0
6;286;1017;1021;4;112;2.0
6;287;1021;1022;1;112;2.0
6;288;1022;1025;3;112;2.0
6;289;1025;1028;3;112;2.0
6;290;1028;1030;2;112;2.0
6;291;1030;1031;1;112;2.0
6;292;1031;1033;2;112;2.0
6;293;1033;1034;1;112;2.0
6;294;1034;1036;2;112;2.0
6;295;1036;1037;1;112;2.0
6;296;1037;1038;1;112;2.0
6;297;1038;1043;5;112;2.0
6;298;1043;1045;2;112;2.0
6;299;1045;1047;2;112;2.0
6;300;1047;1048;1;112;2.0
6;301;1048;1054;6;112;2.0
6;302;1054;1055;1;112;2.0
6;303;1055;1057;2;112;2.0
6;304;1057;1059;2;112;2.0
6;305;1059;1060;1;112;2.0
6;306;1060;1063;3;112;2.0
6;307;1063;1065;2;112;2.0
6;308;1065;1066;1;112;2.0
6;309;1066;1067;1;112;2.0
6;310;1067;1072;5;112;2.0
6;311;1072;1076;4;112;2.0
6;312;1076;1077;1;112;2.0
6;313;1077;1078;1;112;2.0
6;314;1078;1080;2;112;2.0
6;315;1080;1083;3;112;2.0
6;316;1083;1084;1;112;2.0
6;317;1084;1085;1;112;2.0
6;318;1085;1086;1;112;2.0
6;319;1086;1087;1;112;2.0
6;320;1087;1088;1;112;2.0
6;321;1088;1091;3;112;2.0
6;322;1091;1093;2;112;2.0
6;323;1093;1095;2;112;2.0
6;324;1095;1097;2;112;2.0
6;325;1097;1098;1;112;2.0
6;326;1098;1099;1;112;2.0
6;327;1099;1101;2;112;2.0
6;328;1101;1102;1;112;2.0
6;329;1102;1105;3;112;2.0
6;330;1105;1106;1;112;2.0
6;331;1106;1110;4;112;2.0
6;332;1110;1120;10;112;2.0
6;333;1120;1123;3;112;2.0
6;334;1123;1133;10;112;2.0
6;335;1133;1134;1;112;2.0
6;336;1134;1139;5;112;2.0
6;337;1139;1140;1;112;2.0
6;338;1140;1141;1;112;2.0
6;339;1141;1143;2;112;2.0
6;340;1143;1144;1;112;2.0
6;341;1144;1152;8;112;2.0
6;342;1152;1155;3;112;2.0
6;343;1155;1162;7;112;2.0
6;344;1162;1170;8;112;2.0
6;345;1170;1171;1;112;2.0
6;346;1171;1173;2;112;2.0
6;347;1173;1178;5;112;2.0
6;348;1178;1180;2;112;2.0
6;349;1180;1185;5;112;2.0
6;350;1185;1190;5;112;2.0
6;351;1190;1196;6;112;2.0
6;352;1196;1204;8;112;2.0
6;353;1204;1207;3;112;2.0
6;354;1207;1208;1;112;2.0
6;355;1208;1210;2;112;2.0
6;356;1210;1218;8;112;2.0
6;357;1218;1221;3;112;2.0
6;358;1221;1225;4;112;2.0
6;359;1225;1230;5;112;2.0
6;360;1230;1254;24;112;2.0
6;361;1254;1255;1;112;2.0
6;362;1255;1257;2;112;2.0
6;363;1257;1259;2;112;2.0
6;364;1259;1263;4;112;2.0
6;365;1263;1264;1;112;2.0
6;366;1264;1265;1;112;2.0
6;367;1265;1268;3;112;2.0
6;368;1268;1269;1;112;2.0
6;369;1269;1270;1;112;2.0
6;370;1270;1281;11;112;2.0
6;371;1281;1282;1;112;2.0
6;372;1282;1283;1;112;2.0
6;373;1283;1284;1;112;2.0
6;374;1284;1290;6;112;2.0
6;375;1290;1295;5;112;2.0
6;376;1295;1300;5;112;2.0
6;377;1300;1306;6;112;2.0
6;378;1306;1314;8;112;2.0
6;379;1314;1319;5;112;2.0
6;380;1319;1320;1;112;2.0
6;381;1320;1322;2;112;2.0
6;382;1322;1331;9;112;2.0
6;383;1331;1333;2;112;2.0
6;384;1333;1334;1;112;2.0
6;385;1334;1338;4;112;2.0
6;386;1338;1340;2;112;2.0
6;387;1340;1345;5;112;2.0
6;388;1345;1346;1;112;2.0
6;389;1346;1356;10;112;2.0
6;390;1356;1357;1;112;2.0
6;391;1357;1359;2;112;2.0
6;392;1359;1363;4;112;2.0
6;393;1363;1366;3;112;2.0
6;394;1366;1367;1;112;2.0
6;395;1367;1368;1;112;2.0
6;396;1368;1369;1;112;2.0
6;397;1369;1373;4;112;2.0
6;398;1373;1378;5;112;2.0
6;399;1378;1380;2;112;2.0
6;400;1380;1381;1;112;2.0
6;401;1381;1383;2;112;2.0
6;402;1383;1386;3;112;2.0
6;403;1386;1390;4;112;2.0
6;404;1390;1396;6;112;2.0
6;405;1396;1411;15;112;2.0
6;406;1411;1426;15;112;2.0
6;407;1426;1441;15;112;2.0
6;408;1441;1456;15;112;2.0
6;409;1456;1471;15;112;2.0
6;410;1471;1486;15;112;2.0
6;411;1486;1501;15;112;2.0
6;412;1501;1516;15;112;2.0
6;413;1516;1531;15;112;2.0
6;414;1531;1546;15;112;2.0
6;415;1546;1561;15;112;2.0
6;416;1561;1576;15;112;2.0
6;417;1576;1591;15;112;2.0
6;418;1591;1606;15;112;2.0
6;419;1606;1621;15;112;2.0
6;420;1621;1636;15;112;2.0
6;421;1636;1651;15;112;2.0
6;422;1651;1666;15;112;2.0
6;423;1666;1680;14;112;2.0
7;0;240;282;42;28;0.83
7;1;282;326;44;28;0.83
7;2;326;329;3;28;0.83
7;3;329;330;1;28;0.83
7;4;330;331;1;28;0.83
7;5;331;333;2;28;0.83
7;6;333;334;1;28;0.83
7;7;334;336;2;28;0.83
7;8;336;337;1;28;0.83
7;9;337;345;8;28;0.83
7;10;345;346;1;28;0.83
7;11;346;348;2;28;0.83
7;12;348;351;3;28;0.83
7;13;351;353;2;28;0.83
7;14;353;356;3;28;0.83
7;15;356;357;1;28;0.83
7;16;357;358;1;28;0.83
7;17;358;360;2;28;0.83
7;18;360;361;1;28;0.83
7;19;361;362;1;28;0.83
7;20;362;365;3;28;0.83
7;21;365;367;2;28;0.83
7;22;367;368;1;28;0.83
7;23;368;369;1;28;0.83
7;24;369;371;2;28;0.83
7;25;371;380;9;28;0.83
7;26;380;381;1;28;0.83
7;27;381;384;3;28;0.83
7;28;384;385;1;28;0.83
7;29;385;387;2;28;0.83
7;30;387;388;1;28;0.83
7;31;388;391;3;28;0.83
7;32;391;396;5;28;0.83
7;33;396;397;1;28;0.83
7;34;397;401;4;28;0.83
7;35;401;403;2;28;0.83
7;36;403;404;1;28;0.83
7;37;404;406;2;28;0.83
7;38;406;408;2;28;0.83
7;39;408;413;5;28;0.83
7;40;413;416;3;28;0.83
7;41;416;417;1;28;0.83
7;42;417;418;1;28;0.83
7;43;418;420;2;28;0.83
7;44;420;421;1;28;0.83
7;45;421;423;2;28;0.83
7;46;423;425;2;28;0.83
7;47;425;427;2;28;0.83
7;48;427;428;1;28;0.83
7;49;428;429;1;28;0.83
7;50;429;431;2;28;0.83
7;51;431;432;1;28;0.83
7;52;432;435;3;28;0.83
7;53;435;436;1;28;0.83
7;54;436;438;2;28;0.83
7;55;438;444;6;28;0.83
7;56;444;446;2;28;0.83
7;57;446;447;1;28;0.83
7;58;447;448;1;28;0.83
7;59;448;450;2;28;0.83
7;60;450;451;1;28;0.83
7;61;451;452;1;28;0.83
7;62;452;453;1;28;0.83
7;63;453;455;2;28;0.83
7;64;455;458;3;28;0.83
7;65;458;459;1;28;0.83
7;66;459;462;3;28;0.83
7;67;462;463;1;28;0.83
7;68;463;465;2;28;0.83
7;69;465;466;1;28;0.83
7;70;466;467;1;28;0.83
7;71;467;468;1;28;0.83
7;72;468;471;3;28;0.83
7;73;471;472;1;28;0.83
7;74;472;473;1;28;0.83
7;75;473;475;2;28;0.83
7;76;475;476;1;28;0.83
7;77;476;478;2;28;0.83
7;78;478;480;2;28;0.83
7;79;480;481;1;28;0.83
7;80;481;482;1;28;0.83
7;81;482;483;1;28;0.83
7;82;483;484;1;28;0.83
7;83;484;493;9;28;0.83
7;84;493;494;1;28;0.83
7;85;494;496;2;28;0.83
7;86;496;498;2;28;0.83
7;87;498;501;3;28;0.83
7;88;501;504;3;28;0.83
7;89;504;505;1;28;0.83
7;90;505;513;8;28;0.83
7;91;513;514;1;28;0.83
7;92;514;518;4;28;0.83
7;93;518;521;3;28;0.83
7;94;521;522;1;28;0.83
7;95;522;523;1;28;0.83
7;96;523;525;2;28;0.83
7;97;525;531;6;28;0.83
7;98;531;532;1;28;0.83
7;99;532;533;1;28;0.83
7;100;533;537;4;28;0.83
7;101;537;540;3;28;0.83
7;102;540;543;3;28;0.83
7;103;543;544;1;28;0.83
7;104;544;547;3;28;0.83
7;105;547;548;1;28;0.83
7;106;548;549;1;28;0.83
7;107;549;550;1;28;0.83
7;108;550;553;3;28;0.83
7;109;553;556;3;28;0.83
7;110;556;557;1;28;0.83
7;111;557;572;15;28;0.83
7;112;572;574;2;28;0.83
7;113;574;576;2;28;0.83
7;114;576;578;2;28;0.83
7;115;578;585;7;28;0.83
7;116;585;588;3;28;0.83
7;117;588;590;2;28;0.83
7;118;590;591;1;28;0.83
7;119;591;593;2;28;0.83
7;120;593;607;14;28;0.83
7;121;607;615;8;28;0.83
7;122;615;617;2;28;0.83
7;123;617;623;6;28;0.83
7;124;623;625;2;28;0.83
7;125;625;627;2;28;0.83
7;126;627;628;1;28;0.83
7;127;628;629;1;28;0.83
7;128;629;633;4;28;0.83
7;129;633;651;18;28;0.83
7;130;651;653;2;28;0.83
7;131;653;655;2;28;0.83
7;132;655;656;1;28;0.83
7;133;656;658;2;28;0.83
7;134;658;660;2;28;0.83
7;135;660;666;6;28;0.83
7;136;666;671;5;28;0.83
7;137;671;673;2;28;0.83
7;138;673;681;8;28;0.83
7;139;681;692;11;28;0.83
7;140;692;693;1;28;0.83
7;141;693;695;2;28;0.83
7;142;695;698;3;28;0.83
7;143;698;700;2;28;0.83
7;144;700;704;4;28;0.83
7;145;704;707;3;28;0.83
7;146;707;713;6;28;0.83
7;147;713;718;5;28;0.83
7;148;718;721;3;28;0.83
7;149;721;725;4;28;0.83
7;150;725;728;3;28;0.83
7;151;728;735;7;28;0.83
7;152;735;736;1;28;0.83
7;153;736;737;1;28;0.83
7;154;737;746;9;28;0.83
7;155;746;748;2;28;0.83
7;156;748;749;1;28;0.83
7;157;749;758;9;28;0.83
7;158;758;760;2;28;0.83
7;159;760;763;3;28;0.83
7;160;763;766;3;28;0.83
7;161;766;768;2;28;0.83
7;162;768;772;4;28;0.83
7;163;772;773;1;28;0.83
7;164;773;774;1;28;0.83
7;165;774;775;1;28;0.83
7;166;775;778;3;28;0.83
7;167;778;784;6;28;0.83
7;168;784;788;4;28;0.83
7;169;788;792;4;28;0.83
7;170;792;793;1;28;0.83
7;171;793;795;2;28;0.83
7;172;795;798;3;28;0.83
7;173;798;800;2;28;0.83
7;174;800;801;1;28;0.83
7;175;801;804;3;28;0.83
7;176;804;805;1;28;0.83
7;177;805;806;1;28;0.83
7;178;806;812;6;28;0.83
7;179;812;814;2;28;0.83
7;180;814;818;4;28;0.83
7;181;818;820;2;28;0.83
7;182;820;821;1;28;0.83
7;183;821;830;9;28;0.83
7;184;830;832;2;28;0.83
7;185;832;833;1;28;0.83
7;186;833;834;1;28;0.83
7;187;834;836;2;28;0.83
7;188;836;837;1;28;0.83
7;189;837;838;1;28;0.83
7;190;838;841;3;28;0.83
7;191;841;843;2;28;0.83
7;192;843;848;5;28;0.83
7;193;848;850;2;28;0.83
7;194;850;852;2;28;0.83
7;195;852;854;2;28;0.83
7;196;854;855;1;28;0.83
7;197;855;858;3;28;0.83
7;198;858;861;3;28;0.83
7;199;861;862;1;28;0.83
7;200;862;863;1;28;0.83
7;201;863;865;2;28;0.83
7;202;865;866;1;28;0.83
7;203;866;868;2;28;0.83
7;204;868;870;2;28;0.83
7;205;870;871;1;28;0.83
7;206;871;872;1;28;0.83
7;207;872;876;4;28;0.83
7;208;876;877;1;28;0.83
7;209;877;878;1;28;0.83
7;210;878;880;2;28;0.83
7;211;880;883;3;28;0.83
7;212;883;885;2;28;0.83
7;213;885;887;2;28;0.83
7;214;887;888;1;28;0.83
7;215;888;892;4;28;0.83
7;216;892;893;1;28;0.83
7;217;893;895;2;28;0.83
7;218;895;898;3;28;0.83
7;219;898;899;1;28;0.83
7;220;899;901;2;28;0.83
7;221;901;902;1;28;0.83
7;222;902;903;1;28;0.83
7;223;903;907;4;28;0.83
7;224;907;909;2;28;0.83
7;225;909;910;1;28;0.83
7;226;910;911;1;28;0.83
7;227;911;912;1;28;0.83
7;228;912;913;1;28;0.83
7;229;913;915;2;28;0.83
7;230;915;918;3;28;0.83
7;231;918;920;2;28;0.83
7;232;920;922;2;28;0.83
7;233;922;925;3;28;0.83
7;234;925;926;1;28;0.83
7;235;926;928;2;28;0.83
7;236;928;929;1;28;0.83
7;237;929;931;2;28;0.83
7;238;931;932;1;28;0.83
7;239;932;938;6;28;0.83
7;240;938;940;2;28;0.83
7;241;940;942;2;28;0.83
7;242;942;943;1;28;0.83
7;243;943;945;2;28;0.83
7;244;945;947;2;28;0.83
7;245;947;953;6;28;0.83
7;246;953;955;2;28;0.83
7;247;955;956;1;28;0.83
7;248;956;958;2;28;0.83
7;249;958;959;1;28;0.83
7;250;959;962;3;28;0.83
7;251;962;966;4;28;0.83
7;252;966;967;1;28;0.83
7;253;967;968;1;28;0.83
7;254;968;969;1;28;0.83
7;255;969;970;1;28;0.83
7;256;970;972;2;28;0.83
7;257;972;973;1;28;0.83
7;258;973;975;2;28;0.83
7;259;975;978;3;28;0.83
7;260;978;980;2;28;0.83
7;261;980;981;1;28;0.83
7;262;981;988;7;28;0.83
7;263;988;992;4;28;0.83
7;264;992;993;1;28;0.83
7;265;993;998;5;28;0.83
7;266;998;1000;2;28;0.83
7;267;1000;1002;2;28;0.83
7;268;1002;1003;1;28;0.83
7;269;1003;1011;8;28;0.83
7;270;1011;1012;1;28;0.83
7;271;1012;1014;2;28;0.83
7;272;1014;1015;1;28;0.83
7;273;1015;1018;3;28;0.83
7;274;1018;1019;1;28;0.83
7;275;1019;1020;1;28;0.83
7;276;1020;1021;1;28;0.83
7;277;1021;1023;2;28;0.83
7;278;1023;1026;3;28;0.83
7;279;1026;1030;4;28;0.83
7;280;1030;1032;2;28;0.83
7;281;1032;1033;1;28;0.83
7;282;1033;1041;8;28;0.83
7;283;1041;1043;2;28;0.83
7;284;1043;1044;1;28;0.83
7;285;1044;1045;1;28;0.83
7;286;1045;1048;3;28;0.83
7;287;1048;1055;7;28;0.83
7;288;1055;1058;3;28;0.83
7;289;1058;1060;2;28;0.83
7;290;1060;1062;2;28;0.83
7;291;1062;1063;1;28;0.83
7;292;1063;1065;2;28;0.83
7;293;1065;1071;6;28;0.83
7;294;1071;1076;5;28;0.83
7;295;1076;1078;2;28;0.83
7;296;1078;1083;5;28;0.83
7;297;1083;1084;1;28;0.83
7;298;1084;1085;1;28;0.83
7;299;1085;1087;2;28;0.83
7;300;1087;1093;6;28;0.83
7;301;1093;1094;1;28;0.83
7;302;1094;1095;1;28;0.83
7;303;1095;1097;2;28;0.83
7;304;1097;1098;1;28;0.83
7;305;1098;1100;2;28;0.83
7;306;1100;1101;1;28;0.83
7;307;1101;1103;2;28;0.83
7;308;1103;1109;6;28;0.83
7;309;1109;1110;1;28;0.83
7;310;1110;1111;1;28;0.83
7;311;1111;1120;9;28;0.83
7;312;1120;1121;1;28;0.83
7;313;1121;1134;13;28;0.83
7;314;1134;1137;3;28;0.83
7;315;1137;1141;4;28;0.83
7;316;1141;1142;1;28;0.83
7;317;1142;1147;5;28;0.83
7;318;1147;1150;3;28;0.83
7;319;1150;1152;2;28;0.83
7;320;1152;1155;3;28;0.83
7;321;1155;1160;5;28;0.83
7;322;1160;1171;11;28;0.83
7;323;1171;1174;3;28;0.83
7;324;1174;1176;2;28;0.83
7;325;1176;1181;5;28;0.83
7;326;1181;1186;5;28;0.83
7;327;1186;1189;3;28;0.83
7;328;1189;1199;10;28;0.83
7;329;1199;1202;3;28;0.83
7;330;1202;1205;3;28;0.83
7;331;1205;1209;4;28;0.83
7;332;1209;1210;1;28;0.83
7;333;1210;1217;7;28;0.83
7;334;1217;1221;4;28;0.83
7;335;1221;1223;2;28;0.83
7;336;1223;1226;3;28;0.83
7;337;1226;1231;5;28;0.83
7;338;1231;1252;21;28;0.83
7;339;1252;1256;4;28;0.83
7;340;1256;1258;2;28;0.83
7;341;1258;1262;4;28;0.83
7;342;1262;1263;1;28;0.83
7;343;1263;1266;3;28;0.83
7;344;1266;1267;1;28;0.83
7;345;1267;1269;2;28;0.83
7;346;1269;1271;2;28;0.83
7;347;1271;1280;9;28;0.83
7;348;1280;1281;1;28;0.83
7;349;1281;1282;1;28;0.83
7;350;1282;1291;9;28;0.83
7;351;1291;1296;5;28;0.83
7;352;1296;1305;9;28;0.83
7;353;1305;1310;5;28;0.83
7;354;1310;1312;2;28;0.83
7;355;1312;1316;4;28;0.83
7;356;1316;1321;5;28;0.83
7;357;1321;1322;1;28;0.83
7;358;1322;1323;1;28;0.83
7;359;1323;1326;3;28;0.83
7;360;1326;1332;6;28;0.83
7;361;1332;1337;5;28;0.83
7;362;1337;1338;1;28;0.83
7;363;1338;1341;3;28;0.83
7;364;1341;1344;3;28;0.83
7;365;1344;1345;1;28;0.83
7;366;1345;1357;12;28;0.83
7;367;1357;1360;3;28;0.83
7;368;1360;1362;2;28;0.83
7;369;1362;1363;1;28;0.83
7;370;1363;1364;1;28;0.83
7;371;1364;1365;1;28;0.83
7;372;1365;1366;1;28;0.83
7;373;1366;1371;5;28;0.83
7;374;1371;1374;3;28;0.83
7;375;1374;1376;2;28;0.83
7;376;1376;1378;2;28;0.83
7;377;1378;1379;1;28;0.83
7;378;1379;1385;6;28;0.83
7;379;1385;1386;1;28;0.83
7;380;1386;1387;1;28;0.83
7;381;1387;1394;7;28;0.83
7;382;1394;1409;15;28;0.83
7;383;1409;1424;15;28;0.83
7;384;1424;1439;15;28;0.83
7;385;1439;1454;15;28;0.83
7;386;1454;1469;15;28;0.83
7;387;1469;1484;15;28;0.83
7;388;1484;1499;15;28;0.83
7;389;1499;1514;15;28;0.83
7;390;1514;1529;15;28;0.83
7;391;1529;1544;15;28;0.83
7;392;1544;1559;15;28;0.83
7;393;1559;1574;15;28;0.83
7;394;1574;1589;15;28;0.83
7;395;1589;1604;15;28;0.83
7;396;1604;1619;15;28;0.83
7;397;1619;1634;15;28;0.83
7;398;1634;1649;15;28;0.83
7;399;1649;1664;15;28;0.83
7;400;1664;1679;15;28;0.83
7;401;1679;1680;1;28;0.83
8;0;240;282;42;28;0.83
8;1;282;326;44;28;0.83
8;2;326;329;3;28;0.83
8;3;329;330;1;28;0.83
8;4;330;331;1;28;0.83
8;5;331;333;2;28;0.83
8;6;333;334;1;28;0.83
8;7;334;336;2;28;0.83
8;8;336;337;1;28;0.83
8;9;337;345;8;28;0.83
8;10;345;346;1;28;0.83
8;11;346;348;2;28;0.83
8;12;348;351;3;28;0.83
8;13;351;353;2;28;0.83
8;14;353;356;3;28;0.83
8;15;356;357;1;28;0.83
8;16;357;358;1;28;0.83
8;17;358;360;2;28;0.83
8;18;360;361;1;28;0.83
8;19;361;362;1;28;0.83
8;20;362;365;3;28;0.83
8;21;365;367;2;28;0.83
8;22;367;368;1;28;0.83
8;23;368;369;1;28;0.83
8;24;369;371;2;28;0.83
8;25;371;380;9;28;0.83
8;26;380;381;1;28;0.83
8;27;381;384;3;28;0.83
8;28;384;385;1;28;0.83
8;29;385;387;2;28;0.83
8;30;387;388;1;28;0.83
8;31;388;391;3;28;0.83
8;32;391;396;5;28;0.83
8;33;396;397;1;28;0.83
8;34;397;401;4;28;0.83
8;35;401;403;2;28;0.83
8;36;403;404;1;28;0.83
8;37;404;406;2;28;0.83
8;38;406;408;2;28;0.83
8;39;408;413;5;28;0.83
8;40;413;416;3;28;0.83
8;41;416;417;1;28;0.83
8;42;417;418;1;28;0.83
8;43;418;420;2;28;0.83
8;44;420;421;1;28;0.83
8;45;421;423;2;28;0.83
8;46;423;425;2;28;0.83
8;47;425;427;2;28;0.83
8;48;427;428;1;28;0.83
8;49;428;429;1;28;0.83
8;50;429;431;2;28;0.83
8;51;431;432;1;28;0.83
8;52;432;435;3;28;0.83
8;53;435;436;1;28;0.83
8;54;436;438;2;28;0.83
8;55;438;444;6;28;0.83
8;56;444;446;2;28;0.83
8;57;446;447;1;28;0.83
8;58;447;448;1;28;0.83
8;59;448;450;2;28;0.83
8;60;450;451;1;28;0.83
8;61;451;452;1;28;0.83
8;62;452;453;1;28;0.83
8;63;453;455;2;28;0.83
8;64;455;458;3;28;0.83
8;65;458;459;1;28;0.83
8;66;459;462;3;28;0.83
8;67;462;463;1;28;0.83
8;68;463;465;2;28;0.83
8;69;465;466;1;28;0.83
8;70;466;467;1;28;0.83
8;71;467;468;1;28;0.83
8;72;468;471;3;28;0.83
8;73;471;472;1;28;0.83
8;74;472;473;1;28;0.83
8;75;473;475;2;28;0.83
8;76;475;476;1;28;0.83
8;77;476;478;2;28;0.83
8;78;478;480;2;28;0.83
8;79;480;481;1;28;0.83
8;80;481;482;1;28;0.83
8;81;482;483;1;28;0.83
8;82;483;484;1;28;0.83
8;83;484;493;9;28;0.83
8;84;493;494;1;28;0.83
8;85;494;496;2;28;0.83
8;86;496;498;2;28;0.83
8;87;498;501;3;28;0.83
8;88;501;504;3;28;0.83
8;89;504;505;1;28;0.83
8;90;505;513;8;28;0.83
8;91;513;514;1;28;0.83
8;92;514;518;4;28;0.83
8;93;518;521;3;28;0.83
8;94;521;522;1;28;0.83
8;95;522;523;1;28;0.83
8;96;523;525;2;28;0.83
8;97;525;531;6;28;0.83
8;98;531;532;1;28;0.83
8;99;532;533;1;28;0.83
8;100;533;537;4;28;0.83
8;101;537;540;3;28;0.83
8;102;540;543;3;28;0.83
8;103;543;544;1;28;0.83
8;104;544;547;3;28;0.83
8;105;547;548;1;28;0.83
8;106;548;549;1;28;0.83
8;107;549;550;1;28;0.83
8;108;550;553;3;28;0.83
8;109;553;556;3;28;0.83
8;110;556;557;1;28;0.83
8;111;557;572;15;28;0.83
8;112;572;574;2;28;0.83
8;113;574;576;2;28;0.83
8;114;576;578;2;28;0.83
8;115;578;585;7;28;0.83
8;116;585;588;3;28;0.83
8;117;588;590;2;28;0.83
8;118;590;591;1;28;0.83
8;119;591;593;2;28;0.83
8;120;593;607;14;28;0.83
8;121;607;615;8;28;0.83
8;122;615;617;2;28;0.83
8;123;617;623;6;28;0.83
8;124;623;625;2;28;0.83
8;125;625;627;2;28;0.83
8;126;627;628;1;28;0.83
8;127;628;629;1;28;0.83
8;128;629;633;4;28;0.83
8;129;633;651;18;28;0.83
8;130;651;653;2;28;0.83
8;131;653;655;2;28;0.83
8;132;655;656;1;28;0.83
8;133;656;658;2;28;0.83
8;134;658;660;2;28;0.83
8;135;660;666;6;28;0.83
8;136;666;671;5;28;0.83
8;137;671;673;2;28;0.83
8;138;673;681;8;28;0.83
8;139;681;692;11;28;0.83
8;140;692;693;1;28;0.83
8;141;693;695;2;28;0.83
8;142;695;698;3;28;0.83
8;143;698;700;2;28;0.83
8;144;700;704;4;28;0.83
8;145;704;707;3;28;0.83
8;146;707;713;6;28;0.83
8;147;713;718;5;28;0.83
8;148;718;721;3;28;0.83
8;149;721;725;4;28;0.83
8;150;725;728;3;28;0.83
8;151;728;735;7;28;0.83
8;152;735;736;1;28;0.83
8;153;736;737;1;28;0.83
8;154;737;746;9;28;0.83
8;155;746;748;2;28;0.83
8;156;748;749;1;28;0.83
8;157;749;758;9;28;0.83
8;158;758;760;2;28;0.83
8;159;760;763;3;28;0.83
8;160;763;766;3;28;0.83
8;161;766;768;2;28;0.83
8;162;768;772;4;28;0.83
8;163;772;773;1;28;0.83
8;164;773;774;1;28;0.83
8;165;774;775;1;28;0.83
8;166;775;778;3;28;0.83
8;167;778;784;6;28;0.83
8;168;784;788;4;28;0.83
8;169;788;792;4;28;0.83
8;170;792;793;1;28;0.83
8;171;793;795;2;28;0.83
8;172;795;798;3;28;0.83
8;173;798;800;2;28;0.83
8;174;800;801;1;28;0.83
8;175;801;804;3;28;0.83
8;176;804;805;1;28;0.83
8;177;805;806;1;28;0.83
8;178;806;812;6;28;0.83
8;179;812;814;2;28;0.83
8;180;814;818;4;28;0.83
8;181;818;820;2;28;0.83
8;182;820;821;1;28;0.83
8;183;821;830;9;28;0.83
8;184;830;832;2;28;0.83
8;185;832;833;1;28;0.83
8;186;833;834;1;28;0.83
8;187;834;836;2;28;0.83
8;188;836;837;1;28;0.83
8;189;837;838;1;28;0.83
8;190;838;841;3;28;0.83
8;191;841;843;2;28;0.83
8;192;843;848;5;28;0.83
8;193;848;850;2;28;0.83
8;194;850;852;2;28;0.83
8;195;852;854;2;28;0.83
8;196;854;855;1;28;0.83
8;197;855;858;3;28;0.83
8;198;858;861;3;28;0.83
8;199;861;862;1;28;0.83
8;200;862;863;1;28;0.83
8;201;863;865;2;28;0.83
8;202;865;866;1;28;0.83
8;203;866;868;2;28;0.83
8;204;868;870;2;28;0.83
8;205;870;871;1;28;0.83
8;206;871;872;1;28;0.83
8;207;872;876;4;28;0.83
8;208;876;877;1;28;0.83
8;209;877;878;1;28;0.83
8;210;878;880;2;28;0.83
8;211;880;883;3;28;0.83
8;212;883;885;2;28;0.83
8;213;885;887;2;28;0.83
8;214;887;888;1;28;0.83
8;215;888;892;4;28;0.83
8;216;892;893;1;28;0.83
8;217;893;895;2;28;0.83
8;218;895;898;3;28;0.83
8;219;898;899;1;28;0.83
8;220;899;901;2;28;0.83
8;221;901;902;1;28;0.83
8;222;902;903;1;28;0.83
8;223;903;907;4;28;0.83
8;224;907;909;2;28;0.83
8;225;909;910;1;28;0.83
8;226;910;911;1;28;0.83
8;227;911;912;1;28;0.83
8;228;912;913;1;28;0.83
8;229;913;915;2;28;0.83
8;230;915;918;3;28;0.83
8;231;918;920;2;28;0.83
8;232;920;922;2;28;0.83
8;233;922;925;3;28;0.83
8;234;925;926;1;28;0.83
8;235;926;928;2;28;0.83
8;236;928;929;1;28;0.83
8;237;929;931;2;28;0.83
8;238;931;932;1;28;0.83
8;239;932;938;6;28;0.83
8;240;938;940;2;28;0.83
8;241;940;942;2;28;0.83
8;242;942;943;1;28;0.83
8;243;943;945;2;28;0.83
8;244;945;947;2;28;0.83
8;245;947;953;6;28;0.83
8;246;953;955;2;28;0.83
8;247;955;956;1;28;0.83
8;248;956;958;2;28;0.83
8;249;958;959;1;28;0.83
8;250;959;962;3;28;0.83
8;251;962;966;4;28;0.83
8;252;966;967;1;28;0.83
8;253;967;968;1;28;0.83
8;254;968;969;1;28;0.83
8;255;969;970;1;28;0.83
8;256;970;972;2;28;0.83
8;257;972;973;1;28;0.83
8;258;973;975;2;28;0.83
8;259;975;978;3;28;0.83
8;260;978;980;2;28;0.83
8;261;980;981;1;28;0.83
8;262;981;988;7;28;0.83
8;263;988;992;4;28;0.83
8;264;992;993;1;28;0.83
8;265;993;998;5;28;0.83
8;266;998;1000;2;28;0.83
8;267;1000;1002;2;28;0.83
8;268;1002;1003;1;28;0.83
8;269;1003;1011;8;28;0.83
8;270;1011;1012;1;28;0.83
8;271;1012;1014;2;28;0.83
8;272;1014;1015;1;28;0.83
8;273;1015;1018;3;28;0.83
8;274;1018;1019;1;28;0.83
8;275;1019;1020;1;28;0.83
8;276;1020;1021;1;28;0.83
8;277;1021;1023;2;28;0.83
8;278;1023;1026;3;28;0.83
8;279;1026;1030;4;28;0.83
8;280;1030;1032;2;28;0.83
8;281;1032;1033;1;28;0.83
8;282;1033;1041;8;28;0.83
8;283;1041;1043;2;28;0.83
8;284;1043;1044;1;28;0.83
8;285;1044;1045;1;28;0.83
8;286;1045;1048;3;28;0.83
8;287;1048;1055;7;28;0.83
8;288;1055;1058;3;28;0.83
8;289;1058;1060;2;28;0.83
8;290;1060;1062;2;28;0.83
8;291;1062;1063;1;28;0.83
8;292;1063;1065;2;28;0.83
8;293;1065;1071;6;28;0.83
8;294;1071;1076;5;28;0.83
8;295;1076;1078;2;28;0.83
8;296;1078;1083;5;28;0.83
8;297;1083;1084;1;28;0.83
8;298;1084;1085;1;28;0.83
8;299;1085;1087;2;28;0.83
8;300;1087;1093;6;28;0.83
8;301;1093;1094;1;28;0.83
8;302;1094;1095;1;28;0.83
8;303;1095;1097;2;28;0.83
8;304;1097;1098;1;28;0.83
8;305;1098;1100;2;28;0.83
8;306;1100;1101;1;28;0.83
8;307;1101;1103;2;28;0.83
8;308;1103;1109;6;28;0.83
8;309;1109;1110;1;28;0.83
8;310;1110;1111;1;28;0.83
8;311;1111;1120;9;28;0.83
8;312;1120;1121;1;28;0.83
8;313;1121;1134;13;28;0.83
8;314;1134;1137;3;28;0.83
8;315;1137;1141;4;28;0.83
8;316;1141;1142;1;28;0.83
8;317;1142;1147;5;28;0.83
8;318;1147;1150;3;28;0.83
8;319;1150;1152;2;28;0.83
8;320;1152;1155;3;28;0.83
8;321;1155;1160;5;28;0.83
8;322;1160;1171;11;28;0.83
8;323;1171;1174;3;28;0.83
8;324;1174;1176;2;28;0.83
8;325;1176;1181;5;28;0.83
8;326;1181;1186;5;28;0.83
8;327;1186;1189;3;28;0.83
8;328;1189;1199;10;28;0.83
8;329;1199;1202;3;28;0.83
8;330;1202;1205;3;28;0.83
8;331;1205;1209;4;28;0.83
8;332;1209;1210;1;28;0.83
8;333;1210;1217;7;28;0.83
8;334;1217;1221;4;28;0.83
8;335;1221;1223;2;28;0.83
8;336;1223;1226;3;28;0.83
8;337;1226;1231;5;28;0.83
8;338;1231;1252;21;28;0.83
8;339;1252;1256;4;28;0.83
8;340;1256;1258;2;28;0.83
8;341;1258;1262;4;28;0.83
8;342;1262;1263;1;28;0.83
8;343;1263;1266;3;28;0.83
8;344;1266;1267;1;28;0.83
8;345;1267;1269;2;28;0.83
8;346;1269;1271;2;28;0.83
8;347;1271;1280;9;28;0.83
8;348;1280;1281;1;28;0.83
8;349;1281;1282;1;28;0.83
8;350;1282;1291;9;28;0.83
8;351;1291;1296;5;28;0.83
8;352;1296;1305;9;28;0.83
8;353;1305;1310;5;28;0.83
8;354;1310;1312;2;28;0.83
8;355;1312;1316;4;28;0.83
8;356;1316;1321;5;28;0.83
8;357;1321;1322;1;28;0.83
8;358;1322;1323;1;28;0.83
8;359;1323;1326;3;28;0.83
8;360;1326;1332;6;28;0.83
8;361;1332;1337;5;28;0.83
8;362;1337;1338;1;28;0.83
8;363;1338;1341;3;28;0.83
8;364;1341;1344;3;28;0.83
8;365;1344;1345;1;28;0.83
8;366;1345;1357;12;28;0.83
8;367;1357;1360;3;28;0.83
8;368;1360;1362;2;28;0.83
8;369;1362;1363;1;28;0.83
8;370;1363;1364;1;28;0.83
8;371;1364;1365;1;28;0.83
8;372;1365;1366;1;28;0.83
8;373;1366;1371;5;28;0.83
8;374;1371;1374;3;28;0.83
8;375;1374;1376;2;28;0.83
8;376;1376;1378;2;28;0.83
8;377;1378;1379;1;28;0.83
8;378;1379;1385;6;28;0.83
8;379;1385;1386;1;28;0.83
8;380;1386;1387;1;28;0.83
8;381;1387;1394;7;28;0.83
8;382;1394;1409;15;28;0.83
8;383;1409;1424;15;28;0.83
8;384;1424;1439;15;28;0.83
8;385;1439;1454;15;28;0.83
8;386;1454;1469;15;28;0.83
8;387;1469;1484;15;28;0.83
8;388;1484;1499;15;28;0.83
8;389;1499;1514;15;28;0.83
8;390;1514;1529;15;28;0.83
8;391;1529;1544;15;28;0.83
8;392;1544;1559;15;28;0.83
8;393;1559;1574;15;28;0.83
8;394;1574;1589;15;28;0.83
8;395;1589;1604;15;28;0.83
8;396;1604;1619;15;28;0.83
8;397;1619;1634;15;28;0.83
8;398;1634;1649;15;28;0.83
8;399;1649;1664;15;28;0.83
8;400;1664;1679;15;28;0.83
8;401;1679;1680;1;28;0.83
9;0;240;282;42;28;0.83
9;1;282;326;44;28;0.83
9;2;326;329;3;28;0.83
9;3;329;330;1;28;0.83
9;4;330;331;1;28;0.83
9;5;331;333;2;28;0.83
9;6;333;334;1;28;0.83
9;7;334;336;2;28;0.83
9;8;336;337;1;28;0.83
9;9;337;345;8;28;0.83
9;10;345;346;1;28;0.83
9;11;346;348;2;28;0.83
9;12;348;351;3;28;0.83
9;13;351;353;2;28;0.83
9;14;353;356;3;28;0.83
9;15;356;357;1;28;0.83
9;16;357;358;1;28;0.83
9;17;358;360;2;28;0.83
9;18;360;361;1;28;0.83
9;19;361;362;1;28;0.83
9;20;362;365;3;28;0.83
9;21;365;367;2;28;0.83
9;22;367;368;1;28;0.83
9;23;368;369;1;28;0.83
9;24;369;371;2;28;0.83
9;25;371;380;9;28;0.83
9;26;380;381;1;28;0.83
9;27;381;384;3;28;0.83
9;28;384;385;1;28;0.83
9;29;385;387;2;28;0.83
9;30;387;388;1;28;0.83
9;31;388;391;3;28;0.83
9;32;391;396;5;28;0.83
9;33;396;397;1;28;0.83
9;34;397;401;4;28;0.83
9;35;401;403;2;28;0.83
9;36;403;404;1;28;0.83
9;37;404;406;2;28;0.83
9;38;406;408;2;28;0.83
9;39;408;413;5;28;0.83
9;40;413;416;3;28;0.83
9;41;416;417;1;28;0.83
9;42;417;418;1;28;0.83
9;43;418;420;2;28;0.83
9;44;420;421;1;28;0.83
9;45;421;423;2;28;0.83
9;46;423;425;2;28;0.83
9;47;425;427;2;28;0.83
9;48;427;428;1;28;0.83
9;49;428;429;1;28;0.83
9;50;429;431;2;28;0.83
9;51;431;432;1;28;0.83
9;52;432;435;3;28;0.83
9;53;435;436;1;28;0.83
9;54;436;438;2;28;0.83
9;55;438;444;6;28;0.83
9;56;444;446;2;28;0.83
9;57;446;447;1;28;0.83
9;58;447;448;1;28;0.83
9;59;448;450;2;28;0.83
9;60;450;451;1;28;0.83
9;61;451;452;1;28;0.83
9;62;452;453;1;28;0.83
9;63;453;455;2;28;0.83
9;64;455;458;3;28;0.83
9;65;458;459;1;28;0.83
9;66;459;462;3;28;0.83
9;67;462;463;1;28;0.83
9;68;463;465;2;28;0.83
9;69;465;466;1;28;0.83
9;70;466;467;1;28;0.83
9;71;467;468;1;28;0.83
9;72;468;471;3;28;0.83
9;73;471;472;1;28;0.83
9;74;472;473;1;28;0.83
9;75;473;475;2;28;0.83
9;76;475;476;1;28;0.83
9;77;476;478;2;28;0.83
9;78;478;480;2;28;0.83
9;79;480;481;1;28;0.83
9;80;481;482;1;28;0.83
9;81;482;483;1;28;0.83
9;82;483;484;1;28;0.83
9;83;484;493;9;28;0.83
9;84;493;494;1;28;0.83
9;85;494;496;2;28;0.83
9;86;496;498;2;28;0.83
9;87;498;501;3;28;0.83
9;88;501;504;3;28;0.83
9;89;504;505;1;28;0.83
9;90;505;513;8;28;0.83
9;91;513;514;1;28;0.83
9;92;514;518;4;28;0.83
9;93;518;521;3;28;0.83
9;94;521;522;1;28;0.83
9;95;522;523;1;28;0.83
9;96;523;525;2;28;0.83
9;97;525;531;6;28;0.83
9;98;531;532;1;28;0.83
9;99;532;533;1;28;0.83
9;100;533;537;4;28;0.83
9;101;537;540;3;28;0.83
9;102;540;543;3;28;0.83
9;103;543;544;1;28;0.83
9;104;544;547;3;28;0.83
9;105;547;548;1;28;0.83
9;106;548;549;1;28;0.83
9;107;549;550;1;28;0.83
9;108;550;553;3;28;0.83
9;109;553;556;3;28;0.83
9;110;556;557;1;28;0.83
9;111;557;572;15;28;0.83
9;112;572;574;2;28;0.83
9;113;574;576;2;28;0.83
9;114;576;578;2;28;0.83
9;115;578;585;7;28;0.83
9;116;585;588;3;28;0.83
9;117;588;590;2;28;0.83
9;118;590;591;1;28;0.83
9;119;591;593;2;28;0.83
9;120;593;607;14;28;0.83
9;121;607;615;8;28;0.83
9;122;615;617;2;28;0.83
9;123;617;623;6;28;0.83
9;124;623;625;2;28;0.83
9;125;625;627;2;28;0.83
9;126;627;628;1;28;0.83
9;127;628;629;1;28;0.83
9;128;629;633;4;28;0.83
9;129;633;651;18;28;0.83
9;130;651;653;2;28;0.83
9;131;653;655;2;28;0.83
9;132;655;656;1;28;0.83
9;133;656;658;2;28;0.83
9;134;658;660;2;28;0.83
9;135;660;666;6;28;0.83
9;136;666;671;5;28;0.83
9;137;671;673;2;28;0.83
9;138;673;681;8;28;0.83
9;139;681;692;11;28;0.83
9;140;692;693;1;28;0.83
9;141;693;695;2;28;0.83
9;142;695;698;3;28;0.83
9;143;698;700;2;28;0.83
9;144;700;704;4;28;0.83
9;145;704;707;3;28;0.83
9;146;707;713;6;28;0.83
9;147;713;718;5;28;0.83
9;148;718;721;3;28;0.83
9;149;721;725;4;28;0.83
9;150;725;728;3;28;0.83
9;151;728;735;7;28;0.83
9;152;735;736;1;28;0.83
9;153;736;737;1;28;0.83
9;154;737;746;9;28;0.83
9;155;746;748;2;28;0.83
9;156;748;749;1;28;0.83
9;157;749;758;9;28;0.83
9;158;758;760;2;28;0.83
9;159;760;763;3;28;0.83
9;160;763;766;3;28;0.83
9;161;766;768;2;28;0.83
9;162;768;772;4;28;0.83
9;163;772;773;1;28;0.83
9;164;773;774;1;28;0.83
9;165;774;775;1;28;0.83
9;166;775;778;3;28;0.83
9;167;778;784;6;28;0.83
9;168;784;788;4;28;0.83
9;169;788;792;4;28;0.83
9;170;792;793;1;28;0.83
9;171;793;795;2;28;0.83
9;172;795;798;3;28;0.83
9;173;798;800;2;28;0.83
9;174;800;801;1;28;0.83
9;175;801;804;3;28;0.83
9;176;804;805;1;28;0.83
9;177;805;806;1;28;0.83
9;178;806;812;6;28;0.83
9;179;812;814;2;28;0.83
9;180;814;818;4;28;0.83
9;181;818;820;2;28;0.83
9;182;820;821;1;28;0.83
9;183;821;830;9;28;0.83
9;184;830;832;2;28;0.83
9;185;832;833;1;28;0.83
9;186;833;834;1;28;0.83
9;187;834;836;2;28;0.83
9;188;836;837;1;28;0.83
9;189;837;838;1;28;0.83
9;190;838;841;3;28;0.83
9;191;841;843;2;28;0.83
9;192;843;848;5;28;0.83
9;193;848;850;2;28;0.83
9;194;850;852;2;28;0.83
9;195;852;854;2;28;0.83
9;196;854;855;1;28;0.83
9;197;855;858;3;28;0.83
9;198;858;861;3;28;0.83
9;199;861;862;1;28;0.83
9;200;862;863;1;28;0.83
9;201;863;865;2;28;0.83
9;202;865;866;1;28;0.83
9;203;866;868;2;28;0.83
9;204;868;870;2;28;0.83
9;205;870;871;1;28;0.83
9;206;871;872;1;28;0.83
9;207;872;876;4;28;0.83
9;208;876;877;1;28;0.83
9;209;877;878;1;28;0.83
9;210;878;880;2;28;0.83
9;211;880;883;3;28;0.83
9;212;883;885;2;28;0.83
9;213;885;887;2;28;0.83
9;214;887;888;1;28;0.83
9;215;888;892;4;28;0.83
9;216;892;893;1;28;0.83
9;217;893;895;2;28;0.83
9;218;895;898;3;28;0.83
9;219;898;899;1;28;0.83
9;220;899;901;2;28;0.83
9;221;901;902;1;28;0.83
9;222;902;903;1;28;0.83
9;223;903;907;4;28;0.83
9;224;907;909;2;28;0.83
9;225;909;910;1;28;0.83
9;226;910;911;1;28;0.83
9;227;911;912;1;28;0.83
9;228;912;913;1;28;0.83
9;229;913;915;2;28;0.83
9;230;915;918;3;28;0.83
9;231;918;920;2;28;0.83
9;232;920;922;2;28;0.83
9;233;922;925;3;28;0.83
9;234;925;926;1;28;0.83
9;235;926;928;2;28;0.83
9;236;928;929;1;28;0.83
9;237;929;931;2;28;0.83
9;238;931;932;1;28;0.83
9;239;932;938;6;28;0.83
9;240;938;940;2;28;0.83
9;241;940;942;2;28;0.83
9;242;942;943;1;28;0.83
9;243;943;945;2;28;0.83
9;244;945;947;2;28;0.83
9;245;947;953;6;28;0.83
9;246;953;955;2;28;0.83
9;247;955;956;1;28;0.83
9;248;956;958;2;28;0.83
9;249;958;959;1;28;0.83
9;250;959;962;3;28;0.83
9;251;962;966;4;28;0.83
9;252;966;967;1;28;0.83
9;253;967;968;1;28;0.83
9;254;968;969;1;28;0.83
9;255;969;970;1;28;0.83
9;256;970;972;2;28;0.83
9;257;972;973;1;28;0.83
9;258;973;975;2;28;0.83
9;259;975;978;3;28;0.83
9;260;978;980;2;28;0.83
9;261;980;981;1;28;0.83
9;262;981;988;7;28;0.83
9;263;988;992;4;28;0.83
9;264;992;993;1;28;0.83
9;265;993;998;5;28;0.83
9;266;998;1000;2;28;0.83
9;267;1000;1002;2;28;0.83
9;268;1002;1003;1;28;0.83
9;269;1003;1011;8;28;0.83
9;270;1011;1012;1;28;0.83
9;271;1012;1014;2;28;0.83
9;272;1014;1015;1;28;0.83
9;273;1015;1018;3;28;0.83
9;274;1018;1019;1;28;0.83
9;275;1019;1020;1;28;0.83
9;276;1020;1021;1;28;0.83
9;277;1021;1023;2;28;0.83
9;278;1023;1026;3;28;0.83
9;279;1026;1030;4;28;0.83
9;280;1030;1032;2;28;0.83
9;281;1032;1033;1;28;0.83
9;282;1033;1041;8;28;0.83
9;283;1041;1043;2;28;0.83
9;284;1043;1044;1;28;0.83
9;285;1044;1045;1;28;0.83
9;286;1045;1048;3;28;0.83
9;287;1048;1055;7;28;0.83
9;288;1055;1058;3;28;0.83
9;289;1058;1060;2;28;0.83
9;290;1060;1062;2;28;0.83
9;291;1062;1063;1;28;0.83
9;292;1063;1065;2;28;0.83
9;293;1065;1071;6;28;0.83
9;294;1071;1076;5;28;0.83
9;295;1076;1078;2;28;0.83
9;296;1078;1083;5;28;0.83
9;297;1083;1084;1;28;0.83
9;298;1084;1085;1;28;0.83
9;299;1085;1087;2;28;0.83
9;300;1087;1093;6;28;0.83
9;301;1093;1094;1;28;0.83
9;302;1094;1095;1;28;0.83
9;303;1095;1097;2;28;0.83
9;304;1097;1098;1;28;0.83
9;305;1098;1100;2;28;0.83
9;306;1100;1101;1;28;0.83
9;307;1101;1103;2;28;0.83
9;308;1103;1109;6;28;0.83
9;309;1109;1110;1;28;0.83
9;310;1110;1111;1;28;0.83
9;311;1111;1120;9;28;0.83
9;312;1120;1121;1;28;0.83
9;313;1121;1134;13;28;0.83
9;314;1134;1137;3;28;0.83
9;315;1137;1141;4;28;0.83
9;316;1141;1142;1;28;0.83
9;317;1142;1147;5;28;0.83
9;318;1147;1150;3;28;0.83
9;319;1150;1152;2;28;0.83
9;320;1152;1155;3;28;0.83
9;321;1155;1160;5;28;0.83
9;322;1160;1171;11;28;0.83
9;323;1171;1174;3;28;0.83
9;324;1174;1176;2;28;0.83
9;325;1176;1181;5;28;0.83
9;326;1181;1186;5;28;0.83
9;327;1186;1189;3;28;0.83
9;328;1189;1199;10;28;0.83
9;329;1199;1202;3;28;0.83
9;330;1202;1205;3;28;0.83
9;331;1205;1209;4;28;0.83
9;332;1209;1210;1;28;0.83
9;333;1210;1217;7;28;0.83
9;334;1217;1221;4;28;0.83
9;335;1221;1223;2;28;0.83
9;336;1223;1226;3;28;0.83
9;337;1226;1231;5;28;0.83
9;338;1231;1252;21;28;0.83
9;339;1252;1256;4;28;0.83
9;340;1256;1258;2;28;0.83
9;341;1258;1262;4;28;0.83
9;342;1262;1263;1;28;0.83
9;343;1263;1266;3;28;0.83
9;344;1266;1267;1;28;0.83
9;345;1267;1269;2;28;0.83
9;346;1269;1271;2;28;0.83
9;347;1271;1280;9;28;0.83
9;348;1280;1281;1;28;0.83
9;349;1281;1282;1;28;0.83
9;350;1282;1291;9;28;0.83
9;351;1291;1296;5;28;0.83
9;352;1296;1305;9;28;0.83
9;353;1305;1310;5;28;0.83
9;354;1310;1312;2;28;0.83
9;355;1312;1316;4;28;0.83
9;356;1316;1321;5;28;0.83
9;357;1321;1322;1;28;0.83
9;358;1322;1323;1;28;0.83
9;359;1323;1326;3;28;0.83
9;360;1326;1332;6;28;0.83
9;361;1332;1337;5;28;0.83
9;362;1337;1338;1;28;0.83
9;363;1338;1341;3;28;0.83
9;364;1341;1344;3;28;0.83
9;365;1344;1345;1;28;0.83
9;366;1345;1357;12;28;0.83
9;367;1357;1360;3;28;0.83
9;368;1360;1362;2;28;0.83
9;369;1362;1363;1;28;0.83
9;370;1363;1364;1;28;0.83
9;371;1364;1365;1;28;0.83
9;372;1365;1366;1;28;0.83
9;373;1366;1371;5;28;0.83
9;374;1371;1374;3;28;0.83
9;375;1374;1376;2;28;0.83
9;376;1376;1378;2;28;0.83
9;377;1378;1379;1;28;0.83
9;378;1379;1385;6;28;0.83
9;379;1385;1386;1;28;0.83
9;380;1386;1387;1;28;0.83
9;381;1387;1394;7;28;0.83
9;382;1394;1409;15;28;0.83
9;383;1409;1424;15;28;0.83
9;384;1424;1439;15;28;0.83
9;385;1439;1454;15;28;0.83
9;386;1454;1469;15;28;0.83
9;387;1469;1484;15;28;0.83
9;388;1484;1499;15;28;0.83
9;389;1499;1514;15;28;0.83
9;390;1514;1529;15;28;0.83
9;391;1529;1544;15;28;0.83
9;392;1544;1559;15;28;0.83
9;393;1559;1574;15;28;0.83
9;394;1574;1589;15;28;0.83
9;395;1589;1604;15;28;0.83
9;396;1604;1619;15;28;0.83
9;397;1619;1634;15;28;0.83
9;398;1634;1649;15;28;0.83
9;399;1649;1664;15;28;0.83
9;400;1664;1679;15;28;0.83
9;401;1679;1680;1;28;0.83
10;0;240;282;42;28;0.83
10;1;282;326;44;28;0.83
10;2;326;329;3;28;0.83
10;3;329;330;1;28;0.83
10;4;330;331;1;28;0.83
10;5;331;333;2;28;0.83
10;6;333;334;1;28;0.83
10;7;334;336;2;28;0.83
10;8;336;337;1;28;0.83
10;9;337;345;8;28;0.83
10;10;345;346;1;28;0.83
10;11;346;348;2;28;0.83
10;12;348;351;3;28;0.83
10;13;351;353;2;28;0.83
10;14;353;356;3;28;0.83
10;15;356;357;1;28;0.83
10;16;357;358;1;28;0.83
10;17;358;360;2;28;0.83
10;18;360;361;1;28;0.83
10;19;361;362;1;28;0.83
10;20;362;365;3;28;0.83
10;21;365;367;2;28;0.83
10;22;367;368;1;28;0.83
10;23;368;369;1;28;0.83
10;24;369;371;2;28;0.83
10;25;371;380;9;28;0.83
10;26;380;381;1;28;0.83
10;27;381;384;3;28;0.83
10;28;384;385;1;28;0.83
10;29;385;387;2;28;0.83
10;30;387;388;1;28;0.83
10;31;388;391;3;28;0.83
10;32;391;396;5;28;0.83
10;33;396;397;1;28;0.83
10;34;397;401;4;28;0.83
10;35;401;403;2;28;0.83
10;36;403;404;1;28;0.83
10;37;404;406;2;28;0.83
10;38;406;408;2;28;0.83
10;39;408;413;5;28;0.83
10;40;413;416;3;28;0.83
10;41;416;417;1;28;0.83
10;42;417;418;1;28;0.83
10;43;418;420;2;28;0.83
10;44;420;421;1;28;0.83
10;45;421;423;2;28;0.83
10;46;423;425;2;28;0.83
10;47;425;427;2;28;0.83
10;48;427;428;1;28;0.83
10;49;428;429;1;28;0.83
10;50;429;431;2;28;0.83
10;51;431;432;1;28;0.83
10;52;432;435;3;28;0.83
10;53;435;436;1;28;0.83
10;54;436;438;2;28;0.83
10;55;438;444;6;28;0.83
10;56;444;446;2;28;0.83
10;57;446;447;1;28;0.83
10;58;447;448;1;28;0.83
10;59;448;450;2;28;0.83
10;60;450;451;1;28;0.83
10;61;451;452;1;28;0.83
10;62;452;453;1;28;0.83
10;63;453;455;2;28;0.83
10;64;455;458;3;28;0.83
10;65;458;459;1;28;0.83
10;66;459;462;3;28;0.83
10;67;462;463;1;28;0.83
10;68;463;465;2;28;0.83
10;69;465;466;1;28;0.83
10;70;466;467;1;28;0.83
10;71;467;468;1;28;0.83
10;72;468;471;3;28;0.83
10;73;471;472;1;28;0.83
10;74;472;473;1;28;0.83
10;75;473;475;2;28;0.83
10;76;475;476;1;28;0.83
10;77;476;478;2;28;0.83
10;78;478;480;2;28;0.83
10;79;480;481;1;28;0.83
10;80;481;482;1;28;0.83
10;81;482;483;1;28;0.83
10;82;483;484;1;28;0.83
10;83;484;493;9;28;0.83
10;84;493;494;1;28;0.83
10;85;494;496;2;28;0.83
10;86;496;498;2;28;0.83
10;87;498;501;3;28;0.83
10;88;501;504;3;28;0.83
10;89;504;505;1;28;0.83
10;90;505;513;8;28;0.83
10;91;513;514;1;28;0.83
10;92;514;518;4;28;0.83
10;93;518;521;3;28;0.83
10;94;521;522;1;28;0.83
10;95;522;523;1;28;0.83
10;96;523;525;2;28;0.83
10;97;525;531;6;28;0.83
10;98;531;532;1;28;0.83
10;99;532;533;1;28;0.83
10;100;533;537;4;28;0.83
10;101;537;540;3;28;0.83
10;102;540;543;3;28;0.83
10;103;543;544;1;28;0.83
10;104;544;547;3;28;0.83
10;105;547;548;1;28;0.83
10;106;548;549;1;28;0.83
10;107;549;550;1;28;0.83
10;108;550;553;3;28;0.83
10;109;553;556;3;28;0.83
10;110;556;557;1;28;0.83
10;111;557;572;15;28;0.83
10;112;572;574;2;28;0.83
10;113;574;576;2;28;0.83
10;114;576;578;2;28;0.83
10;115;578;585;7;28;0.83
10;116;585;588;3;28;0.83
10;117;588;590;2;28;0.83
10;118;590;591;1;28;0.83
10;119;591;593;2;28;0.83
10;120;593;607;14;28;0.83
10;121;607;615;8;28;0.83
10;122;615;617;2;28;0.83
10;123;617;623;6;28;0.83
10;124;623;625;2;28;0.83
10;125;625;627;2;28;0.83
10;126;627;628;1;28;0.83
10;127;628;629;1;28;0.83
10;128;629;633;4;28;0.83
10;129;633;651;18;28;0.83
10;130;651;653;2;28;0.83
10;131;653;655;2;28;0.83
10;132;655;656;1;28;0.83
10;133;656;658;2;28;0.83
10;134;658;660;2;28;0.83
10;135;660;666;6;28;0.83
10;136;666;671;5;28;0.83
10;137;671;673;2;28;0.83
10;138;673;681;8;28;0.83
10;139;681;692;11;28;0.83
10;140;692;693;1;28;0.83
10;141;693;695;2;28;0.83
10;142;695;698;3;28;0.83
10;143;698;700;2;28;0.83
10;144;700;704;4;28;0.83
10;145;704;707;3;28;0.83
10;146;707;713;6;28;0.83
10;147;713;718;5;28;0.83
10;148;718;721;3;28;0.83
10;149;721;725;4;28;0.83
10;150;725;728;3;28;0.83
10;151;728;735;7;28;0.83
10;152;735;736;1;28;0.83
10;153;736;737;1;28;0.83
10;154;737;746;9;28;0.83
10;155;746;748;2;28;0.83
10;156;748;749;1;28;0.83
10;157;749;758;9;28;0.83
10;158;758;760;2;28;0.83
10;159;760;763;3;28;0.83
10;160;763;766;3;28;0.83
10;161;766;768;2;28;0.83
10;162;768;772;4;28;0.83
10;163;772;773;1;28;0.83
10;164;773;774;1;28;0.83
10;165;774;775;1;28;0.83
10;166;775;778;3;28;0.83
10;167;778;784;6;28;0.83
10;168;784;788;4;28;0.83
10;169;788;792;4;28;0.83
10;170;792;793;1;28;0.83
10;171;793;795;2;28;0.83
10;172;795;798;3;28;0.83
10;173;798;800;2;28;0.83
10;174;800;801;1;28;0.83
10;175;801;804;3;28;0.83
10;176;804;805;1;28;0.83
10;177;805;806;1;28;0.83
10;178;806;812;6;28;0.83
10;179;812;814;2;28;0.83
10;180;814;818;4;28;0.83
10;181;818;820;2;28;0.83
10;182;820;821;1;28;0.83
10;183;821;830;9;28;0.83
10;184;830;832;2;28;0.83
10;185;832;833;1;28;0.83
10;186;833;834;1;28;0.83
10;187;834;836;2;28;0.83
10;188;836;837;1;28;0.83
10;189;837;838;1;28;0.83
10;190;838;841;3;28;0.83
10;191;841;843;2;28;0.83
10;192;843;848;5;28;0.83
10;193;848;850;2;28;0.83
10;194;850;852;2;28;0.83
10;195;852;854;2;28;0.83
10;196;854;855;1;28;0.83
10;197;855;858;3;28;0.83
10;198;858;861;3;28;0.83
10;199;861;862;1;28;0.83
10;200;862;863;1;28;0.83
10;201;863;865;2;28;0.83
10;202;865;866;1;28;0.83
10;203;866;868;2;28;0.83
10;204;868;870;2;28;0.83
10;205;870;871;1;28;0.83
10;206;871;872;1;28;0.83
10;207;872;876;4;28;0.83
10;208;876;877;1;28;0.83
10;209;877;878;1;28;0.83
10;210;878;880;2;28;0.83
10;211;880;883;3;28;0.83
10;212;883;885;2;28;0.83
10;213;885;887;2;28;0.83
10;214;887;888;1;28;0.83
10;215;888;892;4;28;0.83
10;216;892;893;1;28;0.83
10;217;893;895;2;28;0.83
10;218;895;898;3;28;0.83
10;219;898;899;1;28;0.83
10;220;899;901;2;28;0.83
10;221;901;902;1;28;0.83
10;222;902;903;1;28;0.83
10;223;903;907;4;28;0.83
10;224;907;909;2;28;0.83
10;225;909;910;1;28;0.83
10;226;910;911;1;28;0.83
10;227;911;912;1;28;0.83
10;228;912;913;1;28;0.83
10;229;913;915;2;28;0.83
10;230;915;918;3;28;0.83
10;231;918;920;2;28;0.83
10;232;920;922;2;28;0.83
10;233;922;925;3;28;0.83
10;234;925;926;1;28;0.83
10;235;926;928;2;28;0.83
10;236;928;929;1;28;0.83
10;237;929;931;2;28;0.83
10;238;931;932;1;28;0.83
10;239;932;938;6;28;0.83
10;240;938;940;2;28;0.83
10;241;940;942;2;28;0.83
10;242;942;943;1;28;0.83
10;243;943;945;2;28;0.83
10;244;945;947;2;28;0.83
10;245;947;953;6;28;0.83
10;246;953;955;2;28;0.83
10;247;955;956;1;28;0.83
10;248;956;958;2;28;0.83
10;249;958;959;1;28;0.83
10;250;959;962;3;28;0.83
10;251;962;966;4;28;0.83
10;252;966;967;1;28;0.83
10;253;967;968;1;28;0.83
10;254;968;969;1;28;0.83
10;255;969;970;1;28;0.83
10;256;970;972;2;28;0.83
10;257;972;973;1;28;0.83
10;258;973;975;2;28;0.83
10;259;975;978;3;28;0.83
10;260;978;980;2;28;0.83
10;261;980;981;1;28;0.83
10;262;981;988;7;28;0.83
10;263;988;992;4;28;0.83
10;264;992;993;1;28;0.83
10;265;993;998;5;28;0.83
10;266;998;1000;2;28;0.83
10;267;1000;1002;2;28;0.83
10;268;1002;1003;1;28;0.83
10;269;1003;1011;8;28;0.83
10;270;1011;1012;1;28;0.83
10;271;1012;1014;2;28;0.83
10;272;1014;1015;1;28;0.83
10;273;1015;1018;3;28;0.83
10;274;1018;1019;1;28;0.83
10;275;1019;1020;1;28;0.83
10;276;1020;1021;1;28;0.83
10;277;1021;1023;2;28;0.83
10;278;1023;1026;3;28;0.83
10;279;1026;1030;4;28;0.83
10;280;1030;1032;2;28;0.83
10;281;1032;1033;1;28;0.83
10;282;1033;1041;8;28;0.83
10;283;1041;1043;2;28;0.83
10;284;1043;1044;1;28;0.83
10;285;1044;1045;1;28;0.83
10;286;1045;1048;3;28;0.83
10;287;1048;1055;7;28;0.83
10;288;1055;1058;3;28;0.83
10;289;1058;1060;2;28;0.83
10;290;1060;1062;2;28;0.83
10;291;1062;1063;1;28;0.83
10;292;1063;1065;2;28;0.83
10;293;1065;1071;6;28;0.83
10;294;1071;1076;5;28;0.83
10;295;1076;1078;2;28;0.83
10;296;1078;1083;5;28;0.83
10;297;1083;1084;1;28;0.83
10;298;1084;1085;1;28;0.83
10;299;1085;1087;2;28;0.83
10;300;1087;1093;6;28;0.83
10;301;1093;1094;1;28;0.83
10;302;1094;1095;1;28;0.83
10;303;1095;1097;2;28;0.83
10;304;1097;1098;1;28;0.83
10;305;1098;1100;2;28;0.83
10;306;1100;1101;1;28;0.83
10;307;1101;1103;2;28;0.83
10;308;1103;1109;6;28;0.83
10;309;1109;1110;1;28;0.83
10;310;1110;1111;1;28;0.83
10;311;1111;1120;9;28;0.83
10;312;1120;1121;1;28;0.83
10;313;1121;1134;13;28;0.83
10;314;1134;1137;3;28;0.83
10;315;1137;1141;4;28;0.83
10;316;1141;1142;1;28;0.83
10;317;1142;1147;5;28;0.83
10;318;1147;1150;3;28;0.83
10;319;1150;1152;2;28;0.83
10;320;1152;1155;3;28;0.83
10;321;1155;1160;5;28;0.83
10;322;1160;1171;11;28;0.83
10;323;1171;1174;3;28;0.83
10;324;1174;1176;2;28;0.83
10;325;1176;1181;5;28;0.83
10;326;1181;1186;5;28;0.83
10;327;1186;1189;3;28;0.83
10;328;1189;1199;10;28;0.83
10;329;1199;1202;3;28;0.83
10;330;1202;1205;3;28;0.83
10;331;1205;1209;4;28;0.83
10;332;1209;1210;1;28;0.83
10;333;1210;1217;7;28;0.83
10;334;1217;1221;4;28;0.83
10;335;1221;1223;2;28;0.83
10;336;1223;1226;3;28;0.83
10;337;1226;1231;5;28;0.83
10;338;1231;1252;21;28;0.83
10;339;1252;1256;4;28;0.83
10;340;1256;1258;2;28;0.83
10;341;1258;1262;4;28;0.83
10;342;1262;1263;1;28;0.83
10;343;1263;1266;3;28;0.83
10;344;1266;1267;1;28;0.83
10;345;1267;1269;2;28;0.83
10;346;1269;1271;2;28;0.83
10;347;1271;1280;9;28;0.83
10;348;1280;1281;1;28;0.83
10;349;1281;1282;1;28;0.83
10;350;1282;1291;9;28;0.83
10;351;1291;1296;5;28;0.83
10;352;1296;1305;9;28;0.83
10;353;1305;1310;5;28;0.83
10;354;1310;1312;2;28;0.83
10;355;1312;1316;4;28;0.83
10;356;1316;1321;5;28;0.83
10;357;1321;1322;1;28;0.83
10;358;1322;1323;1;28;0.83
10;359;1323;1326;3;28;0.83
10;360;1326;1332;6;28;0.83
10;361;1332;1337;5;28;0.83
10;362;1337;1338;1;28;0.83
10;363;1338;1341;3;28;0.83
10;364;1341;1344;3;28;0.83
10;365;1344;1345;1;28;0.83
10;366;1345;1357;12;28;0.83
10;367;1357;1360;3;28;0.83
10;368;1360;1362;2;28;0.83
10;369;1362;1363;1;28;0.83
10;370;1363;1364;1;28;0.83
10;371;1364;1365;1;28;0.83
10;372;1365;1366;1;28;0.83
10;373;1366;1371;5;28;0.83
10;374;1371;1374;3;28;0.83
10;375;1374;1376;2;28;0.83
10;376;1376;1378;2;28;0.83
10;377;1378;1379;1;28;0.83
10;378;1379;1385;6;28;0.83
10;379;1385;1386;1;28;0.83
10;380;1386;1387;1;28;0.83
10;381;1387;1394;7;28;0.83
10;382;1394;1409;15;28;0.83
10;383;1409;1424;15;28;0.83
10;384;1424;1439;15;28;0.83
10;385;1439;1454;15;28;0.83
10;386;1454;1469;15;28;0.83
10;387;1469;1484;15;28;0.83
10;388;1484;1499;15;28;0.83
10;389;1499;1514;15;28;0.83
10;390;1514;1529;15;28;0.83
10;391;1529;1544;15;28;0.83
10;392;1544;1559;15;28;0.83
10;393;1559;1574;15;28;0.83
10;394;1574;1589;15;28;0.83
10;395;1589;1604;15;28;0.83
10;396;1604;1619;15;28;0.83
10;397;1619;1634;15;28;0.83
10;398;1634;1649;15;28;0.83
10;399;1649;1664;15;28;0.83
10;400;1664;1679;15;28;0.83
10;401;1679;1680;1;28;0.83
