Index Nabijacky;Index Udalosti;Cas Zaciatku;Cas Konca;CasTrvania;Miesto;Rychlost nabijania
0;0;243;332;89;25;2.0
0;1;332;341;9;25;2.0
0;2;341;347;6;25;2.0
0;3;347;356;9;25;2.0
0;4;356;362;6;25;2.0
0;5;362;369;7;25;2.0
0;6;369;376;7;25;2.0
0;7;376;381;5;25;2.0
0;8;381;386;5;25;2.0
0;9;386;391;5;25;2.0
0;10;391;396;5;25;2.0
0;11;396;401;5;25;2.0
0;12;401;406;5;25;2.0
0;13;406;411;5;25;2.0
0;14;411;416;5;25;2.0
0;15;416;421;5;25;2.0
0;16;421;426;5;25;2.0
0;17;426;431;5;25;2.0
0;18;431;436;5;25;2.0
0;19;436;441;5;25;2.0
0;20;441;446;5;25;2.0
0;21;446;451;5;25;2.0
0;22;451;456;5;25;2.0
0;23;456;461;5;25;2.0
0;24;461;466;5;25;2.0
0;25;466;471;5;25;2.0
0;26;471;476;5;25;2.0
0;27;476;481;5;25;2.0
0;28;481;486;5;25;2.0
0;29;486;491;5;25;2.0
0;30;491;506;15;25;2.0
0;31;506;523;17;25;2.0
0;32;523;526;3;25;2.0
0;33;526;541;15;25;2.0
0;34;541;546;5;25;2.0
0;35;546;561;15;25;2.0
0;36;561;566;5;25;2.0
0;37;566;581;15;25;2.0
0;38;581;586;5;25;2.0
0;39;586;601;15;25;2.0
0;40;601;606;5;25;2.0
0;41;606;621;15;25;2.0
0;42;621;626;5;25;2.0
0;43;626;641;15;25;2.0
0;44;641;646;5;25;2.0
0;45;646;661;15;25;2.0
0;46;661;666;5;25;2.0
0;47;666;681;15;25;2.0
0;48;681;686;5;25;2.0
0;49;686;701;15;25;2.0
0;50;701;706;5;25;2.0
0;51;706;721;15;25;2.0
0;52;721;726;5;25;2.0
0;53;726;741;15;25;2.0
0;54;741;746;5;25;2.0
0;55;746;761;15;25;2.0
0;56;761;766;5;25;2.0
0;57;766;781;15;25;2.0
0;58;781;786;5;25;2.0
0;59;786;796;10;25;2.0
0;60;796;801;5;25;2.0
0;61;801;806;5;25;2.0
0;62;806;816;10;25;2.0
0;63;816;821;5;25;2.0
0;64;821;826;5;25;2.0
0;65;826;836;10;25;2.0
0;66;836;841;5;25;2.0
0;67;841;846;5;25;2.0
0;68;846;851;5;25;2.0
0;69;851;856;5;25;2.0
0;70;856;861;5;25;2.0
0;71;861;866;5;25;2.0
0;72;866;871;5;25;2.0
0;73;871;876;5;25;2.0
0;74;876;881;5;25;2.0
0;75;881;886;5;25;2.0
0;76;886;891;5;25;2.0
0;77;891;896;5;25;2.0
0;78;896;901;5;25;2.0
0;79;901;906;5;25;2.0
0;80;906;911;5;25;2.0
0;81;911;916;5;25;2.0
0;82;916;921;5;25;2.0
0;83;921;926;5;25;2.0
0;84;926;931;5;25;2.0
0;85;931;936;5;25;2.0
0;86;936;941;5;25;2.0
0;87;941;946;5;25;2.0
0;88;946;951;5;25;2.0
0;89;951;956;5;25;2.0
0;90;956;961;5;25;2.0
0;91;961;966;5;25;2.0
0;92;966;971;5;25;2.0
0;93;971;976;5;25;2.0
0;94;976;981;5;25;2.0
0;95;981;986;5;25;2.0
0;96;986;991;5;25;2.0
0;97;991;996;5;25;2.0
0;98;996;1001;5;25;2.0
0;99;1001;1006;5;25;2.0
0;100;1006;1011;5;25;2.0
0;101;1011;1016;5;25;2.0
0;102;1016;1026;10;25;2.0
0;103;1026;1031;5;25;2.0
0;104;1031;1041;10;25;2.0
0;105;1041;1046;5;25;2.0
0;106;1046;1056;10;25;2.0
0;107;1056;1061;5;25;2.0
0;108;1061;1071;10;25;2.0
0;109;1071;1076;5;25;2.0
0;110;1076;1086;10;25;2.0
0;111;1086;1091;5;25;2.0
0;112;1091;1101;10;25;2.0
0;113;1101;1106;5;25;2.0
0;114;1106;1116;10;25;2.0
0;115;1116;1118;2;25;2.0
0;116;1118;1128;10;25;2.0
0;117;1128;1133;5;25;2.0
0;118;1133;1143;10;25;2.0
0;119;1143;1148;5;25;2.0
0;120;1148;1158;10;25;2.0
0;121;1158;1163;5;25;2.0
0;122;1163;1178;15;25;2.0
0;123;1178;1183;5;25;2.0
0;124;1183;1198;15;25;2.0
0;125;1198;1203;5;25;2.0
0;126;1203;1218;15;25;2.0
0;127;1218;1228;10;25;2.0
0;128;1228;1238;10;25;2.0
0;129;1238;1253;15;25;2.0
0;130;1253;1263;10;25;2.0
0;131;1263;1278;15;25;2.0
0;132;1278;1288;10;25;2.0
0;133;1288;1303;15;25;2.0
0;134;1303;1313;10;25;2.0
0;135;1313;1323;10;25;2.0
0;136;1323;1338;15;25;2.0
0;137;1338;1343;5;25;2.0
0;138;1343;1364;21;25;2.0
0;139;1364;1366;2;25;2.0
0;140;1366;1383;17;25;2.0
0;141;1383;1398;15;25;2.0
0;142;1398;1413;15;25;2.0
0;143;1413;1428;15;25;2.0
0;144;1428;1443;15;25;2.0
0;145;1443;1458;15;25;2.0
0;146;1458;1473;15;25;2.0
0;147;1473;1488;15;25;2.0
0;148;1488;1503;15;25;2.0
0;149;1503;1518;15;25;2.0
0;150;1518;1533;15;25;2.0
0;151;1533;1548;15;25;2.0
0;152;1548;1563;15;25;2.0
0;153;1563;1578;15;25;2.0
0;154;1578;1593;15;25;2.0
0;155;1593;1608;15;25;2.0
0;156;1608;1623;15;25;2.0
0;157;1623;1638;15;25;2.0
0;158;1638;1653;15;25;2.0
0;159;1653;1668;15;25;2.0
0;160;1668;1680;12;25;2.0
1;0;242;332;90;42;2.0
1;1;332;340;8;42;2.0
1;2;340;347;7;42;2.0
1;3;347;355;8;42;2.0
1;4;355;362;7;42;2.0
1;5;362;368;6;42;2.0
1;6;368;376;8;42;2.0
1;7;376;380;4;42;2.0
1;8;380;386;6;42;2.0
1;9;386;390;4;42;2.0
1;10;390;396;6;42;2.0
1;11;396;400;4;42;2.0
1;12;400;406;6;42;2.0
1;13;406;410;4;42;2.0
1;14;410;416;6;42;2.0
1;15;416;420;4;42;2.0
1;16;420;426;6;42;2.0
1;17;426;430;4;42;2.0
1;18;430;436;6;42;2.0
1;19;436;440;4;42;2.0
1;20;440;446;6;42;2.0
1;21;446;450;4;42;2.0
1;22;450;456;6;42;2.0
1;23;456;460;4;42;2.0
1;24;460;466;6;42;2.0
1;25;466;470;4;42;2.0
1;26;470;476;6;42;2.0
1;27;476;480;4;42;2.0
1;28;480;486;6;42;2.0
1;29;486;490;4;42;2.0
1;30;490;505;15;42;2.0
1;31;505;506;1;42;2.0
1;32;506;522;16;42;2.0
1;33;522;526;4;42;2.0
1;34;526;540;14;42;2.0
1;35;540;546;6;42;2.0
1;36;546;560;14;42;2.0
1;37;560;566;6;42;2.0
1;38;566;580;14;42;2.0
1;39;580;586;6;42;2.0
1;40;586;600;14;42;2.0
1;41;600;606;6;42;2.0
1;42;606;620;14;42;2.0
1;43;620;626;6;42;2.0
1;44;626;640;14;42;2.0
1;45;640;646;6;42;2.0
1;46;646;660;14;42;2.0
1;47;660;666;6;42;2.0
1;48;666;680;14;42;2.0
1;49;680;686;6;42;2.0
1;50;686;700;14;42;2.0
1;51;700;706;6;42;2.0
1;52;706;720;14;42;2.0
1;53;720;726;6;42;2.0
1;54;726;740;14;42;2.0
1;55;740;746;6;42;2.0
1;56;746;760;14;42;2.0
1;57;760;766;6;42;2.0
1;58;766;780;14;42;2.0
1;59;780;786;6;42;2.0
1;60;786;796;10;42;2.0
1;61;796;800;4;42;2.0
1;62;800;806;6;42;2.0
1;63;806;816;10;42;2.0
1;64;816;820;4;42;2.0
1;65;820;826;6;42;2.0
1;66;826;836;10;42;2.0
1;67;836;840;4;42;2.0
1;68;840;846;6;42;2.0
1;69;846;850;4;42;2.0
1;70;850;856;6;42;2.0
1;71;856;860;4;42;2.0
1;72;860;866;6;42;2.0
1;73;866;870;4;42;2.0
1;74;870;876;6;42;2.0
1;75;876;880;4;42;2.0
1;76;880;886;6;42;2.0
1;77;886;890;4;42;2.0
1;78;890;896;6;42;2.0
1;79;896;900;4;42;2.0
1;80;900;906;6;42;2.0
1;81;906;910;4;42;2.0
1;82;910;916;6;42;2.0
1;83;916;920;4;42;2.0
1;84;920;926;6;42;2.0
1;85;926;930;4;42;2.0
1;86;930;936;6;42;2.0
1;87;936;940;4;42;2.0
1;88;940;946;6;42;2.0
1;89;946;950;4;42;2.0
1;90;950;956;6;42;2.0
1;91;956;960;4;42;2.0
1;92;960;966;6;42;2.0
1;93;966;970;4;42;2.0
1;94;970;976;6;42;2.0
1;95;976;980;4;42;2.0
1;96;980;986;6;42;2.0
1;97;986;990;4;42;2.0
1;98;990;996;6;42;2.0
1;99;996;1000;4;42;2.0
1;100;1000;1006;6;42;2.0
1;101;1006;1010;4;42;2.0
1;102;1010;1016;6;42;2.0
1;103;1016;1025;9;42;2.0
1;104;1025;1031;6;42;2.0
1;105;1031;1040;9;42;2.0
1;106;1040;1046;6;42;2.0
1;107;1046;1055;9;42;2.0
1;108;1055;1061;6;42;2.0
1;109;1061;1070;9;42;2.0
1;110;1070;1076;6;42;2.0
1;111;1076;1085;9;42;2.0
1;112;1085;1091;6;42;2.0
1;113;1091;1100;9;42;2.0
1;114;1100;1106;6;42;2.0
1;115;1106;1115;9;42;2.0
1;116;1115;1118;3;42;2.0
1;117;1118;1127;9;42;2.0
1;118;1127;1133;6;42;2.0
1;119;1133;1142;9;42;2.0
1;120;1142;1148;6;42;2.0
1;121;1148;1157;9;42;2.0
1;122;1157;1163;6;42;2.0
1;123;1163;1177;14;42;2.0
1;124;1177;1183;6;42;2.0
1;125;1183;1197;14;42;2.0
1;126;1197;1203;6;42;2.0
1;127;1203;1217;14;42;2.0
1;128;1217;1228;11;42;2.0
1;129;1228;1237;9;42;2.0
1;130;1237;1253;16;42;2.0
1;131;1253;1262;9;42;2.0
1;132;1262;1278;16;42;2.0
1;133;1278;1287;9;42;2.0
1;134;1287;1303;16;42;2.0
1;135;1303;1312;9;42;2.0
1;136;1312;1323;11;42;2.0
1;137;1323;1337;14;42;2.0
1;138;1337;1343;6;42;2.0
1;139;1343;1364;21;42;2.0
1;140;1364;1365;1;42;2.0
1;141;1365;1382;17;42;2.0
1;142;1382;1397;15;42;2.0
1;143;1397;1412;15;42;2.0
1;144;1412;1427;15;42;2.0
1;145;1427;1442;15;42;2.0
1;146;1442;1457;15;42;2.0
1;147;1457;1472;15;42;2.0
1;148;1472;1487;15;42;2.0
1;149;1487;1502;15;42;2.0
1;150;1502;1517;15;42;2.0
1;151;1517;1532;15;42;2.0
1;152;1532;1547;15;42;2.0
1;153;1547;1562;15;42;2.0
1;154;1562;1577;15;42;2.0
1;155;1577;1592;15;42;2.0
1;156;1592;1607;15;42;2.0
1;157;1607;1622;15;42;2.0
1;158;1622;1637;15;42;2.0
1;159;1637;1652;15;42;2.0
1;160;1652;1667;15;42;2.0
1;161;1667;1680;13;42;2.0
2;0;246;335;89;49;2.0
2;1;335;343;8;49;2.0
2;2;343;350;7;49;2.0
2;3;350;358;8;49;2.0
2;4;358;365;7;49;2.0
2;5;365;371;6;49;2.0
2;6;371;379;8;49;2.0
2;7;379;383;4;49;2.0
2;8;383;389;6;49;2.0
2;9;389;393;4;49;2.0
2;10;393;399;6;49;2.0
2;11;399;403;4;49;2.0
2;12;403;409;6;49;2.0
2;13;409;413;4;49;2.0
2;14;413;419;6;49;2.0
2;15;419;423;4;49;2.0
2;16;423;429;6;49;2.0
2;17;429;433;4;49;2.0
2;18;433;439;6;49;2.0
2;19;439;443;4;49;2.0
2;20;443;449;6;49;2.0
2;21;449;453;4;49;2.0
2;22;453;459;6;49;2.0
2;23;459;463;4;49;2.0
2;24;463;469;6;49;2.0
2;25;469;473;4;49;2.0
2;26;473;479;6;49;2.0
2;27;479;483;4;49;2.0
2;28;483;489;6;49;2.0
2;29;489;493;4;49;2.0
2;30;493;508;15;49;2.0
2;31;508;509;1;49;2.0
2;32;509;525;16;49;2.0
2;33;525;529;4;49;2.0
2;34;529;543;14;49;2.0
2;35;543;549;6;49;2.0
2;36;549;563;14;49;2.0
2;37;563;569;6;49;2.0
2;38;569;583;14;49;2.0
2;39;583;589;6;49;2.0
2;40;589;603;14;49;2.0
2;41;603;609;6;49;2.0
2;42;609;623;14;49;2.0
2;43;623;629;6;49;2.0
2;44;629;643;14;49;2.0
2;45;643;649;6;49;2.0
2;46;649;663;14;49;2.0
2;47;663;669;6;49;2.0
2;48;669;683;14;49;2.0
2;49;683;689;6;49;2.0
2;50;689;703;14;49;2.0
2;51;703;709;6;49;2.0
2;52;709;723;14;49;2.0
2;53;723;729;6;49;2.0
2;54;729;743;14;49;2.0
2;55;743;749;6;49;2.0
2;56;749;763;14;49;2.0
2;57;763;769;6;49;2.0
2;58;769;783;14;49;2.0
2;59;783;789;6;49;2.0
2;60;789;799;10;49;2.0
2;61;799;803;4;49;2.0
2;62;803;809;6;49;2.0
2;63;809;819;10;49;2.0
2;64;819;823;4;49;2.0
2;65;823;829;6;49;2.0
2;66;829;839;10;49;2.0
2;67;839;843;4;49;2.0
2;68;843;849;6;49;2.0
2;69;849;853;4;49;2.0
2;70;853;859;6;49;2.0
2;71;859;863;4;49;2.0
2;72;863;869;6;49;2.0
2;73;869;873;4;49;2.0
2;74;873;879;6;49;2.0
2;75;879;883;4;49;2.0
2;76;883;889;6;49;2.0
2;77;889;893;4;49;2.0
2;78;893;899;6;49;2.0
2;79;899;903;4;49;2.0
2;80;903;909;6;49;2.0
2;81;909;913;4;49;2.0
2;82;913;919;6;49;2.0
2;83;919;923;4;49;2.0
2;84;923;929;6;49;2.0
2;85;929;933;4;49;2.0
2;86;933;939;6;49;2.0
2;87;939;943;4;49;2.0
2;88;943;949;6;49;2.0
2;89;949;953;4;49;2.0
2;90;953;959;6;49;2.0
2;91;959;963;4;49;2.0
2;92;963;969;6;49;2.0
2;93;969;973;4;49;2.0
2;94;973;979;6;49;2.0
2;95;979;983;4;49;2.0
2;96;983;989;6;49;2.0
2;97;989;993;4;49;2.0
2;98;993;999;6;49;2.0
2;99;999;1003;4;49;2.0
2;100;1003;1009;6;49;2.0
2;101;1009;1013;4;49;2.0
2;102;1013;1019;6;49;2.0
2;103;1019;1028;9;49;2.0
2;104;1028;1034;6;49;2.0
2;105;1034;1043;9;49;2.0
2;106;1043;1049;6;49;2.0
2;107;1049;1058;9;49;2.0
2;108;1058;1064;6;49;2.0
2;109;1064;1073;9;49;2.0
2;110;1073;1079;6;49;2.0
2;111;1079;1088;9;49;2.0
2;112;1088;1094;6;49;2.0
2;113;1094;1103;9;49;2.0
2;114;1103;1109;6;49;2.0
2;115;1109;1118;9;49;2.0
2;116;1118;1121;3;49;2.0
2;117;1121;1130;9;49;2.0
2;118;1130;1136;6;49;2.0
2;119;1136;1145;9;49;2.0
2;120;1145;1151;6;49;2.0
2;121;1151;1160;9;49;2.0
2;122;1160;1166;6;49;2.0
2;123;1166;1180;14;49;2.0
2;124;1180;1186;6;49;2.0
2;125;1186;1200;14;49;2.0
2;126;1200;1206;6;49;2.0
2;127;1206;1220;14;49;2.0
2;128;1220;1231;11;49;2.0
2;129;1231;1240;9;49;2.0
2;130;1240;1256;16;49;2.0
2;131;1256;1265;9;49;2.0
2;132;1265;1281;16;49;2.0
2;133;1281;1290;9;49;2.0
2;134;1290;1306;16;49;2.0
2;135;1306;1315;9;49;2.0
2;136;1315;1326;11;49;2.0
2;137;1326;1340;14;49;2.0
2;138;1340;1346;6;49;2.0
2;139;1346;1367;21;49;2.0
2;140;1367;1368;1;49;2.0
2;141;1368;1385;17;49;2.0
2;142;1385;1400;15;49;2.0
2;143;1400;1415;15;49;2.0
2;144;1415;1430;15;49;2.0
2;145;1430;1445;15;49;2.0
2;146;1445;1460;15;49;2.0
2;147;1460;1475;15;49;2.0
2;148;1475;1490;15;49;2.0
2;149;1490;1505;15;49;2.0
2;150;1505;1520;15;49;2.0
2;151;1520;1535;15;49;2.0
2;152;1535;1550;15;49;2.0
2;153;1550;1565;15;49;2.0
2;154;1565;1580;15;49;2.0
2;155;1580;1595;15;49;2.0
2;156;1595;1610;15;49;2.0
2;157;1610;1625;15;49;2.0
2;158;1625;1640;15;49;2.0
2;159;1640;1655;15;49;2.0
2;160;1655;1670;15;49;2.0
2;161;1670;1680;10;49;2.0
3;0;244;331;87;77;2.0
3;1;331;340;9;77;2.0
3;2;340;346;6;77;2.0
3;3;346;355;9;77;2.0
3;4;355;361;6;77;2.0
3;5;361;368;7;77;2.0
3;6;368;375;7;77;2.0
3;7;375;380;5;77;2.0
3;8;380;385;5;77;2.0
3;9;385;390;5;77;2.0
3;10;390;395;5;77;2.0
3;11;395;400;5;77;2.0
3;12;400;405;5;77;2.0
3;13;405;410;5;77;2.0
3;14;410;415;5;77;2.0
3;15;415;420;5;77;2.0
3;16;420;425;5;77;2.0
3;17;425;430;5;77;2.0
3;18;430;435;5;77;2.0
3;19;435;440;5;77;2.0
3;20;440;445;5;77;2.0
3;21;445;450;5;77;2.0
3;22;450;455;5;77;2.0
3;23;455;460;5;77;2.0
3;24;460;465;5;77;2.0
3;25;465;470;5;77;2.0
3;26;470;475;5;77;2.0
3;27;475;480;5;77;2.0
3;28;480;485;5;77;2.0
3;29;485;490;5;77;2.0
3;30;490;505;15;77;2.0
3;31;505;522;17;77;2.0
3;32;522;525;3;77;2.0
3;33;525;540;15;77;2.0
3;34;540;545;5;77;2.0
3;35;545;560;15;77;2.0
3;36;560;565;5;77;2.0
3;37;565;580;15;77;2.0
3;38;580;585;5;77;2.0
3;39;585;600;15;77;2.0
3;40;600;605;5;77;2.0
3;41;605;620;15;77;2.0
3;42;620;625;5;77;2.0
3;43;625;640;15;77;2.0
3;44;640;645;5;77;2.0
3;45;645;660;15;77;2.0
3;46;660;665;5;77;2.0
3;47;665;680;15;77;2.0
3;48;680;685;5;77;2.0
3;49;685;700;15;77;2.0
3;50;700;705;5;77;2.0
3;51;705;720;15;77;2.0
3;52;720;725;5;77;2.0
3;53;725;740;15;77;2.0
3;54;740;745;5;77;2.0
3;55;745;760;15;77;2.0
3;56;760;765;5;77;2.0
3;57;765;780;15;77;2.0
3;58;780;785;5;77;2.0
3;59;785;795;10;77;2.0
3;60;795;800;5;77;2.0
3;61;800;805;5;77;2.0
3;62;805;815;10;77;2.0
3;63;815;820;5;77;2.0
3;64;820;825;5;77;2.0
3;65;825;835;10;77;2.0
3;66;835;840;5;77;2.0
3;67;840;845;5;77;2.0
3;68;845;850;5;77;2.0
3;69;850;855;5;77;2.0
3;70;855;860;5;77;2.0
3;71;860;865;5;77;2.0
3;72;865;870;5;77;2.0
3;73;870;875;5;77;2.0
3;74;875;880;5;77;2.0
3;75;880;885;5;77;2.0
3;76;885;890;5;77;2.0
3;77;890;895;5;77;2.0
3;78;895;900;5;77;2.0
3;79;900;905;5;77;2.0
3;80;905;910;5;77;2.0
3;81;910;915;5;77;2.0
3;82;915;920;5;77;2.0
3;83;920;925;5;77;2.0
3;84;925;930;5;77;2.0
3;85;930;935;5;77;2.0
3;86;935;940;5;77;2.0
3;87;940;945;5;77;2.0
3;88;945;950;5;77;2.0
3;89;950;955;5;77;2.0
3;90;955;960;5;77;2.0
3;91;960;965;5;77;2.0
3;92;965;970;5;77;2.0
3;93;970;975;5;77;2.0
3;94;975;980;5;77;2.0
3;95;980;985;5;77;2.0
3;96;985;990;5;77;2.0
3;97;990;995;5;77;2.0
3;98;995;1000;5;77;2.0
3;99;1000;1005;5;77;2.0
3;100;1005;1010;5;77;2.0
3;101;1010;1015;5;77;2.0
3;102;1015;1025;10;77;2.0
3;103;1025;1030;5;77;2.0
3;104;1030;1040;10;77;2.0
3;105;1040;1045;5;77;2.0
3;106;1045;1055;10;77;2.0
3;107;1055;1060;5;77;2.0
3;108;1060;1070;10;77;2.0
3;109;1070;1075;5;77;2.0
3;110;1075;1085;10;77;2.0
3;111;1085;1090;5;77;2.0
3;112;1090;1100;10;77;2.0
3;113;1100;1105;5;77;2.0
3;114;1105;1115;10;77;2.0
3;115;1115;1117;2;77;2.0
3;116;1117;1127;10;77;2.0
3;117;1127;1132;5;77;2.0
3;118;1132;1142;10;77;2.0
3;119;1142;1147;5;77;2.0
3;120;1147;1157;10;77;2.0
3;121;1157;1162;5;77;2.0
3;122;1162;1177;15;77;2.0
3;123;1177;1182;5;77;2.0
3;124;1182;1197;15;77;2.0
3;125;1197;1202;5;77;2.0
3;126;1202;1217;15;77;2.0
3;127;1217;1227;10;77;2.0
3;128;1227;1237;10;77;2.0
3;129;1237;1252;15;77;2.0
3;130;1252;1262;10;77;2.0
3;131;1262;1277;15;77;2.0
3;132;1277;1287;10;77;2.0
3;133;1287;1302;15;77;2.0
3;134;1302;1312;10;77;2.0
3;135;1312;1322;10;77;2.0
3;136;1322;1337;15;77;2.0
3;137;1337;1342;5;77;2.0
3;138;1342;1363;21;77;2.0
3;139;1363;1365;2;77;2.0
3;140;1365;1382;17;77;2.0
3;141;1382;1397;15;77;2.0
3;142;1397;1412;15;77;2.0
3;143;1412;1427;15;77;2.0
3;144;1427;1442;15;77;2.0
3;145;1442;1457;15;77;2.0
3;146;1457;1472;15;77;2.0
3;147;1472;1487;15;77;2.0
3;148;1487;1502;15;77;2.0
3;149;1502;1517;15;77;2.0
3;150;1517;1532;15;77;2.0
3;151;1532;1547;15;77;2.0
3;152;1547;1562;15;77;2.0
3;153;1562;1577;15;77;2.0
3;154;1577;1592;15;77;2.0
3;155;1592;1607;15;77;2.0
3;156;1607;1622;15;77;2.0
3;157;1622;1637;15;77;2.0
3;158;1637;1652;15;77;2.0
3;159;1652;1667;15;77;2.0
3;160;1667;1680;13;77;2.0
4;0;243;329;86;93;2.0
4;1;329;336;7;93;2.0
4;2;336;344;8;93;2.0
4;3;344;351;7;93;2.0
4;4;351;359;8;93;2.0
4;5;359;364;5;93;2.0
4;6;364;373;9;93;2.0
4;7;373;376;3;93;2.0
4;8;376;383;7;93;2.0
4;9;383;386;3;93;2.0
4;10;386;393;7;93;2.0
4;11;393;396;3;93;2.0
4;12;396;403;7;93;2.0
4;13;403;406;3;93;2.0
4;14;406;413;7;93;2.0
4;15;413;416;3;93;2.0
4;16;416;423;7;93;2.0
4;17;423;426;3;93;2.0
4;18;426;433;7;93;2.0
4;19;433;436;3;93;2.0
4;20;436;443;7;93;2.0
4;21;443;446;3;93;2.0
4;22;446;453;7;93;2.0
4;23;453;456;3;93;2.0
4;24;456;463;7;93;2.0
4;25;463;466;3;93;2.0
4;26;466;473;7;93;2.0
4;27;473;476;3;93;2.0
4;28;476;483;7;93;2.0
4;29;483;486;3;93;2.0
4;30;486;501;15;93;2.0
4;31;501;503;2;93;2.0
4;32;503;518;15;93;2.0
4;33;518;523;5;93;2.0
4;34;523;536;13;93;2.0
4;35;536;543;7;93;2.0
4;36;543;556;13;93;2.0
4;37;556;563;7;93;2.0
4;38;563;576;13;93;2.0
4;39;576;583;7;93;2.0
4;40;583;596;13;93;2.0
4;41;596;603;7;93;2.0
4;42;603;616;13;93;2.0
4;43;616;623;7;93;2.0
4;44;623;636;13;93;2.0
4;45;636;643;7;93;2.0
4;46;643;656;13;93;2.0
4;47;656;663;7;93;2.0
4;48;663;676;13;93;2.0
4;49;676;683;7;93;2.0
4;50;683;696;13;93;2.0
4;51;696;703;7;93;2.0
4;52;703;716;13;93;2.0
4;53;716;723;7;93;2.0
4;54;723;736;13;93;2.0
4;55;736;743;7;93;2.0
4;56;743;756;13;93;2.0
4;57;756;763;7;93;2.0
4;58;763;776;13;93;2.0
4;59;776;783;7;93;2.0
4;60;783;793;10;93;2.0
4;61;793;796;3;93;2.0
4;62;796;803;7;93;2.0
4;63;803;813;10;93;2.0
4;64;813;816;3;93;2.0
4;65;816;823;7;93;2.0
4;66;823;833;10;93;2.0
4;67;833;836;3;93;2.0
4;68;836;843;7;93;2.0
4;69;843;846;3;93;2.0
4;70;846;853;7;93;2.0
4;71;853;856;3;93;2.0
4;72;856;863;7;93;2.0
4;73;863;866;3;93;2.0
4;74;866;873;7;93;2.0
4;75;873;876;3;93;2.0
4;76;876;883;7;93;2.0
4;77;883;886;3;93;2.0
4;78;886;893;7;93;2.0
4;79;893;896;3;93;2.0
4;80;896;903;7;93;2.0
4;81;903;906;3;93;2.0
4;82;906;913;7;93;2.0
4;83;913;916;3;93;2.0
4;84;916;923;7;93;2.0
4;85;923;926;3;93;2.0
4;86;926;933;7;93;2.0
4;87;933;936;3;93;2.0
4;88;936;943;7;93;2.0
4;89;943;946;3;93;2.0
4;90;946;953;7;93;2.0
4;91;953;956;3;93;2.0
4;92;956;963;7;93;2.0
4;93;963;966;3;93;2.0
4;94;966;973;7;93;2.0
4;95;973;976;3;93;2.0
4;96;976;983;7;93;2.0
4;97;983;986;3;93;2.0
4;98;986;993;7;93;2.0
4;99;993;996;3;93;2.0
4;100;996;1003;7;93;2.0
4;101;1003;1006;3;93;2.0
4;102;1006;1013;7;93;2.0
4;103;1013;1021;8;93;2.0
4;104;1021;1028;7;93;2.0
4;105;1028;1036;8;93;2.0
4;106;1036;1043;7;93;2.0
4;107;1043;1051;8;93;2.0
4;108;1051;1058;7;93;2.0
4;109;1058;1066;8;93;2.0
4;110;1066;1073;7;93;2.0
4;111;1073;1081;8;93;2.0
4;112;1081;1088;7;93;2.0
4;113;1088;1096;8;93;2.0
4;114;1096;1103;7;93;2.0
4;115;1103;1111;8;93;2.0
4;116;1111;1115;4;93;2.0
4;117;1115;1123;8;93;2.0
4;118;1123;1130;7;93;2.0
4;119;1130;1138;8;93;2.0
4;120;1138;1145;7;93;2.0
4;121;1145;1153;8;93;2.0
4;122;1153;1160;7;93;2.0
4;123;1160;1173;13;93;2.0
4;124;1173;1180;7;93;2.0
4;125;1180;1193;13;93;2.0
4;126;1193;1200;7;93;2.0
4;127;1200;1213;13;93;2.0
4;128;1213;1225;12;93;2.0
4;129;1225;1233;8;93;2.0
4;130;1233;1250;17;93;2.0
4;131;1250;1258;8;93;2.0
4;132;1258;1275;17;93;2.0
4;133;1275;1283;8;93;2.0
4;134;1283;1300;17;93;2.0
4;135;1300;1308;8;93;2.0
4;136;1308;1320;12;93;2.0
4;137;1320;1333;13;93;2.0
4;138;1333;1340;7;93;2.0
4;139;1340;1361;21;93;2.0
4;140;1361;1378;17;93;2.0
4;141;1378;1393;15;93;2.0
4;142;1393;1408;15;93;2.0
4;143;1408;1423;15;93;2.0
4;144;1423;1438;15;93;2.0
4;145;1438;1453;15;93;2.0
4;146;1453;1468;15;93;2.0
4;147;1468;1483;15;93;2.0
4;148;1483;1498;15;93;2.0
4;149;1498;1513;15;93;2.0
4;150;1513;1528;15;93;2.0
4;151;1528;1543;15;93;2.0
4;152;1543;1558;15;93;2.0
4;153;1558;1573;15;93;2.0
4;154;1573;1588;15;93;2.0
4;155;1588;1603;15;93;2.0
4;156;1603;1618;15;93;2.0
4;157;1618;1633;15;93;2.0
4;158;1633;1648;15;93;2.0
4;159;1648;1663;15;93;2.0
4;160;1663;1680;17;93;2.0
5;0;245;334;89;112;2.0
5;1;334;342;8;112;2.0
5;2;342;349;7;112;2.0
5;3;349;357;8;112;2.0
5;4;357;364;7;112;2.0
5;5;364;370;6;112;2.0
5;6;370;378;8;112;2.0
5;7;378;382;4;112;2.0
5;8;382;388;6;112;2.0
5;9;388;392;4;112;2.0
5;10;392;398;6;112;2.0
5;11;398;402;4;112;2.0
5;12;402;408;6;112;2.0
5;13;408;412;4;112;2.0
5;14;412;418;6;112;2.0
5;15;418;422;4;112;2.0
5;16;422;428;6;112;2.0
5;17;428;432;4;112;2.0
5;18;432;438;6;112;2.0
5;19;438;442;4;112;2.0
5;20;442;448;6;112;2.0
5;21;448;452;4;112;2.0
5;22;452;458;6;112;2.0
5;23;458;462;4;112;2.0
5;24;462;468;6;112;2.0
5;25;468;472;4;112;2.0
5;26;472;478;6;112;2.0
5;27;478;482;4;112;2.0
5;28;482;488;6;112;2.0
5;29;488;492;4;112;2.0
5;30;492;507;15;112;2.0
5;31;507;508;1;112;2.0
5;32;508;524;16;112;2.0
5;33;524;528;4;112;2.0
5;34;528;542;14;112;2.0
5;35;542;548;6;112;2.0
5;36;548;562;14;112;2.0
5;37;562;568;6;112;2.0
5;38;568;582;14;112;2.0
5;39;582;588;6;112;2.0
5;40;588;602;14;112;2.0
5;41;602;608;6;112;2.0
5;42;608;622;14;112;2.0
5;43;622;628;6;112;2.0
5;44;628;642;14;112;2.0
5;45;642;648;6;112;2.0
5;46;648;662;14;112;2.0
5;47;662;668;6;112;2.0
5;48;668;682;14;112;2.0
5;49;682;688;6;112;2.0
5;50;688;702;14;112;2.0
5;51;702;708;6;112;2.0
5;52;708;722;14;112;2.0
5;53;722;728;6;112;2.0
5;54;728;742;14;112;2.0
5;55;742;748;6;112;2.0
5;56;748;762;14;112;2.0
5;57;762;768;6;112;2.0
5;58;768;782;14;112;2.0
5;59;782;788;6;112;2.0
5;60;788;798;10;112;2.0
5;61;798;802;4;112;2.0
5;62;802;808;6;112;2.0
5;63;808;818;10;112;2.0
5;64;818;822;4;112;2.0
5;65;822;828;6;112;2.0
5;66;828;838;10;112;2.0
5;67;838;842;4;112;2.0
5;68;842;848;6;112;2.0
5;69;848;852;4;112;2.0
5;70;852;858;6;112;2.0
5;71;858;862;4;112;2.0
5;72;862;868;6;112;2.0
5;73;868;872;4;112;2.0
5;74;872;878;6;112;2.0
5;75;878;882;4;112;2.0
5;76;882;888;6;112;2.0
5;77;888;892;4;112;2.0
5;78;892;898;6;112;2.0
5;79;898;902;4;112;2.0
5;80;902;908;6;112;2.0
5;81;908;912;4;112;2.0
5;82;912;918;6;112;2.0
5;83;918;922;4;112;2.0
5;84;922;928;6;112;2.0
5;85;928;932;4;112;2.0
5;86;932;938;6;112;2.0
5;87;938;942;4;112;2.0
5;88;942;948;6;112;2.0
5;89;948;952;4;112;2.0
5;90;952;958;6;112;2.0
5;91;958;962;4;112;2.0
5;92;962;968;6;112;2.0
5;93;968;972;4;112;2.0
5;94;972;978;6;112;2.0
5;95;978;982;4;112;2.0
5;96;982;988;6;112;2.0
5;97;988;992;4;112;2.0
5;98;992;998;6;112;2.0
5;99;998;1002;4;112;2.0
5;100;1002;1008;6;112;2.0
5;101;1008;1012;4;112;2.0
5;102;1012;1018;6;112;2.0
5;103;1018;1027;9;112;2.0
5;104;1027;1033;6;112;2.0
5;105;1033;1042;9;112;2.0
5;106;1042;1048;6;112;2.0
5;107;1048;1057;9;112;2.0
5;108;1057;1063;6;112;2.0
5;109;1063;1072;9;112;2.0
5;110;1072;1078;6;112;2.0
5;111;1078;1087;9;112;2.0
5;112;1087;1093;6;112;2.0
5;113;1093;1102;9;112;2.0
5;114;1102;1108;6;112;2.0
5;115;1108;1117;9;112;2.0
5;116;1117;1120;3;112;2.0
5;117;1120;1129;9;112;2.0
5;118;1129;1135;6;112;2.0
5;119;1135;1144;9;112;2.0
5;120;1144;1150;6;112;2.0
5;121;1150;1159;9;112;2.0
5;122;1159;1165;6;112;2.0
5;123;1165;1179;14;112;2.0
5;124;1179;1185;6;112;2.0
5;125;1185;1199;14;112;2.0
5;126;1199;1205;6;112;2.0
5;127;1205;1219;14;112;2.0
5;128;1219;1230;11;112;2.0
5;129;1230;1239;9;112;2.0
5;130;1239;1255;16;112;2.0
5;131;1255;1264;9;112;2.0
5;132;1264;1280;16;112;2.0
5;133;1280;1289;9;112;2.0
5;134;1289;1305;16;112;2.0
5;135;1305;1314;9;112;2.0
5;136;1314;1325;11;112;2.0
5;137;1325;1339;14;112;2.0
5;138;1339;1345;6;112;2.0
5;139;1345;1366;21;112;2.0
5;140;1366;1367;1;112;2.0
5;141;1367;1384;17;112;2.0
5;142;1384;1399;15;112;2.0
5;143;1399;1414;15;112;2.0
5;144;1414;1429;15;112;2.0
5;145;1429;1444;15;112;2.0
5;146;1444;1459;15;112;2.0
5;147;1459;1474;15;112;2.0
5;148;1474;1489;15;112;2.0
5;149;1489;1504;15;112;2.0
5;150;1504;1519;15;112;2.0
5;151;1519;1534;15;112;2.0
5;152;1534;1549;15;112;2.0
5;153;1549;1564;15;112;2.0
5;154;1564;1579;15;112;2.0
5;155;1579;1594;15;112;2.0
5;156;1594;1609;15;112;2.0
5;157;1609;1624;15;112;2.0
5;158;1624;1639;15;112;2.0
5;159;1639;1654;15;112;2.0
5;160;1654;1669;15;112;2.0
5;161;1669;1680;11;112;2.0
6;0;245;334;89;112;2.0
6;1;334;342;8;112;2.0
6;2;342;349;7;112;2.0
6;3;349;357;8;112;2.0
6;4;357;364;7;112;2.0
6;5;364;370;6;112;2.0
6;6;370;378;8;112;2.0
6;7;378;382;4;112;2.0
6;8;382;388;6;112;2.0
6;9;388;392;4;112;2.0
6;10;392;398;6;112;2.0
6;11;398;402;4;112;2.0
6;12;402;408;6;112;2.0
6;13;408;412;4;112;2.0
6;14;412;418;6;112;2.0
6;15;418;422;4;112;2.0
6;16;422;428;6;112;2.0
6;17;428;432;4;112;2.0
6;18;432;438;6;112;2.0
6;19;438;442;4;112;2.0
6;20;442;448;6;112;2.0
6;21;448;452;4;112;2.0
6;22;452;458;6;112;2.0
6;23;458;462;4;112;2.0
6;24;462;468;6;112;2.0
6;25;468;472;4;112;2.0
6;26;472;478;6;112;2.0
6;27;478;482;4;112;2.0
6;28;482;488;6;112;2.0
6;29;488;492;4;112;2.0
6;30;492;507;15;112;2.0
6;31;507;508;1;112;2.0
6;32;508;524;16;112;2.0
6;33;524;528;4;112;2.0
6;34;528;542;14;112;2.0
6;35;542;548;6;112;2.0
6;36;548;562;14;112;2.0
6;37;562;568;6;112;2.0
6;38;568;582;14;112;2.0
6;39;582;588;6;112;2.0
6;40;588;602;14;112;2.0
6;41;602;608;6;112;2.0
6;42;608;622;14;112;2.0
6;43;622;628;6;112;2.0
6;44;628;642;14;112;2.0
6;45;642;648;6;112;2.0
6;46;648;662;14;112;2.0
6;47;662;668;6;112;2.0
6;48;668;682;14;112;2.0
6;49;682;688;6;112;2.0
6;50;688;702;14;112;2.0
6;51;702;708;6;112;2.0
6;52;708;722;14;112;2.0
6;53;722;728;6;112;2.0
6;54;728;742;14;112;2.0
6;55;742;748;6;112;2.0
6;56;748;762;14;112;2.0
6;57;762;768;6;112;2.0
6;58;768;782;14;112;2.0
6;59;782;788;6;112;2.0
6;60;788;798;10;112;2.0
6;61;798;802;4;112;2.0
6;62;802;808;6;112;2.0
6;63;808;818;10;112;2.0
6;64;818;822;4;112;2.0
6;65;822;828;6;112;2.0
6;66;828;838;10;112;2.0
6;67;838;842;4;112;2.0
6;68;842;848;6;112;2.0
6;69;848;852;4;112;2.0
6;70;852;858;6;112;2.0
6;71;858;862;4;112;2.0
6;72;862;868;6;112;2.0
6;73;868;872;4;112;2.0
6;74;872;878;6;112;2.0
6;75;878;882;4;112;2.0
6;76;882;888;6;112;2.0
6;77;888;892;4;112;2.0
6;78;892;898;6;112;2.0
6;79;898;902;4;112;2.0
6;80;902;908;6;112;2.0
6;81;908;912;4;112;2.0
6;82;912;918;6;112;2.0
6;83;918;922;4;112;2.0
6;84;922;928;6;112;2.0
6;85;928;932;4;112;2.0
6;86;932;938;6;112;2.0
6;87;938;942;4;112;2.0
6;88;942;948;6;112;2.0
6;89;948;952;4;112;2.0
6;90;952;958;6;112;2.0
6;91;958;962;4;112;2.0
6;92;962;968;6;112;2.0
6;93;968;972;4;112;2.0
6;94;972;978;6;112;2.0
6;95;978;982;4;112;2.0
6;96;982;988;6;112;2.0
6;97;988;992;4;112;2.0
6;98;992;998;6;112;2.0
6;99;998;1002;4;112;2.0
6;100;1002;1008;6;112;2.0
6;101;1008;1012;4;112;2.0
6;102;1012;1018;6;112;2.0
6;103;1018;1027;9;112;2.0
6;104;1027;1033;6;112;2.0
6;105;1033;1042;9;112;2.0
6;106;1042;1048;6;112;2.0
6;107;1048;1057;9;112;2.0
6;108;1057;1063;6;112;2.0
6;109;1063;1072;9;112;2.0
6;110;1072;1078;6;112;2.0
6;111;1078;1087;9;112;2.0
6;112;1087;1093;6;112;2.0
6;113;1093;1102;9;112;2.0
6;114;1102;1108;6;112;2.0
6;115;1108;1117;9;112;2.0
6;116;1117;1120;3;112;2.0
6;117;1120;1129;9;112;2.0
6;118;1129;1135;6;112;2.0
6;119;1135;1144;9;112;2.0
6;120;1144;1150;6;112;2.0
6;121;1150;1159;9;112;2.0
6;122;1159;1165;6;112;2.0
6;123;1165;1179;14;112;2.0
6;124;1179;1185;6;112;2.0
6;125;1185;1199;14;112;2.0
6;126;1199;1205;6;112;2.0
6;127;1205;1219;14;112;2.0
6;128;1219;1230;11;112;2.0
6;129;1230;1239;9;112;2.0
6;130;1239;1255;16;112;2.0
6;131;1255;1264;9;112;2.0
6;132;1264;1280;16;112;2.0
6;133;1280;1289;9;112;2.0
6;134;1289;1305;16;112;2.0
6;135;1305;1314;9;112;2.0
6;136;1314;1325;11;112;2.0
6;137;1325;1339;14;112;2.0
6;138;1339;1345;6;112;2.0
6;139;1345;1366;21;112;2.0
6;140;1366;1367;1;112;2.0
6;141;1367;1384;17;112;2.0
6;142;1384;1399;15;112;2.0
6;143;1399;1414;15;112;2.0
6;144;1414;1429;15;112;2.0
6;145;1429;1444;15;112;2.0
6;146;1444;1459;15;112;2.0
6;147;1459;1474;15;112;2.0
6;148;1474;1489;15;112;2.0
6;149;1489;1504;15;112;2.0
6;150;1504;1519;15;112;2.0
6;151;1519;1534;15;112;2.0
6;152;1534;1549;15;112;2.0
6;153;1549;1564;15;112;2.0
6;154;1564;1579;15;112;2.0
6;155;1579;1594;15;112;2.0
6;156;1594;1609;15;112;2.0
6;157;1609;1624;15;112;2.0
6;158;1624;1639;15;112;2.0
6;159;1639;1654;15;112;2.0
6;160;1654;1669;15;112;2.0
6;161;1669;1680;11;112;2.0
7;0;240;331;91;28;0.83
7;1;331;338;7;28;0.83
7;2;338;346;8;28;0.83
7;3;346;353;7;28;0.83
7;4;353;361;8;28;0.83
7;5;361;366;5;28;0.83
7;6;366;375;9;28;0.83
7;7;375;378;3;28;0.83
7;8;378;385;7;28;0.83
7;9;385;388;3;28;0.83
7;10;388;395;7;28;0.83
7;11;395;398;3;28;0.83
7;12;398;405;7;28;0.83
7;13;405;408;3;28;0.83
7;14;408;415;7;28;0.83
7;15;415;418;3;28;0.83
7;16;418;425;7;28;0.83
7;17;425;428;3;28;0.83
7;18;428;435;7;28;0.83
7;19;435;438;3;28;0.83
7;20;438;445;7;28;0.83
7;21;445;448;3;28;0.83
7;22;448;455;7;28;0.83
7;23;455;458;3;28;0.83
7;24;458;465;7;28;0.83
7;25;465;468;3;28;0.83
7;26;468;475;7;28;0.83
7;27;475;478;3;28;0.83
7;28;478;485;7;28;0.83
7;29;485;488;3;28;0.83
7;30;488;503;15;28;0.83
7;31;503;505;2;28;0.83
7;32;505;520;15;28;0.83
7;33;520;525;5;28;0.83
7;34;525;538;13;28;0.83
7;35;538;545;7;28;0.83
7;36;545;558;13;28;0.83
7;37;558;565;7;28;0.83
7;38;565;578;13;28;0.83
7;39;578;585;7;28;0.83
7;40;585;598;13;28;0.83
7;41;598;605;7;28;0.83
7;42;605;618;13;28;0.83
7;43;618;625;7;28;0.83
7;44;625;638;13;28;0.83
7;45;638;645;7;28;0.83
7;46;645;658;13;28;0.83
7;47;658;665;7;28;0.83
7;48;665;678;13;28;0.83
7;49;678;685;7;28;0.83
7;50;685;698;13;28;0.83
7;51;698;705;7;28;0.83
7;52;705;718;13;28;0.83
7;53;718;725;7;28;0.83
7;54;725;738;13;28;0.83
7;55;738;745;7;28;0.83
7;56;745;758;13;28;0.83
7;57;758;765;7;28;0.83
7;58;765;778;13;28;0.83
7;59;778;785;7;28;0.83
7;60;785;795;10;28;0.83
7;61;795;798;3;28;0.83
7;62;798;805;7;28;0.83
7;63;805;815;10;28;0.83
7;64;815;818;3;28;0.83
7;65;818;825;7;28;0.83
7;66;825;835;10;28;0.83
7;67;835;838;3;28;0.83
7;68;838;845;7;28;0.83
7;69;845;848;3;28;0.83
7;70;848;855;7;28;0.83
7;71;855;858;3;28;0.83
7;72;858;865;7;28;0.83
7;73;865;868;3;28;0.83
7;74;868;875;7;28;0.83
7;75;875;878;3;28;0.83
7;76;878;885;7;28;0.83
7;77;885;888;3;28;0.83
7;78;888;895;7;28;0.83
7;79;895;898;3;28;0.83
7;80;898;905;7;28;0.83
7;81;905;908;3;28;0.83
7;82;908;915;7;28;0.83
7;83;915;918;3;28;0.83
7;84;918;925;7;28;0.83
7;85;925;928;3;28;0.83
7;86;928;935;7;28;0.83
7;87;935;938;3;28;0.83
7;88;938;945;7;28;0.83
7;89;945;948;3;28;0.83
7;90;948;955;7;28;0.83
7;91;955;958;3;28;0.83
7;92;958;965;7;28;0.83
7;93;965;968;3;28;0.83
7;94;968;975;7;28;0.83
7;95;975;978;3;28;0.83
7;96;978;985;7;28;0.83
7;97;985;988;3;28;0.83
7;98;988;995;7;28;0.83
7;99;995;998;3;28;0.83
7;100;998;1005;7;28;0.83
7;101;1005;1008;3;28;0.83
7;102;1008;1015;7;28;0.83
7;103;1015;1023;8;28;0.83
7;104;1023;1030;7;28;0.83
7;105;1030;1038;8;28;0.83
7;106;1038;1045;7;28;0.83
7;107;1045;1053;8;28;0.83
7;108;1053;1060;7;28;0.83
7;109;1060;1068;8;28;0.83
7;110;1068;1075;7;28;0.83
7;111;1075;1083;8;28;0.83
7;112;1083;1090;7;28;0.83
7;113;1090;1098;8;28;0.83
7;114;1098;1105;7;28;0.83
7;115;1105;1113;8;28;0.83
7;116;1113;1117;4;28;0.83
7;117;1117;1125;8;28;0.83
7;118;1125;1132;7;28;0.83
7;119;1132;1140;8;28;0.83
7;120;1140;1147;7;28;0.83
7;121;1147;1155;8;28;0.83
7;122;1155;1162;7;28;0.83
7;123;1162;1175;13;28;0.83
7;124;1175;1182;7;28;0.83
7;125;1182;1195;13;28;0.83
7;126;1195;1202;7;28;0.83
7;127;1202;1215;13;28;0.83
7;128;1215;1227;12;28;0.83
7;129;1227;1235;8;28;0.83
7;130;1235;1252;17;28;0.83
7;131;1252;1260;8;28;0.83
7;132;1260;1277;17;28;0.83
7;133;1277;1285;8;28;0.83
7;134;1285;1302;17;28;0.83
7;135;1302;1310;8;28;0.83
7;136;1310;1322;12;28;0.83
7;137;1322;1335;13;28;0.83
7;138;1335;1342;7;28;0.83
7;139;1342;1363;21;28;0.83
7;140;1363;1380;17;28;0.83
7;141;1380;1395;15;28;0.83
7;142;1395;1410;15;28;0.83
7;143;1410;1425;15;28;0.83
7;144;1425;1440;15;28;0.83
7;145;1440;1455;15;28;0.83
7;146;1455;1470;15;28;0.83
7;147;1470;1485;15;28;0.83
7;148;1485;1500;15;28;0.83
7;149;1500;1515;15;28;0.83
7;150;1515;1530;15;28;0.83
7;151;1530;1545;15;28;0.83
7;152;1545;1560;15;28;0.83
7;153;1560;1575;15;28;0.83
7;154;1575;1590;15;28;0.83
7;155;1590;1605;15;28;0.83
7;156;1605;1620;15;28;0.83
7;157;1620;1635;15;28;0.83
7;158;1635;1650;15;28;0.83
7;159;1650;1665;15;28;0.83
7;160;1665;1680;15;28;0.83
8;0;240;331;91;28;0.83
8;1;331;338;7;28;0.83
8;2;338;346;8;28;0.83
8;3;346;353;7;28;0.83
8;4;353;361;8;28;0.83
8;5;361;366;5;28;0.83
8;6;366;375;9;28;0.83
8;7;375;378;3;28;0.83
8;8;378;385;7;28;0.83
8;9;385;388;3;28;0.83
8;10;388;395;7;28;0.83
8;11;395;398;3;28;0.83
8;12;398;405;7;28;0.83
8;13;405;408;3;28;0.83
8;14;408;415;7;28;0.83
8;15;415;418;3;28;0.83
8;16;418;425;7;28;0.83
8;17;425;428;3;28;0.83
8;18;428;435;7;28;0.83
8;19;435;438;3;28;0.83
8;20;438;445;7;28;0.83
8;21;445;448;3;28;0.83
8;22;448;455;7;28;0.83
8;23;455;458;3;28;0.83
8;24;458;465;7;28;0.83
8;25;465;468;3;28;0.83
8;26;468;475;7;28;0.83
8;27;475;478;3;28;0.83
8;28;478;485;7;28;0.83
8;29;485;488;3;28;0.83
8;30;488;503;15;28;0.83
8;31;503;505;2;28;0.83
8;32;505;520;15;28;0.83
8;33;520;525;5;28;0.83
8;34;525;538;13;28;0.83
8;35;538;545;7;28;0.83
8;36;545;558;13;28;0.83
8;37;558;565;7;28;0.83
8;38;565;578;13;28;0.83
8;39;578;585;7;28;0.83
8;40;585;598;13;28;0.83
8;41;598;605;7;28;0.83
8;42;605;618;13;28;0.83
8;43;618;625;7;28;0.83
8;44;625;638;13;28;0.83
8;45;638;645;7;28;0.83
8;46;645;658;13;28;0.83
8;47;658;665;7;28;0.83
8;48;665;678;13;28;0.83
8;49;678;685;7;28;0.83
8;50;685;698;13;28;0.83
8;51;698;705;7;28;0.83
8;52;705;718;13;28;0.83
8;53;718;725;7;28;0.83
8;54;725;738;13;28;0.83
8;55;738;745;7;28;0.83
8;56;745;758;13;28;0.83
8;57;758;765;7;28;0.83
8;58;765;778;13;28;0.83
8;59;778;785;7;28;0.83
8;60;785;795;10;28;0.83
8;61;795;798;3;28;0.83
8;62;798;805;7;28;0.83
8;63;805;815;10;28;0.83
8;64;815;818;3;28;0.83
8;65;818;825;7;28;0.83
8;66;825;835;10;28;0.83
8;67;835;838;3;28;0.83
8;68;838;845;7;28;0.83
8;69;845;848;3;28;0.83
8;70;848;855;7;28;0.83
8;71;855;858;3;28;0.83
8;72;858;865;7;28;0.83
8;73;865;868;3;28;0.83
8;74;868;875;7;28;0.83
8;75;875;878;3;28;0.83
8;76;878;885;7;28;0.83
8;77;885;888;3;28;0.83
8;78;888;895;7;28;0.83
8;79;895;898;3;28;0.83
8;80;898;905;7;28;0.83
8;81;905;908;3;28;0.83
8;82;908;915;7;28;0.83
8;83;915;918;3;28;0.83
8;84;918;925;7;28;0.83
8;85;925;928;3;28;0.83
8;86;928;935;7;28;0.83
8;87;935;938;3;28;0.83
8;88;938;945;7;28;0.83
8;89;945;948;3;28;0.83
8;90;948;955;7;28;0.83
8;91;955;958;3;28;0.83
8;92;958;965;7;28;0.83
8;93;965;968;3;28;0.83
8;94;968;975;7;28;0.83
8;95;975;978;3;28;0.83
8;96;978;985;7;28;0.83
8;97;985;988;3;28;0.83
8;98;988;995;7;28;0.83
8;99;995;998;3;28;0.83
8;100;998;1005;7;28;0.83
8;101;1005;1008;3;28;0.83
8;102;1008;1015;7;28;0.83
8;103;1015;1023;8;28;0.83
8;104;1023;1030;7;28;0.83
8;105;1030;1038;8;28;0.83
8;106;1038;1045;7;28;0.83
8;107;1045;1053;8;28;0.83
8;108;1053;1060;7;28;0.83
8;109;1060;1068;8;28;0.83
8;110;1068;1075;7;28;0.83
8;111;1075;1083;8;28;0.83
8;112;1083;1090;7;28;0.83
8;113;1090;1098;8;28;0.83
8;114;1098;1105;7;28;0.83
8;115;1105;1113;8;28;0.83
8;116;1113;1117;4;28;0.83
8;117;1117;1125;8;28;0.83
8;118;1125;1132;7;28;0.83
8;119;1132;1140;8;28;0.83
8;120;1140;1147;7;28;0.83
8;121;1147;1155;8;28;0.83
8;122;1155;1162;7;28;0.83
8;123;1162;1175;13;28;0.83
8;124;1175;1182;7;28;0.83
8;125;1182;1195;13;28;0.83
8;126;1195;1202;7;28;0.83
8;127;1202;1215;13;28;0.83
8;128;1215;1227;12;28;0.83
8;129;1227;1235;8;28;0.83
8;130;1235;1252;17;28;0.83
8;131;1252;1260;8;28;0.83
8;132;1260;1277;17;28;0.83
8;133;1277;1285;8;28;0.83
8;134;1285;1302;17;28;0.83
8;135;1302;1310;8;28;0.83
8;136;1310;1322;12;28;0.83
8;137;1322;1335;13;28;0.83
8;138;1335;1342;7;28;0.83
8;139;1342;1363;21;28;0.83
8;140;1363;1380;17;28;0.83
8;141;1380;1395;15;28;0.83
8;142;1395;1410;15;28;0.83
8;143;1410;1425;15;28;0.83
8;144;1425;1440;15;28;0.83
8;145;1440;1455;15;28;0.83
8;146;1455;1470;15;28;0.83
8;147;1470;1485;15;28;0.83
8;148;1485;1500;15;28;0.83
8;149;1500;1515;15;28;0.83
8;150;1515;1530;15;28;0.83
8;151;1530;1545;15;28;0.83
8;152;1545;1560;15;28;0.83
8;153;1560;1575;15;28;0.83
8;154;1575;1590;15;28;0.83
8;155;1590;1605;15;28;0.83
8;156;1605;1620;15;28;0.83
8;157;1620;1635;15;28;0.83
8;158;1635;1650;15;28;0.83
8;159;1650;1665;15;28;0.83
8;160;1665;1680;15;28;0.83
9;0;240;331;91;28;0.83
9;1;331;338;7;28;0.83
9;2;338;346;8;28;0.83
9;3;346;353;7;28;0.83
9;4;353;361;8;28;0.83
9;5;361;366;5;28;0.83
9;6;366;375;9;28;0.83
9;7;375;378;3;28;0.83
9;8;378;385;7;28;0.83
9;9;385;388;3;28;0.83
9;10;388;395;7;28;0.83
9;11;395;398;3;28;0.83
9;12;398;405;7;28;0.83
9;13;405;408;3;28;0.83
9;14;408;415;7;28;0.83
9;15;415;418;3;28;0.83
9;16;418;425;7;28;0.83
9;17;425;428;3;28;0.83
9;18;428;435;7;28;0.83
9;19;435;438;3;28;0.83
9;20;438;445;7;28;0.83
9;21;445;448;3;28;0.83
9;22;448;455;7;28;0.83
9;23;455;458;3;28;0.83
9;24;458;465;7;28;0.83
9;25;465;468;3;28;0.83
9;26;468;475;7;28;0.83
9;27;475;478;3;28;0.83
9;28;478;485;7;28;0.83
9;29;485;488;3;28;0.83
9;30;488;503;15;28;0.83
9;31;503;505;2;28;0.83
9;32;505;520;15;28;0.83
9;33;520;525;5;28;0.83
9;34;525;538;13;28;0.83
9;35;538;545;7;28;0.83
9;36;545;558;13;28;0.83
9;37;558;565;7;28;0.83
9;38;565;578;13;28;0.83
9;39;578;585;7;28;0.83
9;40;585;598;13;28;0.83
9;41;598;605;7;28;0.83
9;42;605;618;13;28;0.83
9;43;618;625;7;28;0.83
9;44;625;638;13;28;0.83
9;45;638;645;7;28;0.83
9;46;645;658;13;28;0.83
9;47;658;665;7;28;0.83
9;48;665;678;13;28;0.83
9;49;678;685;7;28;0.83
9;50;685;698;13;28;0.83
9;51;698;705;7;28;0.83
9;52;705;718;13;28;0.83
9;53;718;725;7;28;0.83
9;54;725;738;13;28;0.83
9;55;738;745;7;28;0.83
9;56;745;758;13;28;0.83
9;57;758;765;7;28;0.83
9;58;765;778;13;28;0.83
9;59;778;785;7;28;0.83
9;60;785;795;10;28;0.83
9;61;795;798;3;28;0.83
9;62;798;805;7;28;0.83
9;63;805;815;10;28;0.83
9;64;815;818;3;28;0.83
9;65;818;825;7;28;0.83
9;66;825;835;10;28;0.83
9;67;835;838;3;28;0.83
9;68;838;845;7;28;0.83
9;69;845;848;3;28;0.83
9;70;848;855;7;28;0.83
9;71;855;858;3;28;0.83
9;72;858;865;7;28;0.83
9;73;865;868;3;28;0.83
9;74;868;875;7;28;0.83
9;75;875;878;3;28;0.83
9;76;878;885;7;28;0.83
9;77;885;888;3;28;0.83
9;78;888;895;7;28;0.83
9;79;895;898;3;28;0.83
9;80;898;905;7;28;0.83
9;81;905;908;3;28;0.83
9;82;908;915;7;28;0.83
9;83;915;918;3;28;0.83
9;84;918;925;7;28;0.83
9;85;925;928;3;28;0.83
9;86;928;935;7;28;0.83
9;87;935;938;3;28;0.83
9;88;938;945;7;28;0.83
9;89;945;948;3;28;0.83
9;90;948;955;7;28;0.83
9;91;955;958;3;28;0.83
9;92;958;965;7;28;0.83
9;93;965;968;3;28;0.83
9;94;968;975;7;28;0.83
9;95;975;978;3;28;0.83
9;96;978;985;7;28;0.83
9;97;985;988;3;28;0.83
9;98;988;995;7;28;0.83
9;99;995;998;3;28;0.83
9;100;998;1005;7;28;0.83
9;101;1005;1008;3;28;0.83
9;102;1008;1015;7;28;0.83
9;103;1015;1023;8;28;0.83
9;104;1023;1030;7;28;0.83
9;105;1030;1038;8;28;0.83
9;106;1038;1045;7;28;0.83
9;107;1045;1053;8;28;0.83
9;108;1053;1060;7;28;0.83
9;109;1060;1068;8;28;0.83
9;110;1068;1075;7;28;0.83
9;111;1075;1083;8;28;0.83
9;112;1083;1090;7;28;0.83
9;113;1090;1098;8;28;0.83
9;114;1098;1105;7;28;0.83
9;115;1105;1113;8;28;0.83
9;116;1113;1117;4;28;0.83
9;117;1117;1125;8;28;0.83
9;118;1125;1132;7;28;0.83
9;119;1132;1140;8;28;0.83
9;120;1140;1147;7;28;0.83
9;121;1147;1155;8;28;0.83
9;122;1155;1162;7;28;0.83
9;123;1162;1175;13;28;0.83
9;124;1175;1182;7;28;0.83
9;125;1182;1195;13;28;0.83
9;126;1195;1202;7;28;0.83
9;127;1202;1215;13;28;0.83
9;128;1215;1227;12;28;0.83
9;129;1227;1235;8;28;0.83
9;130;1235;1252;17;28;0.83
9;131;1252;1260;8;28;0.83
9;132;1260;1277;17;28;0.83
9;133;1277;1285;8;28;0.83
9;134;1285;1302;17;28;0.83
9;135;1302;1310;8;28;0.83
9;136;1310;1322;12;28;0.83
9;137;1322;1335;13;28;0.83
9;138;1335;1342;7;28;0.83
9;139;1342;1363;21;28;0.83
9;140;1363;1380;17;28;0.83
9;141;1380;1395;15;28;0.83
9;142;1395;1410;15;28;0.83
9;143;1410;1425;15;28;0.83
9;144;1425;1440;15;28;0.83
9;145;1440;1455;15;28;0.83
9;146;1455;1470;15;28;0.83
9;147;1470;1485;15;28;0.83
9;148;1485;1500;15;28;0.83
9;149;1500;1515;15;28;0.83
9;150;1515;1530;15;28;0.83
9;151;1530;1545;15;28;0.83
9;152;1545;1560;15;28;0.83
9;153;1560;1575;15;28;0.83
9;154;1575;1590;15;28;0.83
9;155;1590;1605;15;28;0.83
9;156;1605;1620;15;28;0.83
9;157;1620;1635;15;28;0.83
9;158;1635;1650;15;28;0.83
9;159;1650;1665;15;28;0.83
9;160;1665;1680;15;28;0.83
10;0;240;331;91;28;0.83
10;1;331;338;7;28;0.83
10;2;338;346;8;28;0.83
10;3;346;353;7;28;0.83
10;4;353;361;8;28;0.83
10;5;361;366;5;28;0.83
10;6;366;375;9;28;0.83
10;7;375;378;3;28;0.83
10;8;378;385;7;28;0.83
10;9;385;388;3;28;0.83
10;10;388;395;7;28;0.83
10;11;395;398;3;28;0.83
10;12;398;405;7;28;0.83
10;13;405;408;3;28;0.83
10;14;408;415;7;28;0.83
10;15;415;418;3;28;0.83
10;16;418;425;7;28;0.83
10;17;425;428;3;28;0.83
10;18;428;435;7;28;0.83
10;19;435;438;3;28;0.83
10;20;438;445;7;28;0.83
10;21;445;448;3;28;0.83
10;22;448;455;7;28;0.83
10;23;455;458;3;28;0.83
10;24;458;465;7;28;0.83
10;25;465;468;3;28;0.83
10;26;468;475;7;28;0.83
10;27;475;478;3;28;0.83
10;28;478;485;7;28;0.83
10;29;485;488;3;28;0.83
10;30;488;503;15;28;0.83
10;31;503;505;2;28;0.83
10;32;505;520;15;28;0.83
10;33;520;525;5;28;0.83
10;34;525;538;13;28;0.83
10;35;538;545;7;28;0.83
10;36;545;558;13;28;0.83
10;37;558;565;7;28;0.83
10;38;565;578;13;28;0.83
10;39;578;585;7;28;0.83
10;40;585;598;13;28;0.83
10;41;598;605;7;28;0.83
10;42;605;618;13;28;0.83
10;43;618;625;7;28;0.83
10;44;625;638;13;28;0.83
10;45;638;645;7;28;0.83
10;46;645;658;13;28;0.83
10;47;658;665;7;28;0.83
10;48;665;678;13;28;0.83
10;49;678;685;7;28;0.83
10;50;685;698;13;28;0.83
10;51;698;705;7;28;0.83
10;52;705;718;13;28;0.83
10;53;718;725;7;28;0.83
10;54;725;738;13;28;0.83
10;55;738;745;7;28;0.83
10;56;745;758;13;28;0.83
10;57;758;765;7;28;0.83
10;58;765;778;13;28;0.83
10;59;778;785;7;28;0.83
10;60;785;795;10;28;0.83
10;61;795;798;3;28;0.83
10;62;798;805;7;28;0.83
10;63;805;815;10;28;0.83
10;64;815;818;3;28;0.83
10;65;818;825;7;28;0.83
10;66;825;835;10;28;0.83
10;67;835;838;3;28;0.83
10;68;838;845;7;28;0.83
10;69;845;848;3;28;0.83
10;70;848;855;7;28;0.83
10;71;855;858;3;28;0.83
10;72;858;865;7;28;0.83
10;73;865;868;3;28;0.83
10;74;868;875;7;28;0.83
10;75;875;878;3;28;0.83
10;76;878;885;7;28;0.83
10;77;885;888;3;28;0.83
10;78;888;895;7;28;0.83
10;79;895;898;3;28;0.83
10;80;898;905;7;28;0.83
10;81;905;908;3;28;0.83
10;82;908;915;7;28;0.83
10;83;915;918;3;28;0.83
10;84;918;925;7;28;0.83
10;85;925;928;3;28;0.83
10;86;928;935;7;28;0.83
10;87;935;938;3;28;0.83
10;88;938;945;7;28;0.83
10;89;945;948;3;28;0.83
10;90;948;955;7;28;0.83
10;91;955;958;3;28;0.83
10;92;958;965;7;28;0.83
10;93;965;968;3;28;0.83
10;94;968;975;7;28;0.83
10;95;975;978;3;28;0.83
10;96;978;985;7;28;0.83
10;97;985;988;3;28;0.83
10;98;988;995;7;28;0.83
10;99;995;998;3;28;0.83
10;100;998;1005;7;28;0.83
10;101;1005;1008;3;28;0.83
10;102;1008;1015;7;28;0.83
10;103;1015;1023;8;28;0.83
10;104;1023;1030;7;28;0.83
10;105;1030;1038;8;28;0.83
10;106;1038;1045;7;28;0.83
10;107;1045;1053;8;28;0.83
10;108;1053;1060;7;28;0.83
10;109;1060;1068;8;28;0.83
10;110;1068;1075;7;28;0.83
10;111;1075;1083;8;28;0.83
10;112;1083;1090;7;28;0.83
10;113;1090;1098;8;28;0.83
10;114;1098;1105;7;28;0.83
10;115;1105;1113;8;28;0.83
10;116;1113;1117;4;28;0.83
10;117;1117;1125;8;28;0.83
10;118;1125;1132;7;28;0.83
10;119;1132;1140;8;28;0.83
10;120;1140;1147;7;28;0.83
10;121;1147;1155;8;28;0.83
10;122;1155;1162;7;28;0.83
10;123;1162;1175;13;28;0.83
10;124;1175;1182;7;28;0.83
10;125;1182;1195;13;28;0.83
10;126;1195;1202;7;28;0.83
10;127;1202;1215;13;28;0.83
10;128;1215;1227;12;28;0.83
10;129;1227;1235;8;28;0.83
10;130;1235;1252;17;28;0.83
10;131;1252;1260;8;28;0.83
10;132;1260;1277;17;28;0.83
10;133;1277;1285;8;28;0.83
10;134;1285;1302;17;28;0.83
10;135;1302;1310;8;28;0.83
10;136;1310;1322;12;28;0.83
10;137;1322;1335;13;28;0.83
10;138;1335;1342;7;28;0.83
10;139;1342;1363;21;28;0.83
10;140;1363;1380;17;28;0.83
10;141;1380;1395;15;28;0.83
10;142;1395;1410;15;28;0.83
10;143;1410;1425;15;28;0.83
10;144;1425;1440;15;28;0.83
10;145;1440;1455;15;28;0.83
10;146;1455;1470;15;28;0.83
10;147;1470;1485;15;28;0.83
10;148;1485;1500;15;28;0.83
10;149;1500;1515;15;28;0.83
10;150;1515;1530;15;28;0.83
10;151;1530;1545;15;28;0.83
10;152;1545;1560;15;28;0.83
10;153;1560;1575;15;28;0.83
10;154;1575;1590;15;28;0.83
10;155;1590;1605;15;28;0.83
10;156;1605;1620;15;28;0.83
10;157;1620;1635;15;28;0.83
10;158;1635;1650;15;28;0.83
10;159;1650;1665;15;28;0.83
10;160;1665;1680;15;28;0.83
